AAAU      	Perth Mint Physical Gold ETF                      	AMEX      
AADR      	Advisorshares Dorsey Wright ADR                   	AMEX      
AAMC      	Altisource Asset                                  	AMEX      
AAU       	Almaden Minerals                                  	AMEX      
ACES      	Alps Clean Energy ETF                             	AMEX      
ACIM      	ACWI IMI MSCI ETF SPDR                            	AMEX      
ACSI      	American Customer Satisfaction Core Alpha ETF     	AMEX      
ACU       	Acme United Corp                                  	AMEX      
ACWF      	Global Multifactor Ishares Edge MSCI ETF          	AMEX      
ACWV      	Global Min Vol Ishares Edge MSCI ETF              	AMEX      
ACY       	Aerocentury Corp                                  	AMEX      
AE        	Adams Resources & Energy                          	AMEX      
AEF       	Aberdeen EM Equity Income Fund Inc                	AMEX      
AFIF      	Anfield Universal Fixed Income ETF                	AMEX      
AFK       	Africa Index ETF Vaneck                           	AMEX      
AFTY      	CSOP FTSE China A50 ETF                           	AMEX      
AGF       	DB Agriculture ETN Powershares                    	AMEX      
AGG       	US Aggregate Bond Ishares Core ETF                	AMEX      
AGGE      	IQ Enhanced Core Bond U.S. ETF                    	AMEX      
AGGP      	IQ Enhanced Core Plus Bond U.S.                   	AMEX      
AGGY      	Wisdomtree Yield Enhcd US Agg Bond Fund           	AMEX      
AGQ       	Ultra Silver Proshares                            	AMEX      
AGT       	Argentina Ishares MSCI ETF                        	AMEX      
AGZ       	Agency Bond Ishares ETF                           	AMEX      
AIEQ      	Ai Powered Equity ETF                             	AMEX      
AIIQ      	Ai Powered International Equity ETF               	AMEX      
AINC      	Ashford Inc                                       	AMEX      
AIRI      	Air Industries Group Inc                          	AMEX      
AKG       	Asanko Gold Inc                                   	AMEX      
ALD       	Asia Local Debt ETF Wisdomtree                    	AMEX      
ALFA      	Alphaclone Alternative Alpha ETF                  	AMEX      
ALO       	Alio Gold Corp                                    	AMEX      
ALTS      	Mstar Alternative Solutions Proshares             	AMEX      
AMBO      	Ambow Education Holding Ltd                       	AMEX      
AMJ       	Alerian MLP Index ETN JP Morgan                   	AMEX      
AMJL      	X-Links Mthy Pay 2X Leveraged Alerian MLP         	AMEX      
AMLP      	Alps Alerian MLP ETF                              	AMEX      
AMPE      	Ampio Pharmaceutical                              	AMEX      
AMS       	American Shared Hospital Services                 	AMEX      
AMU       	Etracs Alerian MLP Index ETN                      	AMEX      
AMUB      	Etracs Alerian MLP ETN Series B                   	AMEX      
AMZA      	Infracap MLP ETF                                  	AMEX      
ANGL      	Fallen Angel HY Bond ETF Vaneck                   	AMEX      
AOA       	Aggressive Allocation Ishares Core ETF            	AMEX      
AOK       	Conservative Allocation Ishares Core ETF          	AMEX      
AOM       	Moderate Allocation Ishares Core ETF              	AMEX      
AOR       	Growth Allocation Ishares Core ETF                	AMEX      
APHB      	Ampliphi Biosciences Corp                         	AMEX      
APT       	Alpha Pro Tech                                    	AMEX      
ARCM      	Arrow Reserve Capital Management ETF              	AMEX      
ARGT      	G-X FTSE Argentina 20 ETF                         	AMEX      
ARKG      	Ark Genomic Revolution Multi-Sector ETF           	AMEX      
ARKK      	Ark Innovation ETF                                	AMEX      
ARKQ      	Ark Industrial Innovation ETF                     	AMEX      
ARKW      	Ark Web X.0 ETF                                   	AMEX      
ARN.P     	Arconic Inc Pf 3.75                               	AMEX      
ARVR      	Tactile Analytics Ar/Vr Virtual Tech              	AMEX      
ASB.W     	Associated Banc-Corp WT                           	AMEX      
ASEA      	G-X FTSE Asean 40 ETF                             	AMEX      
ASHR      	Db-Xt Harvest CSI 300 China A                     	AMEX      
ASHS      	Db-Xt Harvest CSI 500 China A                     	AMEX      
ASHX      	Db-Xt CSI 300 China A Hgd Eq                      	AMEX      
ASM       	Avino Silver & Gold                               	AMEX      
AST       	Asterias Biotherapeutics Inc                      	AMEX      
ATMP      	Barclays Plus Select MLP ETN                      	AMEX      
ATNM      	Actinium Pharmaceuticals Inc                      	AMEX      
AUG       	Auryn Resources Inc                               	AMEX      
AUGR      	Defiance Future Tech ETF                          	AMEX      
AUMN      	Golden Minerals Co                                	AMEX      
AUSE      	Australia Dividend Wisdomtree                     	AMEX      
AUSF      	Global X Adaptive US Factor ETF                   	AMEX      
AWX       	Avalon Holdings Corp                              	AMEX      
AXJL      	Asia Pacific Ex-Japan Wisdomtree                  	AMEX      
AXJV      	Asia Ex Japan Min Vol Ishares Edge MSCI ETF       	AMEX      
AXU       	Alexco Resource Corp                              	AMEX      
BAB       	Taxable Municipal Bond Invesco ETF                	AMEX      
BAL       	Ipatha Cotton Subindex Total Return ETN           	AMEX      
BALB      	Ipath.B Cotton Subindex TR Series B ETN           	AMEX      
BAR       	Graniteshares Gold Trust Shares of Beneficial In  	AMEX      
BATT      	Amplify Advanced Battery Metals and Materials Et  	AMEX      
BBAX      	Jpmorgan Betabuilders Developed Asia-Ex Japan Et  	AMEX      
BBC       	Bioshares Biotech Clinical Trial                  	AMEX      
BBCA      	Jpmorgan Betabuilders Canada ETF                  	AMEX      
BBEU      	Jpmorgan Betabuilders Europe ETF                  	AMEX      
BBJP      	Jpmorgan Betabuilders Japan ETF                   	AMEX      
BBP       	Bioshares Biotech Products                        	AMEX      
BBRC      	Columbia Beyond Brics ETF                         	AMEX      
BBRE      	Jpmorgan Betabuilders MSCI U.S. REIT ETF          	AMEX      
BCD       	All Commodity Longer Dated Strategy ETF           	AMEX      
BCI       	All Commodity Strategy K-1 Free ETF               	AMEX      
BCM       	Ipath Pure Beta Broad Commodity ETN               	AMEX      
BCV       	Bancroft Convertible Fund                         	AMEX      
BCV-A     	Bancroft Fund Ltd                                 	AMEX      
BDCL      	Wells Fargo 2X Bus Dv Cm ETN UBS E-Tracs          	AMEX      
BDCS      	Wells Fargo Bus Dev Comp ETN                      	AMEX      
BDCZ      	Etracs Wells Fargo Business Dev ETN               	AMEX      
BDD       	DB Base Metals 2X ETN Powershares                 	AMEX      
BDL       	Flanigan's Enterprises                            	AMEX      
BDR       	Blonder Tongue Laboratories                       	AMEX      
BDRY      	Breakwave Dry Bulk Shipping ETF                   	AMEX      
BEF       	Energy Commodity Longer Dated Strategy ETF        	AMEX      
BEMO      	Aptus Behavioral Momentum ETF                     	AMEX      
BERN      	Bernstein U.S. Research Fund                      	AMEX      
BFOR      	Barron's 400                                      	AMEX      
BGI       	Birks Group Inc                                   	AMEX      
BGSF      	Bg Staffing                                       	AMEX      
BHB       	Bar Harbor Bankshares                             	AMEX      
BIBL      	Inspire 100 ETF                                   	AMEX      
BIKR      	Rogers Ai Global Macro ETF                        	AMEX      
BIL       	1-3 Month T-Bill Barclays Capital SPDR            	AMEX      
BIV       	Interm Term Bond ETF Vanguard                     	AMEX      
BIZD      	Bdc Income Vaneck ETF                             	AMEX      
BJJN      	Ipath.B Nickel Subindex TR Series B ETN           	AMEX      
BJK       	Gaming ETF Vaneck                                 	AMEX      
BJO       	Ipath.B Coffee Subindex TR Series B ETN           	AMEX      
BJUL      	Innovator S&P 500 Buffer ETF                      	AMEX      
BKC       	Rex Bkcm ETF                                      	AMEX      
BKF       	BRIC Ishares MSCI ETF                             	AMEX      
BKJ       	Bancorp of New Jersey Inc                         	AMEX      
BKLN      	Senior Loan Invesco ETF                           	AMEX      
BKTI      	Bk Technologies Inc                               	AMEX      
BLES      	Inspire Global Hope Large Cap ETF                 	AMEX      
BLHY      	Virtus Dynamic Credit ETF                         	AMEX      
BLOK      	Amplify Transformational Data Sharing ETF         	AMEX      
BLV       	Long Term Bond Index ETF Vanguard                 	AMEX      
BNDC      	Flexshares Core Select Bond Fund                  	AMEX      
BNO       	US Brent Oil                                      	AMEX      
BOCT      	Innovator S&P 500 Buffer ETF                      	AMEX      
BOIL      	Ultra DJ-UBS Natural Gas Proshares                	AMEX      
BOM       	DB Base Metals -2X ETN Powershares                	AMEX      
BOND      	Total Return ETF Pimco                            	AMEX      
BOON      	NYSE Pickens Oil Response ETF                     	AMEX      
BOS       	DB Base Metals -1X ETN Powershares                	AMEX      
BOSS      	G-X Founder-Run Companies ETF                     	AMEX      
BOUT      	Innovator Ibd Breakout Opportunities ETF          	AMEX      
BPMX      	Biopharmx Corporatio                              	AMEX      
BRF       	Brazil Smallcap ETF Vaneck                        	AMEX      
BRG       	Bluerock Residential Growth Rei                   	AMEX      
BRG-A     	Bluerock Residential Growth Rei                   	AMEX      
BRG-C     	Bluerock Residential Growth REIT Inc              	AMEX      
BRG-D     	Bluerock Residential Growth REIT Inc              	AMEX      
BRGL      	Bernstein Global Research Fund                    	AMEX      
BRN       	Barnwell Industries                               	AMEX      
BRZU      	Direxion Brazil Bull 3X                           	AMEX      
BSAE      	Invesco Bulletshares 2021 USD EM Debt ETF         	AMEX      
BSBE      	Invesco Bulletshares 2022 USD Emerging Markets D  	AMEX      
BSCE      	Invesco Bulletshares 2023 USD EM Debt ETF         	AMEX      
BSCI      	Bs 2018 Corp Bond Invesco ETF                     	AMEX      
BSCJ      	Bs 2019 Corp Bond Invesco ETF                     	AMEX      
BSCK      	Bs 2020 Corp Bond Invesco ETF                     	AMEX      
BSCL      	Bs 2021 Corp Bond Invesco ETF                     	AMEX      
BSCM      	Bs 2022 Corp Bond Invesco ETF                     	AMEX      
BSCN      	Bs 2023 Corp Bond Invesco ETF                     	AMEX      
BSCO      	Bs 2024 Corp Bond Invesco ETF                     	AMEX      
BSCP      	Bs 2025 Corp Bond Invesco ETF                     	AMEX      
BSCQ      	Bs 2026 Corp Bond Invesco ETF                     	AMEX      
BSCR      	Bs 2027 Corp Bond Invesco ETF                     	AMEX      
BSCS      	Invesco Bulletshares 2028 Corporate Bond ETF      	AMEX      
BSDE      	Invesco Bulletshares 2024 USD Emerging Markets D  	AMEX      
BSJI      	Bs 2018 High Yield Corp Bond Invesco ETF          	AMEX      
BSJJ      	Bs 2019 High Yield Corp Bond Invesco ETF          	AMEX      
BSJK      	Bs 2020 High Yield Corp Bond Invesco ETF          	AMEX      
BSJL      	Bs 2021 High Yield Corp Bond Invesco ETF          	AMEX      
BSJM      	Bs 2022 High Yield Corp Bond Invesco ETF          	AMEX      
BSJN      	Bs 2023 High Yield Corp Bond Invesco ETF          	AMEX      
BSJO      	Bs 2024 High Yield Corp Bond Invesco ETF          	AMEX      
BSJP      	Bs 2025 High Yield Corp Bond Invesco ETF          	AMEX      
BSJQ      	Invesco Bulletshares 2026 High Yield Corporate B  	AMEX      
BSV       	Short-Term Bond ETF Vanguard                      	AMEX      
BTAL      	US Anti-Beta Fund Mkt Neutral Quantshares         	AMEX      
BTG       	B2Gold Corp                                       	AMEX      
BTN       	Ballantyne Strong Inc                             	AMEX      
BTX       	Biotime Inc                                       	AMEX      
BUY       	Uscf Summerhaven Shpei Index Fund                 	AMEX      
BUYN      	Uscf Summerhaven Shpen Index Fund                 	AMEX      
BUZ       	Sprott Buzz Social Media Insights ETF             	AMEX      
BVAL      	Brand Value ETF                                   	AMEX      
BVX       	Bovie Medical Corp                                	AMEX      
BWL.A     	Bowl Amer Inc Cl A                                	AMEX      
BWX       	Intl Treasury Bond ETF SPDR                       	AMEX      
BWZ       	Short-Term Intl Treasury Bond ETF SPDR            	AMEX      
BYLD      	Yield Optimized Bond Ishares ETF                  	AMEX      
BZF       	Wisdomtree Brazilian Real Fund                    	AMEX      
BZQ       	Ultrashort MSCI Brazil Proshares                  	AMEX      
CALF      	Pacer US Small Cap Cash Cows 100 ETF              	AMEX      
CANE      	Teucrium Sugar                                    	AMEX      
CANF      	Can-Fite Biopharma Ltd                            	AMEX      
CAPE      	Barclays Schiller Cape ETN                        	AMEX      
CAW       	CCA Industries                                    	AMEX      
CBND      	Issuer Scd Corp Bond SPDR                         	AMEX      
CBOE      	CBOE Global Markets Inc                           	AMEX      
CBON      	Chinaamc China Vaneck ETF                         	AMEX      
CCA       	MFS California Insured Muni Trust                 	AMEX      
CCF       	Chase Corp                                        	AMEX      
CCOR      	Cambria Core Equity ETF                           	AMEX      
CDOR      	Condor Hospitality T                              	AMEX      
CEF       	Sprott Physical Gold & Silver Trust               	AMEX      
CEFL      	Etracs Mt Pay 2X Closed-End Fund ETN              	AMEX      
CEFS      	Exchange Listed Funds Trust ETF                   	AMEX      
CEI       	Camber Energy Inc                                 	AMEX      
CEMB      	Emrg Mkts Corp Bond Ishares JPM ETF               	AMEX      
CET       	Central Securities Corp                           	AMEX      
CEV       	Eaton Vance California Muni Income Trust          	AMEX      
CEW       	Wisdomtree Emerging Currency Fund                 	AMEX      
CGW       	S&P Global Water Index Invesco ETF                	AMEX      
CHAD      	Direxion CSI 300 China A 1X                       	AMEX      
CHAU      	Direxion CSI 300 China A 2X                       	AMEX      
CHEP      	US Value Fund Mkt Neutral ETF Quantshares         	AMEX      
CHGX      	Diversified Impact U.S. Large Cap Fossil Fuel F   	AMEX      
CHIE      	G-X China Energy ETF                              	AMEX      
CHII      	G-X China Industrials ETF                         	AMEX      
CHIM      	G-X China Materials ETF                           	AMEX      
CHIQ      	G-X China Consumer ETF                            	AMEX      
CHIX      	G-X China Financials ETF                          	AMEX      
CIK       	Credit Suisse Asset Management                    	AMEX      
CIX       	Compx International Inc                           	AMEX      
CJNK      	Bofa Crossover Corp Bond ETF SPDR                 	AMEX      
CKX       	Ckx Lands                                         	AMEX      
CLIX      	Proshares Long Online/Short Stores ETF            	AMEX      
CLM       	Cornerstone Strategic Value Fund                  	AMEX      
CLTL      	Treasury Collateral Invesco ETF                   	AMEX      
CMBS      	CMBS Ishares ETF                                  	AMEX      
CMCL      	Caledonia Mining Cp                               	AMEX      
CMDY      	Bberg Roll Select Cmdty Strategy Ishares ETF      	AMEX      
CMF       	California Muni Bond Ishares ETF                  	AMEX      
CMT       	Core Molding Technologies Inc                     	AMEX      
CN        	Namaste Technologies Inc                          	AMEX      
CNHX      	CSOP MSCI China A International                   	AMEX      
CNXT      	Chinaamc Sme-Chn Vaneck ETF                       	AMEX      
CNY       	RMB/USD ETN Vaneck                                	AMEX      
CNYA      	China A Ishares MSCI ETF                          	AMEX      
COHN      	Cohen & Co Inc                                    	AMEX      
COM       	Direxion Auspice Broad Commodity Strategy ETF     	AMEX      
COMB      	Commodity Broad Strategy No K-1 ETF               	AMEX      
COMG      	GSCI Commodity Broad Strategy No K-1 ETF          	AMEX      
COPX      	G-X Copper Miners ETF                             	AMEX      
CORN      	Teucrium Corn                                     	AMEX      
CORP      	Invest Grade Corp Bd Index ETF Pimco              	AMEX      
COW       	Ipatha Livestock Subindex Total Return ETN        	AMEX      
COWB      	Ipath.B Livestock Subindex TR Series B ETN        	AMEX      
COWZ      	Pacer US Cash Cows 100 ETF                        	AMEX      
CPER      	US Copper                                         	AMEX      
CPHI      	China Pharma Holdings                             	AMEX      
CPI       	IQ Real Return ETF                                	AMEX      
CQP       	Cheniere Energy Partners LP                       	AMEX      
CQQQ      	China Technology Invesco ETF                      	AMEX      
CRAK      	Oil Refiners Vaneck ETF                           	AMEX      
CRBN      	ACWI Low Carbon Target Ishares MSCI ETF           	AMEX      
CRF       	Cornerstone Strategic Return Fund                 	AMEX      
CRHM      	CRH Medical Corp                                  	AMEX      
CRMD      	Cormedix Inc                                      	AMEX      
CROC      	Ultrashort Australian Proshares                   	AMEX      
CROP      	IQ Global Agribusiness Smallcap ETF               	AMEX      
CSD       	S&P Spin-Off Invesco ETF                          	AMEX      
CSM       	Largecap Core Proshares Lus                       	AMEX      
CTEK      	Cynergis Tek Inc                                  	AMEX      
CTO       	Consolidated-Tomoka Land Co                       	AMEX      
CUMB      	Virtus Cumberland Municipal Bond ETF              	AMEX      
CUO       	Continental Materials Corp                        	AMEX      
CURE      	Healthcare Bull 3X Direxion ETF                   	AMEX      
CUT       	MSCI Global Timber Invesco ETF                    	AMEX      
CVM       	Cel-Sci Corp                                      	AMEX      
CVR       	Chicago Rivet & Machine Co                        	AMEX      
CVRS      	Corindus Vascular Robotics Inc                    	AMEX      
CVU       	CPI Aerostructures                                	AMEX      
CVY       	Zacks Multi-Asset Income Invesco ETF              	AMEX      
CWAI      	Cwa Income ETF                                    	AMEX      
CWB       	Convertible Secs Barclays Capital SPDR            	AMEX      
CWEB      	Direxion CSI China Internet Idx Bull 2X           	AMEX      
CWI       	ACWI [Ex-Us] MSCI ETF SPDR                        	AMEX      
CWS       	Advisorshares Focused Equity ETF                  	AMEX      
CYB       	Wisdomtree Chinese Yuan Fund                      	AMEX      
CYM       	Cymat Technologies Ltd                            	AMEX      
CZA       	Zacks Mid-Cap Invesco ETF                         	AMEX      
DAG       	DB Agriculture 2X ETN Powershares                 	AMEX      
DALT      	Anfield Capital Diversified Alternatives ETF      	AMEX      
DAUD      	Citigroup Global Markets Holdings Inc             	AMEX      
DBA       	DB Agriculture Fund Invesco                       	AMEX      
DBAP      	Db-Xt MSCI Asia Pacific Ex-Japan Hgd Eq           	AMEX      
DBAW      	Db-Xt MSCI All World Ex-US Hgd Eq                 	AMEX      
DBB       	DB Base Metals Fund Invesco                       	AMEX      
DBC       	DB Commodity Index Tracking Fund Invesco          	AMEX      
DBE       	DB Energy Fund Invesco                            	AMEX      
DBEF      	Db-Xt MSCI EAFE Hgd Eq                            	AMEX      
DBEM      	Db-Xt MSCI EM Mkts Hgd Eq                         	AMEX      
DBEU      	Db-Xt MSCI Europe Hgd Eq                          	AMEX      
DBEZ      	Db-Xt MSCI Eurozone Hdg Eq                        	AMEX      
DBGR      	Db-Xt MSCI Germany Hgd Eq                         	AMEX      
DBJP      	Db-Xt MSCI Japan Hgd Eq                           	AMEX      
DBKO      	Db-Xt MSCI South Korea Hgd Eq                     	AMEX      
DBLV      	Advisorshares Doubleline Value Equity ETF         	AMEX      
DBO       	DB Oil Fund Invesco                               	AMEX      
DBP       	DB Precious Metals Fund Invesco                   	AMEX      
DBS       	DB Silver Fund Invesco                            	AMEX      
DBUK      	DB Xt MSCI UK Hedged Equity                       	AMEX      
DBV       	DB G10 Currency Harvest Fund Invesco              	AMEX      
DCHF      	Citigroup Global Markets Holdings Inc             	AMEX      
DDEZ      	Wisdomtree Europe Eqty Dynamic Currency Hedged    	AMEX      
DDG       	Oil & Gas Short Proshares                         	AMEX      
DDJP      	Wisdomtree Japan Eqty Dynamic Currency Hedged     	AMEX      
DDLS      	Wisdomtree Intl Smallcap Dynamic Currency Hedged  	AMEX      
DDM       	Ultra Dow 30 Proshares                            	AMEX      
DDP       	DB Commodity -1X ETN Powershares                  	AMEX      
DDWM      	Wisdomtree Intl Eqty Dynamic Currency Hedged      	AMEX      
DEEF      	Db-Xt FTSE Dvlpd Ex US Comp Factor ETF            	AMEX      
DEF       	Defensive Equity Invesco ETF                      	AMEX      
DEFA      	EAFE Adaptive Curr Hedged MSCI Ishares ETF        	AMEX      
DEM       	Emrg Mkts Equity Inc Wisdomtree                   	AMEX      
DEMG      	Db-Xt FTSE Emerging Comp Factor ETF               	AMEX      
DES       	Smallcap Dividend Wisdomtree                      	AMEX      
DESC      	Db-Xt Russell 2000 Comp Factor ETF                	AMEX      
DEUR      	Citigroup Global Markets Holdings Inc             	AMEX      
DEUS      	Db-Xt Russell 1000 Comp Factor ETF                	AMEX      
DEW       	Global Equity Income Wisdomtree                   	AMEX      
DEWJ      	Japan Adaptive Curr Hedged Ishares MSCI ETF       	AMEX      
DEZU      	Eurozone Adaptive Curr Hedged Ishares MSCI ETF    	AMEX      
DFE       	Europe Smallcap Dividend Wisdomtree               	AMEX      
DFEN      	Direxion Daily Aerospace Defense Bull 3X Shares   	AMEX      
DFJ       	Japan Smallcap Dividend Wisdomtree                	AMEX      
DFND      	Reality Divcon Dividend Defender ETF              	AMEX      
DGAZ      	Natural Gas -3X Inverse ETN Velocityshares        	AMEX      
DGBP      	Citigroup Global Markets Holdings Inc             	AMEX      
DGL       	DB Gold Fund Invesco                              	AMEX      
DGP       	DB Gold 2X ETN Powershares                        	AMEX      
DGRO      	Dividend Growth Ishares Core ETF                  	AMEX      
DGS       	Emrg Mkts Smallcap Div Wisdomtree                 	AMEX      
DGSE      	Dgse Companies Inc                                	AMEX      
DGT       	Global Dow ETF SPDR                               	AMEX      
DGZ       	DB Gold -1X ETN Powershares                       	AMEX      
DHDG      	Wisdomtree Intl Dividend Dynamic Currency Hedged  	AMEX      
DHS       	Equity Income Wisdomtree                          	AMEX      
DHVW      	Diamond Hill Valuation-Weighted                   	AMEX      
DHY       	Credit Suisse High Yield Bond Fund                	AMEX      
DIA       	Dow Industrials SPDR                              	AMEX      
DIAL      	Columbia Diversified Fixed Income Allocation ETF  	AMEX      
DIG       	Ultra Oil & Gas Proshares                         	AMEX      
DIM       	Intl Midcap Dividend Wisdomtree                   	AMEX      
DIT       	Amcon Distributing Company                        	AMEX      
DIV       	G-X Super Dividend ETF                            	AMEX      
DIVA      	Quantshares Hedged Dividend Income ETF            	AMEX      
DIVB      	US Dividend and Buyback Ishares ETF               	AMEX      
DIVO      	Amplify Yieldshares Cwp Dividend Option Inc ETF   	AMEX      
DIVY      	Reality Shares Divs ETF                           	AMEX      
DJCI      	DJ-UBS Commodity Idx TR ETN UBS E-Tracs           	AMEX      
DJD       	Dow Jones Indu Dividend Invesco ETF               	AMEX      
DJP       	Ipath.B Commodity Index TR ETN                    	AMEX      
DJPY      	Citigroup Global Markets Holdings Inc             	AMEX      
DLA       	Delta Apparel                                     	AMEX      
DLBR      	Velocityshares Short Libor                        	AMEX      
DLN       	Largecap Dividend Wisdomtree                      	AMEX      
DLS       	Intl Smallcap Dividend Wisdomtree                 	AMEX      
DMF       	Dreyfus Muni Income                               	AMEX      
DMRI      	Deltashares S&P Intl Managed Risk ETF             	AMEX      
DMRL      	Deltashares S&P 500 Managed Risk ETF              	AMEX      
DMRM      	Deltashares S&P 400 Managed Risk ETF              	AMEX      
DMRS      	Deltashares S&P 600 Managed Risk ETF              	AMEX      
DNL       	Global Ex-US Growth Wisdomtree                    	AMEX      
DNN       	Denison Mines Corp                                	AMEX      
DOD       	DJ High Yield Select 10 ETN Elements              	AMEX      
DOG       	Dow 30 Short Proshares                            	AMEX      
DOGS      	Arrow Dogs of The World ETF                       	AMEX      
DOL       	Intl Largecap Dividend Wisdomtree                 	AMEX      
DON       	Midcap Dividend Wisdomtree                        	AMEX      
DOO       	Intl Div Ex-Financials Wisdomtree                 	AMEX      
DPK       	Dev Mkts Bear 3X Direxion ETF                     	AMEX      
DPST      	Direxion Regional Banks Bull 3X                   	AMEX      
DPW       	Digital Power Corp                                	AMEX      
DQML      	Reality Shares Fundstrat Dqm Long ETF             	AMEX      
DRIP      	Direxion S&P Oil & Gas Expl Bear 3X               	AMEX      
DRN       	Real Estate Bull 3X Direxion                      	AMEX      
DRR       	Euro -2X ETN Vaneck                               	AMEX      
DRSK      	Aptus Defined Risk ETF                            	AMEX      
DRV       	Real Estate Bear 3X Direxion                      	AMEX      
DRW       	Global Ex-US Real Estate Wisdomtree               	AMEX      
DSI       	KLD 400 Social Ishares MSCI ETF                   	AMEX      
DSS       	Document Security Systems                         	AMEX      
DSTL      	Distillate U.S. Fundamental Stability & Value Et  	AMEX      
DSUM      	Chinese Yuan Dim Sum Bond Invesco ETF             	AMEX      
DTD       	Total Dividend Wisdomtree                         	AMEX      
DTEC      	Alps Disruptive Technologies ETF                  	AMEX      
DTH       	DEFA Equity Income Wisdomtree                     	AMEX      
DTN       	Dividend Ex-Financials Wisdomtree                 	AMEX      
DTO       	DB Crude Oil -2X ETN Powershares                  	AMEX      
DUG       	Ultrashort Oil & Gas Proshares                    	AMEX      
DURA      	Vaneck Vectors Morningstar Durable Dividend ETF   	AMEX      
DUSL      	Direxion Daily Industrials Bull 3X Shares         	AMEX      
DUST      	Gold Miners Bear 3X Direxion ETF                  	AMEX      
DVEM      	Wisdomtree EM Dividends Fund                      	AMEX      
DVHL      	Etracs Mt Pay 2X Dvrsfd High Income ETN           	AMEX      
DVP       	Deep Value ETF                                    	AMEX      
DVYA      	Asia/Pacific Dividend Ishares ETF                 	AMEX      
DVYE      	Emrg Mkts Dividend Ishares ETF                    	AMEX      
DVYL      	DJ 2X Select Dividend ETN                         	AMEX      
DWM       	DEFA Wisdomtree                                   	AMEX      
DWMF      	Wisdomtree International Multifactor Fund         	AMEX      
DWT       	Velocity 3X Inverse Crude Oil                     	AMEX      
DWX       	S&P Dividend Intl SPDR                            	AMEX      
DXD       	Ultrashort Dow 30 Proshares                       	AMEX      
DXF       	Dunxin Financial Holdings Ltd                     	AMEX      
DXJ       	Japan Hedged Equity Wisdomtree                    	AMEX      
DXJF      	Wisdomtree Japan Financials Hedged Fund           	AMEX      
DXR       	Daxor Corp                                        	AMEX      
DYB       	Wisdomtree Bearish U.S. Equity Fund               	AMEX      
DYLS      	Wisdomtree L/S US Eqty Dynamic                    	AMEX      
DYY       	DB Commodity 2X ETN Powershares                   	AMEX      
DZK       	Dev Mkts Bull 3X Direxion ETF                     	AMEX      
DZZ       	DB Gold -2X ETN Powershares                       	AMEX      
EAD       	Wells Fargo Advantage                             	AMEX      
EAGG      	Ishares ESG U.S. Aggregate Bond ETF               	AMEX      
EASG      	Xtrackers MSCI EAFE ESG Leaders Equity ETF        	AMEX      
EASI      	Amplify ETF Trust ETF                             	AMEX      
EBND      	EM Local Bond ETF Barclays Capital SPDR           	AMEX      
ECF       	Ellsworth Convertible Growth and Income           	AMEX      
ECF-A     	Ellsworth Fund Ltd                                	AMEX      
ECH       	Chile Ishares MSCI ETF                            	AMEX      
ECNS      	China Small-Cap Ishares MSCI ETF                  	AMEX      
ECON      	Emrg Mkts Consumer Egshares                       	AMEX      
EDC       	Emrg Mkts Bull 3X Direxion                        	AMEX      
EDEN      	Denmark Ishares MSCI ETF                          	AMEX      
EDIV      	S&P Emrg Mkts Dividend SPDR                       	AMEX      
EDOG      	Alps Emerging Sector Dividend                     	AMEX      
EDOM      	Wisdomtree Europe Domestic Ecomony Fund           	AMEX      
EDOW      	First Trust Dow 30 Equal Weight ETF               	AMEX      
EDV       	Extended Dur Trs Idx ETF Vanguard                 	AMEX      
EDZ       	Emrg Mkts Bear 3X Direxion                        	AMEX      
EEB       	BRIC Invesco ETF                                  	AMEX      
EED       	Xxeed - Claymore BNY BRIC ETF Intraday            	AMEX      
EEH       	Spectrum Lg Cap U.S. Sector ETN Elements          	AMEX      
EELV      	S&P Emerging Markets Low Vol Invesco ETF          	AMEX      
EEM       	Emerging Markets Ishares MSCI ETF                 	AMEX      
EEMD      	Aam S&P Emerging Markets High Dividend Value ETF  	AMEX      
EEMO      	S&P Emerging Markets Momentum Invesco ETF         	AMEX      
EEMS      	Emrg Mkts Small-Cap Ishares MSCI ETF              	AMEX      
EEMV      	Emrg Mkts Min Vol Ishares Edge MSCI ETF           	AMEX      
EEMX      	EM Fossil Fuel Reserves MSCI ETF SPDR             	AMEX      
EES       	Smallcap Earnings Wisdomtree                      	AMEX      
EET       	Ultra MSCI Emrg Mkts Proshares                    	AMEX      
EEV       	Ultrashort MSCI Emrg Mkts Proshares               	AMEX      
EFA       	EAFE Ishares MSCI ETF                             	AMEX      
EFAD      	EAFE Dividend Growth Proshares                    	AMEX      
EFAV      	EAFE Min Vol Ishares Edge MSCI ETF                	AMEX      
EFAX      	EAFE Fossil Fuel Reserves Free MSCI ETF SPDR      	AMEX      
EFFE      	G-X JPM Efficiente Index ETF                      	AMEX      
EFG       	EAFE Growth Ishares MSCI ETF                      	AMEX      
EFNL      	Finland Ishares MSCI ETF                          	AMEX      
EFO       	Ultra MSCI EAFE Proshares                         	AMEX      
EFU       	Ultrashort MSCI EAFE Proshares                    	AMEX      
EFV       	EAFE Value Ishares MSCI ETF                       	AMEX      
EFZ       	EAFE MSCI Short Proshares                         	AMEX      
EGI       	Entree Resources Ltd                              	AMEX      
EGPT      	Egypt Index ETF Vaneck                            	AMEX      
EIA       	Eaton Vance California Muni Bond II               	AMEX      
EIDO      	Indonesia Ishares MSCI ETF                        	AMEX      
EIM       	Eaton Vance Muni Bond Fund                        	AMEX      
EIO       	Eaton Vance Ohio Muni Bond Fund                   	AMEX      
EIP       	Eaton Vance Pennsylvania Muni Bond                	AMEX      
EIRL      	Ireland Ishares MSCI ETF                          	AMEX      
EIS       	Israel Ishares MSCI ETF                           	AMEX      
EIV       	Eaton Vance Muni Bond Fund II                     	AMEX      
EKAR      	Innovation Shares Nextgen Vehicles & Technology   	AMEX      
ELD       	Emrg Mkts Local Debt Wisdomtree                   	AMEX      
ELLO      	Ellomay Capital Ltd Ordinary Sh                   	AMEX      
ELMD      	Electromed Inc                                    	AMEX      
EMAG      	EM Aggregate Bond Vaneck ETF                      	AMEX      
EMAN      	Emagin Corp                                       	AMEX      
EMBH      	Int Rate Hedged Emrg Mkts Bond Ishares ETF        	AMEX      
EMDV      	Emerging Markets Proshares                        	AMEX      
EMEM      	Virtus Glovista Emerging Markets ETF              	AMEX      
EMFM      	G-X Next Emerging & Frontier ETF                  	AMEX      
EMGF      	Emrg Mkts Edge Multifactor Ishares MSCI ETF       	AMEX      
EMHY      	Emrg Mkts High Yield Bond Ishares ETF             	AMEX      
EMI       	Eaton Vance Michigan Muni Income Trust            	AMEX      
EMIH      	Db-Xt EM Bond Int Rate Hdged ETF                  	AMEX      
EMJ       	Eaton Vance New Jersey Muni Bond                  	AMEX      
EMLC      	Emrg Mkts Local Curr Bond ETF Vaneck              	AMEX      
EMLP      	North American Energy Infr Fund FT                	AMEX      
EMMF      	Wisdomtree Emerging Markets Multifactor Fund      	AMEX      
EMQQ      	Emrg Mkts Internet and Ecommerce Etc              	AMEX      
EMSH      	Short-Term USD EM Bond Proshares                  	AMEX      
EMTL      	EM Fixed Income ETF SPDR                          	AMEX      
EMTY      	Proshares Decline of The Retail Store ETF         	AMEX      
EMX       	Emx Royalty Group                                 	AMEX      
ENFR      	Alerian Energy Infrastructure E                   	AMEX      
ENOR      	Norway Ishares MSCI ETF                           	AMEX      
ENSV      	Enservco Corpporation                             	AMEX      
ENTR      	Entrepreneur 30 Fund                              	AMEX      
ENX       	Eaton Vance New York Muni Bond Fund               	AMEX      
ENY       	Canadian Energy Income Invesco ETF                	AMEX      
EPHE      	Philippines Ishares MSCI ETF                      	AMEX      
EPI       	India Earnings Wisdomtree                         	AMEX      
EPM       	Evolution Petroleum Corp                          	AMEX      
EPOL      	Poland Ishares MSCI ETF                           	AMEX      
EPP       	Pacific Ex Japan Ishares MSCI ETF                 	AMEX      
EPRF      	Elkhorn S&P High Quality Preferred                	AMEX      
EPS       	Earnings 500 Wisdomtree                           	AMEX      
EPU       	Peru All Ishares MSCI ETF                         	AMEX      
EPV       	Ultrashort FTSE Europe Proshares                  	AMEX      
EQAL      	Russell 1000 EW Invesco ETF                       	AMEX      
EQL       	Alps Equal Sector Weight ETF                      	AMEX      
EQLT      	Workplace Equality Portfolio ETF                  	AMEX      
EQWL      	Russell Top 200 EW Invesco ETF                    	AMEX      
EQWM      	Russell Midcap EW Invesco ETF                     	AMEX      
EQWS      	Russell 2000 EW Invesco ETF                       	AMEX      
ERC       	Wells Fargo Advantage Multi-Sector                	AMEX      
ERH       	Wells Fargo Advantage Utilities and High          	AMEX      
ERM       	Equitycompass Risk Manager ETF                    	AMEX      
ERUS      	Russia Ishares MSCI ETF                           	AMEX      
ERX       	Energy Bull 3X Direxion                           	AMEX      
ERY       	Energy Bear 3X Direxion                           	AMEX      
ESBA      	Empire State Realty Op LP                         	AMEX      
ESGF      	Global ESG Revenue ETF Oppenheimer                	AMEX      
ESGL      	ESG Revenue ETF Oppenheimer                       	AMEX      
ESGN      	Columbia Sustainable Internatio                   	AMEX      
ESGS      	Columbia Sustainable U.S. Equit                   	AMEX      
ESGV      	Vanguard ESG U.S. Stock ETF                       	AMEX      
ESGW      	Columbia Sustainable Global Equ                   	AMEX      
ESML      	USA Small-Cap ESG Optimized Ishares MSCI ETF      	AMEX      
ESNC      	Ensync Inc                                        	AMEX      
ESP       	Espey Mfg. & Electronics                          	AMEX      
ESPO      	Vaneck Vectors Video Gaming and Esports ETF       	AMEX      
ETHO      	Etho Climate Leadership U.S. ETF                  	AMEX      
EUDG      	Wisdomtree Europe Dividend Growth Fund            	AMEX      
EUDV      	Europe Dividend Proshares                         	AMEX      
EUFL      	Direxion European Financials Bull 2X              	AMEX      
EUFX      	Euro Short Proshares                              	AMEX      
EUM       	Emrg Mkts MSCI Short Proshares                    	AMEX      
EUMV      	Europe Min Vol Ishares Edge MSCI ETF              	AMEX      
EUO       	Ultrashort Euro Proshares                         	AMEX      
EURL      	Direxion FTSE Europe Bull 3X                      	AMEX      
EURZ      	Db-Xt MSCI Southern Europe Hedged Eqty ETF        	AMEX      
EUSA      	USA Equal Weighted Ishares MSCI ETF               	AMEX      
EUSC      	Wisdomtree Europe Hedged Smallcap Eqty ETF        	AMEX      
EUXL      	Direxion Daily Euro Stoxx 50 Bull 3X Shares       	AMEX      
EVBN      	Evans Bancorp                                     	AMEX      
EVI       	Envirostar Inc                                    	AMEX      
EVIX      	Velocityshares 1X Long Vstoxx Futures ETN         	AMEX      
EVJ       	Eaton Vance New Jersey Muni Income Trust          	AMEX      
EVM       	Eaton Vance California Muni Bond Fund             	AMEX      
EVO       	Eaton Vance Ohio Muni Income Trust                	AMEX      
EVP       	Eaton Vance Pennsylvania Muni Income Trust        	AMEX      
EVV       	Eaton Vance Limited Duration                      	AMEX      
EVX       	Environmental Svcs ETF Vaneck                     	AMEX      
EVY       	Eaton Vance New York Muni Income Trust            	AMEX      
EWA       	Australia Ishares MSCI ETF                        	AMEX      
EWC       	Canada Ishares MSCI ETF                           	AMEX      
EWCO      	Invesco S&P 500 Equal Weight Communication Servi  	AMEX      
EWD       	Sweden Ishares MSCI ETF                           	AMEX      
EWEM      	MSCI Emrg Markets Equal Country Weight Invesco E  	AMEX      
EWG       	Germany Ishares MSCI ETF                          	AMEX      
EWGS      	Germany Small-Cap Ishares MSCI ETF                	AMEX      
EWH       	Hong Kong Ishares MSCI ETF                        	AMEX      
EWI       	Italy Ishares MSCI ETF                            	AMEX      
EWJ       	Japan Ishares MSCI ETF                            	AMEX      
EWK       	Belgium Ishares MSCI ETF                          	AMEX      
EWL       	Switzerland Ishares MSCI ETF                      	AMEX      
EWM       	Malaysia Ishares MSCI ETF                         	AMEX      
EWMC      	S&P Midcap 400 EW Invesco ETF                     	AMEX      
EWN       	Netherlands Ishares MSCI ETF                      	AMEX      
EWO       	Austria Ishares MSCI ETF                          	AMEX      
EWP       	Spain Ishares MSCI ETF                            	AMEX      
EWQ       	France Ishares MSCI ETF                           	AMEX      
EWRE      	S&P 500 EW Real Estate Invesco ETF                	AMEX      
EWS       	Singapore Ishares MSCI ETF                        	AMEX      
EWSC      	S&P Smallcap 600 EW Invesco ETF                   	AMEX      
EWT       	Taiwan Ishares MSCI ETF                           	AMEX      
EWU       	United Kingdom Ishares MSCI ETF                   	AMEX      
EWUS      	United Kingdom Small-Cap Ishares MSCI ETF         	AMEX      
EWV       	Ultrashort MSCI Japan Proshares                   	AMEX      
EWW       	Mexico Ishares MSCI ETF                           	AMEX      
EWX       	S&P Emrg Mkts Smallcap SPDR                       	AMEX      
EWY       	South Korea Ishares MSCI ETF                      	AMEX      
EWZ       	Brazil Ishares MSCI ETF                           	AMEX      
EXI       	Global Industrials Ishares ETF                    	AMEX      
EXIV      	Velocityshares 1X Daily Inverse Vstoxx Futures E  	AMEX      
EXT       	Total Earnings Wisdomtree                         	AMEX      
EYLD      	Cambria Emerging Shareholder Yield ETF            	AMEX      
EZA       	South Africa Ishares MSCI ETF                     	AMEX      
EZJ       	Ultra MSCI Japan Proshares                        	AMEX      
EZM       	Midcap Earnings Wisdomtree                        	AMEX      
EZU       	Eurozone Ishares MSCI ETF                         	AMEX      
FAN       	Global Wind Energy First Trust                    	AMEX      
FANZ      	Prosports Sponsors ETF                            	AMEX      
FAS       	Financial Bull 3X Direxion                        	AMEX      
FAUS      	Australia Alphadex First Trust                    	AMEX      
FAX       	Aberdeen Asia-Pacific                             	AMEX      
FAZ       	Financial Bear 3X Direxion                        	AMEX      
FBGX      	FI Enhanced Large Cap Growth ETN                  	AMEX      
FBND      	Fidelity Total Bond ETF                           	AMEX      
FBT       	Biotechnology Index NYSE ETF                      	AMEX      
FCG       	Natural Gas ETF FT                                	AMEX      
FCO       	Aberdeen Global                                   	AMEX      
FCOM      	Fidelity Telecommunication MSCI ETF               	AMEX      
FCOR      	Fidelity Corporate Bond ETF                       	AMEX      
FCTR      	First Trust Lunt U.S. Factor Rotation ETF         	AMEX      
FDD       	Stoxx Euro Select Div First Trust                 	AMEX      
FDHY      	Fidelity High Yield Factor ETF                    	AMEX      
FDIS      	Fidelity Consumer Disc MSCI ETF                   	AMEX      
FDL       	Mstar Dividend Leaders                            	AMEX      
FDLO      	Fidelity Low Volatility Factor ETF                	AMEX      
FDM       	DJ Select Microcap First Trust                    	AMEX      
FDMO      	Fidelity Momentum Factor ETF                      	AMEX      
FDN       	DJ Internet Index First Trust                     	AMEX      
FDRR      	Fidelity Dividend ETF For Rising Rates            	AMEX      
FDVV      	Fidelity Core Dividend ETF                        	AMEX      
FEN       	Energy Income and Growth Fund                     	AMEX      
FENY      	Fidelity Energy MSCI ETF                          	AMEX      
FEU       	Stoxx Europe 50 SPDR                              	AMEX      
FEUL      	Credit Suisse FI Enhanced Europe 50 Etns          	AMEX      
FEZ       	Euro Stoxx 50 ETF SPDR                            	AMEX      
FFEU      	Barclays ETN FI Enhanced Europe 50 Exchange Tra   	AMEX      
FFHG      	Formula Folios Hedged Growth ETF                  	AMEX      
FFIU      	Fieldstone Uva Unconstrained Medium-Term Fixed I  	AMEX      
FFR       	FTSE En Dev Mkts Rel Est First Trust              	AMEX      
FFSG      	Formulafolios Smart Growth ETF                    	AMEX      
FFTG      	Formulafolios Tactical Growth ETF                 	AMEX      
FFTI      	Formula Folios Income ETF                         	AMEX      
FFTY      	Innovator Ibd 50 Fund ETF                         	AMEX      
FGD       	DJ Global Select Dividend First Trust             	AMEX      
FHLC      	Fidelity Health Care MSCI ETF                     	AMEX      
FIBR      	US Fixed Income Balanced Risk Ishares Edge ETF    	AMEX      
FIDI      	Fidelity International High Dividend ETF          	AMEX      
FIDU      	Fidelity Industrials MSCI ETF                     	AMEX      
FIEE      	FI Enhanced 2X Europe 50 ETN                      	AMEX      
FIEG      	FI Enhanced Global High Yield                     	AMEX      
FIHD      	FI Enhanced Global High Yield ETN                 	AMEX      
FILL      	Global Energy Producers Ishares MSCI ETF          	AMEX      
FINU      	Ultrapro Financials Proshares                     	AMEX      
FINZ      	Ultrapro Short Financials Proshares               	AMEX      
FISK      	Empire State Realty Op LP Se                      	AMEX      
FIVA      	Fidelity International Value Factor ETF           	AMEX      
FIW       	Water ETF FT                                      	AMEX      
FIYY      	Barclays Plc                                      	AMEX      
FLAG      	Weatherstorm Forensic Accounting                  	AMEX      
FLAU      	Australia Franklin FTSE ETF                       	AMEX      
FLAX      	Franklin Asia Ex Japan ETF                        	AMEX      
FLBL      	Franklin Liberty Senior Loan ETF                  	AMEX      
FLBR      	Brazil Franklin FTSE ETF                          	AMEX      
FLCA      	Canada Franklin FTSE ETF                          	AMEX      
FLCH      	China Franklin FTSE ETF                           	AMEX      
FLCO      	Liberty Investment Grade Corp ETF                 	AMEX      
FLDR      	Fidelity Low Duration Bond Factor ETF             	AMEX      
FLEE      	Europe Franklin FTSE ETF                          	AMEX      
FLEH      	Europe Hedged Franklin FTSE ETF                   	AMEX      
FLEU      	FI Enhanced Europe 50 ETN Series B                	AMEX      
FLFR      	France Franklin FTSE ETF                          	AMEX      
FLGB      	United Kingdom Franklin FTSE ETF                  	AMEX      
FLGE      	CS FI Large Cap Growth Enhanced ETN               	AMEX      
FLGR      	Germany Franklin FTSE ETF                         	AMEX      
FLHK      	Hong Kong Franklin FTSE ETF                       	AMEX      
FLHY      	Franklin Liberty High Yield Corp ETF              	AMEX      
FLIA      	Franklin Liberty Intl Aggregate Bond ETF          	AMEX      
FLIN      	Franklin India ETF                                	AMEX      
FLIO      	Franklin Intl Opportunities ETF                   	AMEX      
FLIY      	Italy Franklin FTSE ETF                           	AMEX      
FLJH      	Japan Hedged Franklin FTSE ETF                    	AMEX      
FLJP      	Japan Franklin FTSE ETF                           	AMEX      
FLKR      	South Korea Franklin FTSE ETF                     	AMEX      
FLLA      	Franklin FTSE Latin America ETF                   	AMEX      
FLLV      	Liberty US Low Volatility ETF                     	AMEX      
FLM       	Global Engineering and Construction ETF FT        	AMEX      
FLMB      	Franklin Liberty Municipal Bond ETF               	AMEX      
FLMI      	Franklin Liberty Intermediate Munic               	AMEX      
FLMX      	Mexico Franklin FTSE ETF                          	AMEX      
FLOT      	Floating Rate Bond Ishares ETF                    	AMEX      
FLQD      	Liberty Global Dividend                           	AMEX      
FLQE      	Liberty Emerging Marketfs ETF                     	AMEX      
FLQG      	Liberty Global Equity ETF                         	AMEX      
FLQH      	Liberty Intl Equity Hedged ETF                    	AMEX      
FLQL      	Franklin Libertyq U.S. Equity ETF                 	AMEX      
FLQM      	Franklin Libertyq U.S. Mid Cap Equity ETF         	AMEX      
FLQS      	Franklin Libertyq U.S. Small Cap Equity ETF       	AMEX      
FLRN      	Inv Growth Floating Rate ETF SPDR                 	AMEX      
FLRT      	Advisorshares Pacific Asset Enh                   	AMEX      
FLRU      	Franklin Russia ETF                               	AMEX      
FLSA      	Franklin FTSE Saudi Arabia ETF                    	AMEX      
FLSW      	Franklin Switzerland ETF                          	AMEX      
FLTB      	Fidelity Limited Term Bond ETF                    	AMEX      
FLTR      	Investment Grade Floating Rate Vaneck ETF         	AMEX      
FLTW      	Taiwan Franklin FTSE ETF                          	AMEX      
FLZA      	Franklin FTSE South Africa ETF                    	AMEX      
FM        	Frontier 100 Ishares MSCI ETF                     	AMEX      
FMAT      	Fidelity Materials MSCI ETF                       	AMEX      
FMDG      	Fieldstone Merlin Dynamic Large Cap Growth ETF    	AMEX      
FMF       	Mstar Managed Futures Strategy Fund FT            	AMEX      
FNCL      	Fidelity Financials MSCI ETF                      	AMEX      
FNDA      	Schwab Fundamental US Smallcap                    	AMEX      
FNDB      	Schwab Fundamental US Broad Market                	AMEX      
FNDC      	Schwab Fundamental Intl Smallcap                  	AMEX      
FNDE      	Schwab Fundamental EM Large Company               	AMEX      
FNDF      	Schwab Fundamental Intl Large Company             	AMEX      
FNDX      	Schwab Fundamental US Largecap                    	AMEX      
FNG       	Advisorshares New Tech and Media ETF              	AMEX      
FNGD      	BMO Rex Microsectors Fang Index -3X Inverse Lev   	AMEX      
FNGO      	Microsectors Fang Index 2X Leveraged Etns 01/08   	AMEX      
FNGU      	BMO Rex Microsectors Fang Index 3X Leveraged Ex   	AMEX      
FNGZ      	Microsectors Fang Index -2X Inverse Leveraged E   	AMEX      
FNI       	Chindia ETF FT                                    	AMEX      
FPE       	Preferred Securities and Income ETF FT            	AMEX      
FPEI      	FT Institutional Preferred Securities and Income  	AMEX      
FPX       	US IPO Index First Trust                          	AMEX      
FQAL      	Fidelity Quality Factor ETF                       	AMEX      
FRAK      	Unconventional Oil & Gas Vaneck ETF               	AMEX      
FRD       	Friedman Industries Inc                           	AMEX      
FREL      	Fidelity Real Estate MSCI ETF                     	AMEX      
FRI       	S&P REIT Index                                    	AMEX      
FRLG      	Large Cap Growth Index-Linked Exchange Traded No  	AMEX      
FRN       	Frontier Markets Invesco ETF                      	AMEX      
FSI       	Flexible Solutions International Inc              	AMEX      
FSP       	Franklin Street Properties                        	AMEX      
FSTA      	Fidelity Consumer Staples MSCI ETF                	AMEX      
FTEC      	Fidelity Info Tech MSCI ETF                       	AMEX      
FTF       	Franklin Templeton Limited Duration               	AMEX      
FTLS      	Long/Short Equity ETF FT                          	AMEX      
FTNW      	Fte Networks Inc                                  	AMEX      
FTSD      	Franklin Short Dur US Government ETF              	AMEX      
FTVA      	Aptus Fortified Value ETF                         	AMEX      
FUD       	CMCI Food TR ETN UBS E-Tracs                      	AMEX      
FUE       	MLCX Biofuels Index TR ETN Elements               	AMEX      
FUMB      	First Trust Ultra Short Duration Municipal ETF    	AMEX      
FUT       	Managed Futures Strategy Proshares                	AMEX      
FUTY      	Fidelity Utilities MSCI ETF                       	AMEX      
FVAL      	Fidelity Value Factor ETF                         	AMEX      
FVD       	Value Line Dividend Idx First Trust               	AMEX      
FVL       	Value Line 100 ETF First Trust                    	AMEX      
FWDB      	Madrona Global Bond ETF                           	AMEX      
FWDD      	Madrona Domestic ETF                              	AMEX      
FWDI      	Madrona International ETF                         	AMEX      
FXA       	Australian Dollar Trust Currencyshares Invesco    	AMEX      
FXB       	British Pound Sterling Trust Currencyshares Inve  	AMEX      
FXC       	Canadian Dollar Trust Currencyshares Invesco      	AMEX      
FXCH      	Chinese Renminbi Trust Currencyshares Invesco     	AMEX      
FXD       	Consumer Disc Alphadex First Trust                	AMEX      
FXE       	Euro Trust Currencyshares Invesco                 	AMEX      
FXF       	Swiss Franc Trust Currencyshares Invesco          	AMEX      
FXG       	Consumer Staples Alphadex First Trust             	AMEX      
FXH       	Healthcare Alphadex First Trust ETF               	AMEX      
FXI       	China Large-Cap Ishares ETF                       	AMEX      
FXL       	Technology Alphadex First Trust                   	AMEX      
FXN       	Energy Alphadex First Trust                       	AMEX      
FXO       	Financial Alphadex First Trust                    	AMEX      
FXP       	Ultrashort FTSE China 25 Proshares                	AMEX      
FXR       	Indust/Producer Dur Alphadex First Trust          	AMEX      
FXS       	Swedish Krona Trust Currencyshares Invesco        	AMEX      
FXSG      	Singapore Dollar Trust Currencyshares Invesco     	AMEX      
FXU       	Utilities Alphadex First Trust                    	AMEX      
FXY       	Japanese Yen Trust Currencyshares Invesco         	AMEX      
FXZ       	Materials Alphadex First Trust                    	AMEX      
FYLD      	Cambria Foreign Shareholder Yie                   	AMEX      
GAA       	Cambria Global Asset Allocation                   	AMEX      
GAL       	SSGA Global Allocation ETF SPDR                   	AMEX      
GAMR      	Purefunds Video Game Tech ETF                     	AMEX      
GARD      	Reality Divcon Dividend Guard ETF                 	AMEX      
GASL      	Natural Gas Bull 3X Direxion                      	AMEX      
GASX      	Direxion Natural Gas Bear 3X                      	AMEX      
GAZ       	Ipath Bloomberg Natural Gas Subindex Total Retur  	AMEX      
GAZB      	Ipath.B Natural Gas Subindex TR Series B ETN      	AMEX      
GBF       	Government/Credit Bond Ishares ETF                	AMEX      
GBIL      	GS Treasuryaccess 0-1 Year ETF                    	AMEX      
GBR       	New Concept Energy Inc                            	AMEX      
GCC       	Continuous Commodity Index                        	AMEX      
GCE       	CEF GS Connect ETN Claymore                       	AMEX      
GCOW      	Pacer Global Cash Cows Dividend                   	AMEX      
GDG       	Gadsdena Dynamica Growtha ETF                     	AMEX      
GDMA      	Gadsdena Dynamica Multi-Asseta ETF                	AMEX      
GDP       	Goodrich Petroleum Corp                           	AMEX      
GDVD      	Principal Active Global Dividend Income ETF       	AMEX      
GDX       	Gold Miners Vaneck ETF                            	AMEX      
GDXJ      	Junior Gold Miners ETF Vaneck                     	AMEX      
GDXS      	Ultrashort Gold Miner Proshares                   	AMEX      
GDXX      	Ultra Gold Miners Proshares                       	AMEX      
GEM       	GS Activebeta EM Equity ETF                       	AMEX      
GEX       	Global Alternatve Energy ETF Vaneck               	AMEX      
GGN       	Gamco Global Gold Natural Resources               	AMEX      
GGN-B     	Gamco Global Gold Natural Reou                    	AMEX      
GGO       	Gabelli Go Anywhere Trust                         	AMEX      
GGO-A     	The Gabelli Healthcare and Wellness Trust         	AMEX      
GHII      	S&P High Income Infrastructure Invesco ETF        	AMEX      
GHYB      	Access High Yield Corporate Bond ETF Goldman Sac  	AMEX      
GHYG      	US and Intl High Yield Corp Bond Ishares ETF      	AMEX      
GIGB      	Goldman Sachs Access Investment Grade Corp Bond   	AMEX      
GII       	FTSE Global Infra 100 SPDR                        	AMEX      
GLD       	Gold SPDR                                         	AMEX      
GLDM      	SPDR Gold Minishares Trust                        	AMEX      
GLDW      	Long Dollar Gold Trust SPDR                       	AMEX      
GLF       	Gulfmark Offshore Inc                             	AMEX      
GLF.W     	Gulfmark Offshore Inc WT                          	AMEX      
GLL       	Ultrashort Gold Proshares                         	AMEX      
GLO       	Clough Global Opportunities Fund                  	AMEX      
GLOW      	Glowpoint Inc                                     	AMEX      
GLQ       	Clough Global Equity Fund                         	AMEX      
GLTR      	Physical Precious Metals Basket                   	AMEX      
GLU       	Gabelli Global Utility                            	AMEX      
GLU-A     	The Gabelli Global Utility and                    	AMEX      
GLU.P     	Gabelli Global Utility & Income Trust             	AMEX      
GLV       	Clough Global Allocation Fund                     	AMEX      
GMF       	S&P Emerging Asia Pacific SPDR                    	AMEX      
GMFL      	Multi-Factor Large Cap Invesco ETF                	AMEX      
GMI       	Xxgmi - Market Vectors Gold Miners Index Intrada  	AMEX      
GMO       	General Moly Inc                                  	AMEX      
GMOM      	Cambria Global Momentum ETF                       	AMEX      
GNAF      	Microsectors Fang Index Inverse Etns 01/08/2023   	AMEX      
GNR       	S&P Global Natural Resources SPDR                 	AMEX      
GOAT      	Vaneck Vectors Morningstar Global Wide Moat ETF   	AMEX      
GOAU      	US Global Go Gold and Precious Metal Miners ETF   	AMEX      
GOEX      	G-X Gold Explorers ETF                            	AMEX      
GORO      	Gold Resource Corp                                	AMEX      
GOVT      	US Treasury Bond Ishares ETF                      	AMEX      
GPL       	Great Panther Silver Ltd                          	AMEX      
GQRE      	Flexshares Global Quality Real Estate             	AMEX      
GREK      	G-X FTSE Greece 20 ETF                            	AMEX      
GRES      	IQ Global Resources ETF                           	AMEX      
GRF       	Eagle Capital Growth Fund                         	AMEX      
GRI       	Global Realty Majors Cohen & Steers ETF           	AMEX      
GRMY      	Xtrackers Germany Equity ETF                      	AMEX      
GRNB      	Green Bond Vaneck ETF                             	AMEX      
GRU       	MLCX Grains Index TR ETN Elements                 	AMEX      
GSAT      	Globalstar                                        	AMEX      
GSB       	Globalscape                                       	AMEX      
GSC       	GS Connect S&P GSCI Enh Commodity TR ETN          	AMEX      
GSD       	Wisdomtree Global Smallcap Divd Fund              	AMEX      
GSEU      	GS Activebeta Europe Equity ETF                   	AMEX      
GSEW      	Equal Weight U.S. Large Cap Equity ETF Goldman S  	AMEX      
GSG       	S&P GSCI Commodity-Indexed Ishares ETF            	AMEX      
GSIE      	GS Activebeta International ETF                   	AMEX      
GSJY      	GS Activebeta Japan Equity ETF                    	AMEX      
GSLC      	GS Activebeta US Largecap ETF                     	AMEX      
GSP       	Ipath S&P GSCI Total Return Index ETN             	AMEX      
GSS       	Golden Star Resources Ltd                         	AMEX      
GSSC      	GS Activebeta U.S. Small Cap Equity ETF           	AMEX      
GSV       	Gold Standard Ventures Corp                       	AMEX      
GSY       	Ultra Short Duration Invesco ETF                  	AMEX      
GTE       	Gran Tierra Energy Inc                            	AMEX      
GTIP      	Goldman Sachs Access Inflation Protected USD Bon  	AMEX      
GTO       	Total Return Bond Invesco ETF                     	AMEX      
GUDB      	Sage ESG Intermediate Credit ETF                  	AMEX      
GUNR      	Mstar Global Upstream Natural Resources ETF       	AMEX      
GURU      	G-X Guru Index ETF                                	AMEX      
GUSH      	Direxion S&P Oil & Gas Expl Bull 3X               	AMEX      
GV        	Goldfield Corp                                    	AMEX      
GVAL      	Cambria Global Value ETF                          	AMEX      
GVI       	Interm Govt/Credit Bond Ishares ETF               	AMEX      
GVIP      	GS Hedge Industry Vip ETF                         	AMEX      
GWX       	S&P Smallcap Intl SPDR                            	AMEX      
GXC       	S&P China SPDR                                    	AMEX      
GXF       	G-X FTSE Nordic Region ETF                        	AMEX      
GXG       	G-X FTSE Colombia 20 ETF                          	AMEX      
GYLD      	Arrow DJ Global Yield ETF                         	AMEX      
HACK      	Etfmg Prime Cyber Security ETF                    	AMEX      
HAO       	China Small Cap Invesco ETF                       	AMEX      
HAP       	Rve Hard Assets Producers Vaneck ETF              	AMEX      
HAUD      	Australia Curr Hedged Ishares MSCI ETF            	AMEX      
HAWX      	ACWI Curr Hedged Ex US Ishares MSCI ETF           	AMEX      
HDAW      	Db-Xt MSCI All World Ex-US Div Yld Hgd Eq         	AMEX      
HDEF      	Db-Xt MSCI EAFE High Div Yld Hgd Eq               	AMEX      
HDG       	Hedge Replication Proshares                       	AMEX      
HDGE      	Active Bear ETF                                   	AMEX      
HDLV      	Etracs Mt Pay 2X US Hi Div Low Vol ETN            	AMEX      
HDMV      	Horizon Vol Dev Intl ETF FT                       	AMEX      
HDV       	High Dividend Ishares Core ETF                    	AMEX      
HEB       	Hemispherx Biopharma                              	AMEX      
HECO      	Ecological Strategy ETF                           	AMEX      
HEDJ      	Intl Hedged Equity Wisdomtree                     	AMEX      
HEEM      	Emrg Mkts Curr Hedged Ishares MSCI ETF            	AMEX      
HEFA      	EAFE Curr Hedged Ishares MSCI ETF                 	AMEX      
HEWC      	Canada Curr Hedged Ishares MSCI ETF               	AMEX      
HEWI      	Italy Curr Hedged Ishares MSCI ETF                	AMEX      
HEWJ      	Japan Curr Hedged Ishares MSCI ETF                	AMEX      
HEWL      	Switzerland Curr Hedged Ishares MSCI ETF          	AMEX      
HEWP      	Spain Curr Hedged Ishares MSCI ETF                	AMEX      
HEWU      	United Kingdom Curr Hedged Ishares MSCI ETF       	AMEX      
HEWW      	Mexico Curr Hedged Ishares MSCI ETF               	AMEX      
HEWY      	South Korea Curr Hedged Ishares MSCI ETF          	AMEX      
HEZU      	Eurozone Curr Hedged Ishares MSCI ETF             	AMEX      
HFXE      	IQ 50% Hedged FTSE Europe                         	AMEX      
HFXI      	IQ 50% Hedged FTSE International                  	AMEX      
HFXJ      	IQ 50% Hedged FTSE Japan                          	AMEX      
HGI       	Zacks Intl Multi- Asset Income Invesco ETF        	AMEX      
HGSD      	Wisdomtree Global Smallcap Hedged Fund            	AMEX      
HILO      	Low Vol EM Dividend ETF Egshares                  	AMEX      
HIPS      	Graniteshares US High Income ETF                  	AMEX      
HJPX      	Jpx-Nikkei 400 Curr Hedged Ishares ETF            	AMEX      
HLM.P     	Hillman Gr Cap 11.6                               	AMEX      
HLTH      	Nobilis Health Corp                               	AMEX      
HMG       	Hmg/Courtland Properties                          	AMEX      
HMOP      	Hartford Municipal Opportunities ETF              	AMEX      
HNW       	Pioneer Diversified High Income Trust             	AMEX      
HOLD      	Advisorshares Sage Core Reserve                   	AMEX      
HOML      	Etracs Mt Reset 2X ISE Exc Homebuilders ETN       	AMEX      
HONR      	Insightshares Patriotic Employers ETF             	AMEX      
HSCZ      	EAFE Small-Cap Curr Hedged Ishares MSCI ETF       	AMEX      
HSPX      	Horizons S&P 500 Covered Call                     	AMEX      
HSRT      	Hartford Short Duration ETF                       	AMEX      
HTRB      	Hartford Total Return Bond ETF                    	AMEX      
HTUS      	Hull Tactical US ETF                              	AMEX      
HUSA      	Houston American Energy Corp                      	AMEX      
HUSE      	US Equity Rotation Strategy ETF                   	AMEX      
HUSV      	Horizon Vol Domestic ETF FT                       	AMEX      
HVX       	Xxhvx - Market Vectors Environment Services Inde  	AMEX      
HYD       	High Yld Muni ETF Vaneck                          	AMEX      
HYDB      	High Yield Defensive Bond Ishares Edge ETF        	AMEX      
HYDD      	Direxion High Yield Bear 2X                       	AMEX      
HYDW      	Xtrackers Low Beta High Yield Bond ETF            	AMEX      
HYEM      	Emrg Mkts High Yield Bd ETF Vaneck                	AMEX      
HYG       	High Yield Corp Bond Ishares Iboxx $ ETF          	AMEX      
HYGH      	Int Rate Hedged High Yield Bond Ishares ETF       	AMEX      
HYGV      	Flexshares High Yield Value-Scored Bond Index Fu  	AMEX      
HYHG      	High Yld Interest Rate Proshares                  	AMEX      
HYIH      	Db-Xt HY Corp Bd Intr Rt Hdg                      	AMEX      
HYLB      	D-X USD Hi Yld Corp Bond ETF                      	AMEX      
HYLD      	Peritus High Yield ETF                            	AMEX      
HYLV      	Indexiq S&P High Yld Low Vol ETF                  	AMEX      
HYMB      	S&P Hi Yld Muni Bond SPDR                         	AMEX      
HYS       	0-5 Year Hi Yld Corp Bond Idx ETF Pimco           	AMEX      
HYUP      	Xtrackers High Beta High Yield Bond ETF           	AMEX      
HYXU      	Intl High Yield Corp Bond Ishares ETF             	AMEX      
IAF       	Aberdeen Australia Equity Fund Inc                	AMEX      
IAGG      	Intl Aggregate Bond Ishares Core ETF              	AMEX      
IAI       	US Broker-Dealers & Sec Exch Ishares ETF          	AMEX      
IAK       	US Insurance Ishares ETF                          	AMEX      
IAT       	US Regional Banks Ishares ETF                     	AMEX      
IAU       	Gold Trust Ishares                                	AMEX      
IAUF      	Ishares Gold Strategy ETF                         	AMEX      
IBCD      	Mar 2020 Term Corp Ex-Financials Ishares Ibonds   	AMEX      
IBCE      	Mar 2023 Term Corp Ex-Financials Ishares Ibonds   	AMEX      
IBD       	Inspire Corporate Bond Impact ETF                 	AMEX      
IBDC      	Ishares Mar 2020 Term Corp ETF                    	AMEX      
IBDD      	Mar 2023 Term Corp Ishares Ibonds ETF             	AMEX      
IBDH      	Dec 2018 Term Corp Ishares Ibonds ETF             	AMEX      
IBDK      	Dec 2019 Term Corp Ishares Ibonds ETF             	AMEX      
IBDL      	Dec 2020 Term Corp Ishares Ibonds ETF             	AMEX      
IBDM      	Dec 2021 Term Corp Ishares Ibonds ETF             	AMEX      
IBDN      	Dec 2022 Term Corp Ishares Ibonds ETF             	AMEX      
IBDO      	Dec 2023 Term Corp Ishares Ibonds ETF             	AMEX      
IBDP      	Dec 2024 Term Corp Ishares Ibonds ETF             	AMEX      
IBDQ      	Dec 2025 Term Corp Ishares Ibonds ETF             	AMEX      
IBDR      	Dec 2026 Term Corp Ishares Ibonds ETF             	AMEX      
IBDS      	Dec 2027 Term Corp Ishares Ibonds ETF             	AMEX      
IBDT      	Ishares Ibonds Dec 2028 Term Corporate ETF        	AMEX      
IBIO      	Ibio Inc                                          	AMEX      
IBKR      	Interactive Brokers                               	AMEX      
IBMH      	Sep 2019 Term Muni Bond Ishares Ibonds ETF        	AMEX      
IBMI      	Sep 2020 Term Muni Bond Ishares Ibonds ETF        	AMEX      
IBMJ      	Dec 2021 Term Muni Bond Ishares Ibonds ETF        	AMEX      
IBMK      	Dec 2022 Term Muni Bond Ishares Ibonds ETF        	AMEX      
IBML      	Dec 2023 Term Muni Bond Ishares Ibonds ETF        	AMEX      
IBMM      	Dec 2024 Term Muni Bond Ishares Ibonds ETF        	AMEX      
IBMN      	Ishares Ibonds Dec 2025 Term Muni Bond ETF        	AMEX      
IBND      	Intl Corp Bond ETF SPDR                           	AMEX      
ICAN      	Serenityshares Impact ETF                         	AMEX      
ICF       	Cohen & Steers REIT Ishares ETF                   	AMEX      
ICOL      	Colombia Ishares MSCI ETF                         	AMEX      
ICOW      	Pacer Developed Markets International Cash Cows   	AMEX      
ICSH      	Ultra Short-Term Ishares ETF                      	AMEX      
ICVT      	Convertible Bond Ishares ETF                      	AMEX      
IDEV      	Intl Devd Markets Ishares Core MSCI ETF           	AMEX      
IDHD      	S&P Intl Developed Hi Div Low Vol Invesco ETF     	AMEX      
IDHQ      	S&P Intl Developed Quality Invesco ETF            	AMEX      
IDIV      	U.S. Equity Cumulative Dividends Fund Series 202  	AMEX      
IDLV      	S&P Intl Developed Low Vol Invesco ETF            	AMEX      
IDMO      	S&P Intl Developed Momentum Invesco ETF           	AMEX      
IDN       	Intellicheck Mobilisia                            	AMEX      
IDOG      	Alps International Sector Dividend                	AMEX      
IDU       	US Utilities Ishares ETF                          	AMEX      
IDV       	Intl Select Dividend Ishares ETF                  	AMEX      
IDX       	Indonesia Index ETF Vaneck                        	AMEX      
IEC       	IEC Electronics                                   	AMEX      
IECS      	US Consumer Staples Ishares Evolved ETF           	AMEX      
IEDI      	US Discretionary Spending Ishares Evolved ETF     	AMEX      
IEFA      	EAFE Ishares Core MSCI ETF                        	AMEX      
IEFN      	US Financials Ishares Evolved ETF                 	AMEX      
IEHS      	US Healthcare Staples Ishares Evolved ETF         	AMEX      
IEIH      	US Innovative Healthcare Ishares Evolved ETF      	AMEX      
IEMD      	Invesco Emerging Markets Debt Defensive ETF       	AMEX      
IEME      	US Media and Entertainment Ishares Evolved ETF    	AMEX      
IEMG      	Emrg Mkts Ishares Core MSCI ETF                   	AMEX      
IEMV      	Invesco Emerging Markets Debt Value ETF           	AMEX      
IEO       	US Oil & Gas Explor & Prod Ishares ETF            	AMEX      
IETC      	US Technology Ishares Evolved ETF                 	AMEX      
IEUR      	Europe Ishares Core MSCI ETF                      	AMEX      
IEV       	Europe 350 Ishares ETF                            	AMEX      
IEZ       	US Oil Equipment & Services Ishares ETF           	AMEX      
IFIX      	DB-X Barclays Inter Corp Bh ETF                   	AMEX      
IFLY      	Purefunds Drone Economy Strategy ETF              	AMEX      
IFRA      	US Infrastructure Ishares ETF                     	AMEX      
IG        	Principal Investment Grade Corporate Active ETF   	AMEX      
IGBH      	Int. Rate Hedged Long-Term Corp Bond Ishares      	AMEX      
IGE       	Natural Resources North American Ishares ETF      	AMEX      
IGEB      	Invst Grade Enhanced Bond Ishares Edge ETF        	AMEX      
IGHG      	Invest Grade Interest Rate Proshares              	AMEX      
IGIH      	Db-Xt Invt Grd Bd Intr Rt Hdg                     	AMEX      
IGLB      	Long-Term Corp Bond Ishares ETF                   	AMEX      
IGM       	North American Tech Ishares ETF                   	AMEX      
IGN       	North American Tech-Multimedia Networking Ishare  	AMEX      
IGRO      	Intl Dividend Growth Ishares ETF                  	AMEX      
IGV       	North American Tech-Software Ishares ETF          	AMEX      
IGVT      	DB-X Barclays Inter Treas Bh ETF                  	AMEX      
IHDG      	Wisdomtree Intl Hedged Fund                       	AMEX      
IHE       	US Pharmaceuticals Ishares ETF                    	AMEX      
IHF       	US Healthcare Providers Ishares ETF               	AMEX      
IHI       	US Medical Devices Ishares ETF                    	AMEX      
IHT       	Innsuites Hospitality Trust                       	AMEX      
IHY       	Intl High Yield Bond ETF Vaneck                   	AMEX      
IHYD      	Invesco Corp Income Defensive ETF                 	AMEX      
IHYV      	Invesco Corporate Income Value ETF                	AMEX      
IIGD      	Invesco Investment Grade Defensive ETF            	AMEX      
IJH       	S&P Mid-Cap 400 Ishares Core ETF                  	AMEX      
IJJ       	S&P Mid-Cap 400 Value Ishares ETF                 	AMEX      
IJK       	S&P Mid-Cap 400 Growth Ishares ETF                	AMEX      
IJR       	S&P Small-Cap Ishares Core ETF                    	AMEX      
IJS       	S&P Small-Cap 600 Value Ishares ETF               	AMEX      
ILF       	Latin America 40 Ishares ETF                      	AMEX      
ILTB      	10+ Year USD Bond Ishares Core ETF                	AMEX      
IMFC      	Invesco Multi-Factor Core Fixed Income ETF        	AMEX      
IMH       	Impac Mortgage Holdings                           	AMEX      
IMLP      	Ipath S&P MLP ETN                                 	AMEX      
IMO       	Imperial Oil Ltd                                  	AMEX      
IMOM      	Intl Quantitative Momentum ETF                    	AMEX      
IMTB      	5-10 Year USD Bond Ishares Core ETF               	AMEX      
IMTM      	Intl Momentum Factor Ishares Edge MSCI ETF        	AMEX      
INCO      	India Consumer Egshares                           	AMEX      
INDA      	India MSCI Ishares ETF                            	AMEX      
INDL      	India Bull 3X Direxion                            	AMEX      
INDS      	Pacer Benchmark Industrial Real Estate Sctr ETF   	AMEX      
INFU      	Infusystems Holdings                              	AMEX      
INKM      	SSGA Income Allocation ETF SPDR                   	AMEX      
INR       	INR/USD ETN Vaneck                                	AMEX      
INS       	Intelligent Systems Corp                          	AMEX      
INTF      	Intl Multifactor Ishares Edge MSCI ETF            	AMEX      
INTT      	Intest Corp                                       	AMEX      
INUV      	Inuvo Inc                                         	AMEX      
INXX      	India Infrastructure Egshares                     	AMEX      
IOO       	Global 100 Ishares ETF                            	AMEX      
IOR       	Income Opportunity Realty Trust                   	AMEX      
IPAC      	Pacific Ishares Core MSCI ETF                     	AMEX      
IPAY      	Purefunds ISE Mobile Payments ETF                 	AMEX      
IPB       	Merrill Lynch & Co                                	AMEX      
IPE       	TIPS Barclays ETF SPDR                            	AMEX      
IPFF      	Intl Preferred Stock Ishares ETF                  	AMEX      
IPO       	Renaissance IPO ETF                               	AMEX      
IPOS      	Renaissance Capital Greenwich Fund                	AMEX      
IQDE      	Flexshares Intl Quality Div Def Fund              	AMEX      
IQDF      	Flexshares Intl Quality Div Fund                  	AMEX      
IQDG      	Wisdomtree Intl Quality Divd Growth Fund          	AMEX      
IQDY      	Flexshares Intl Quality Div Dyn Fund              	AMEX      
IQLT      	Intl Quality Factor Ishares Edge MSCI ETF         	AMEX      
IRBO      	Ishares Robotics and Artificial Intelligence ETF  	AMEX      
ISCF      	Intl Small-Cap Multifactor Ishares Edge MSCI ETF  	AMEX      
ISDR      	Issuer Direct Corp                                	AMEX      
ISMD      	Inspire Small/Mid Cap Impact ETF                  	AMEX      
ISR       	Isoray Inc                                        	AMEX      
ISRA      	Israel Vaneck ETF                                 	AMEX      
ISZE      	Intl Size Factor Ishares Edge MSCI ETF            	AMEX      
ITA       	US Aerospace & Defense Ishares ETF                	AMEX      
ITB       	US Home Construction Ishares ETF                  	AMEX      
ITE       	Interm-Term Treasury ETF SPDR                     	AMEX      
ITEQ      	Bluestar Israel Technology ETF                    	AMEX      
ITM       	Interm Muni ETF Vaneck                            	AMEX      
ITOT      	S&P Total US Stock Market Ishares Core ETF        	AMEX      
ITP       	IT Tech Packaging Inc                             	AMEX      
IVAL      	Intl Quantitative Valueshares ETF                 	AMEX      
IVE       	S&P 500 Value Ishares ETF                         	AMEX      
IVLU      	Intl Value Factor Ishares Edge MSCI ETF           	AMEX      
IVOG      	S&P Midcap 400 Growth ETF Vanguard                	AMEX      
IVOO      	S&P Midcap 400 ETF Vanguard                       	AMEX      
IVOV      	S&P Midcap 400 Value ETF Vanguard                 	AMEX      
IVV       	S&P 500 Ishares Core ETF                          	AMEX      
IVW       	S&P 500 Growth Ishares ETF                        	AMEX      
IWB       	Russell 1000 Ishares ETF                          	AMEX      
IWC       	Micro-Cap Ishares ETF                             	AMEX      
IWD       	Russell 1000 Value Ishares ETF                    	AMEX      
IWF       	Russell 1000 Growth Ishares ETF                   	AMEX      
IWL       	Russell Top 200 Ishares ETF                       	AMEX      
IWM       	Russell 2000 Ishares ETF                          	AMEX      
IWN       	Russell 2000 Value Ishares ETF                    	AMEX      
IWO       	Russell 2000 Growth Ishares ETF                   	AMEX      
IWP       	Russell Mid-Cap Growth Ishares ETF                	AMEX      
IWR       	Russell Mid-Cap Ishares ETF                       	AMEX      
IWS       	Russell Mid-Cap Value Ishares ETF                 	AMEX      
IWV       	Russell 3000 Ishares ETF                          	AMEX      
IWX       	Russell Top 200 Value Ishares ETF                 	AMEX      
IWY       	Russell Top 200 Growth Ishares ETF                	AMEX      
IXC       	Global Energy Ishares ETF                         	AMEX      
IXG       	Global Financials Ishares ETF                     	AMEX      
IXJ       	Global Healthcare Ishares ETF                     	AMEX      
IXN       	Global Tech Ishares ETF                           	AMEX      
IXP       	Global Telecom Ishares ETF                        	AMEX      
IYC       	US Consumer Services Ishares ETF                  	AMEX      
IYE       	US Energy Ishares ETF                             	AMEX      
IYF       	US Financials Ishares ETF                         	AMEX      
IYG       	US Financial Services Ishares ETF                 	AMEX      
IYH       	US Healthcare Ishares ETF                         	AMEX      
IYJ       	US Industrials Ishares ETF                        	AMEX      
IYK       	US Consumer Goods Ishares ETF                     	AMEX      
IYLD      	Mstar Multi-Asset Income Ishares ETF              	AMEX      
IYM       	US Basic Materials Ishares ETF                    	AMEX      
IYR       	US Real Estate Ishares ETF                        	AMEX      
IYT       	Transportation Average Ishares ETF                	AMEX      
IYW       	US Technology Ishares ETF                         	AMEX      
IYY       	DJ US Ishares ETF                                 	AMEX      
IYZ       	US Telecommunications Ishares ETF                 	AMEX      
IZRL      	Ark Israel Innovative Technology ETF              	AMEX      
JBRI      	James Biblically Responsible Investment ETF       	AMEX      
JDIV      	JPM U.S. Dividend ETF                             	AMEX      
JDST      	Direxion Junior Gold Mine Bear 3X                 	AMEX      
JETS      	US Global Jets ETF                                	AMEX      
JHDG      	Wisdomtree Japan Divd Hedged Fund                 	AMEX      
JHEM      	John Hancock Multifactor Emerging Markets ETF     	AMEX      
JHMA      	JH Materials Multifactor ETF                      	AMEX      
JHMC      	JH Consumer Disc Multifactor ETF                  	AMEX      
JHMD      	JH Developed Intl Multifactor ETF                 	AMEX      
JHME      	JH Energy Multifactor ETF                         	AMEX      
JHMF      	JH Financial Multifactor ETF                      	AMEX      
JHMH      	JH Healthcare Multifactor ETF                     	AMEX      
JHMI      	JH Industrials Multifactor ETF                    	AMEX      
JHML      	JH Largecap Multifactor ETF                       	AMEX      
JHMM      	JH Midcap Multifactor ETF                         	AMEX      
JHMS      	JH Consumer Staples Multifactor ETF               	AMEX      
JHMT      	JH Technology Multifactor ETF                     	AMEX      
JHMU      	JH Utilities Multifactor ETF                      	AMEX      
JHSC      	John Hancock Multifactor Small Cap ETF            	AMEX      
JJA       	Ipatha Agriculture Subindex Total Return ETN      	AMEX      
JJAB      	Ipath.B Agriculture Subindex TR Series B ETN      	AMEX      
JJC       	Ipatha Copper Subindex Total Return ETN           	AMEX      
JJCB      	Ipath.B Copper Subindex TR Series B ETN           	AMEX      
JJE       	Ipatha Energy Subindex Total Return ETN           	AMEX      
JJEB      	Ipath.B Energy Subindex TR Series B ETN           	AMEX      
JJG       	Ipatha Grains Subindex Total Return ETN           	AMEX      
JJGB      	Ipath.B Grains Subindex TR Series B ETN           	AMEX      
JJM       	Ipatha Industrial Metals Subindex Total Retur     	AMEX      
JJMB      	Ipath.B Industrial Metals Subindex TR Series B E  	AMEX      
JJN       	Ipath.B Nickel Subindex TR Series B ETN           	AMEX      
JJP       	Ipatha Precious Metals Subindex Total Return      	AMEX      
JJPB      	Ipath.B Precious Metals Subindex TR Series B ETN  	AMEX      
JJS       	Ipatha Softs Subindex Total Return ETN            	AMEX      
JJSB      	Ipath.B Softs Subindex TR Series B ETN            	AMEX      
JJT       	Ipatha Tin Subindex Total Return ETN              	AMEX      
JJTB      	Ipath.B Tin Subindex TR Series B ETN              	AMEX      
JJU       	Ipatha Aluminum Subindex Total Return ETN         	AMEX      
JJUB      	Ipath.B Aluminum Subindex TR Series B ETN         	AMEX      
JKD       	Mstar Large-Cap Ishares ETF                       	AMEX      
JKE       	Mstar Large-Cap Growth Ishares ETF                	AMEX      
JKF       	Mstar Large-Cap Value Ishares ETF                 	AMEX      
JKG       	Mstar Mid-Cap Ishares ETF                         	AMEX      
JKH       	Mstar Mid-Cap Growth Ishares ETF                  	AMEX      
JKJ       	Mstar Small-Cap Ishares ETF                       	AMEX      
JKK       	Mstar Small-Cap Growth Ishares ETF                	AMEX      
JKL       	Mstar Small-Cap Value Ishares ETF                 	AMEX      
JMBS      	Janus Henderson Mortgage-Backed Securities ETF    	AMEX      
JMIN      	JPM U.S. Minimum Volatility ETF                   	AMEX      
JMOM      	JPM U.S. Momentum Factor ETF                      	AMEX      
JMST      	Jpmorgan Ultra-Short Municipal ETF                	AMEX      
JMUB      	Jpmorgan Municipal ETF                            	AMEX      
JNK       	High Yield Bond ETF SPDR                          	AMEX      
JNUG      	Direxion Junior Gold Mine Bull 3X                 	AMEX      
JO        	Ipath.B Coffee Subindex TR Series B ETN           	AMEX      
JOB       	General Employment Enterprises                    	AMEX      
JPBI      	James Purpose Based Investment ETF                	AMEX      
JPED      	JPM Event Driven ETF                              	AMEX      
JPEH      	JPM Dvsd Rtns Europe Currency Hedged              	AMEX      
JPEM      	JPM Dvsd Rtns EM ETF                              	AMEX      
JPEU      	JPM Dvsd Rtns Europe Equity ETF                   	AMEX      
JPGB      	JPM Global Bond Opportunities ETF                 	AMEX      
JPGE      	JPM Dvsd Rtns Global Equity                       	AMEX      
JPHF      	JPM Dvsd Alternatives ETF                         	AMEX      
JPHY      	JPM Diversified High Yield ETF                    	AMEX      
JPIH      	JPM Dvsd Rtns Intl Currency Hedged                	AMEX      
JPIN      	JPM Dvsd Rtns Intl Equity ETF                     	AMEX      
JPLS      	JPM Long/Short ETF                                	AMEX      
JPMB      	JPM USD Emrg Mkts Sovereign Bond ETF              	AMEX      
JPME      	JPM Dvsd Rtns US Midcap ETF                       	AMEX      
JPMF      	JPM Managed Futures Strategy ETF                  	AMEX      
JPMV      	Japan Min Vol Ishares Edge MSCI ETF               	AMEX      
JPN       	Db-Xt Jpn Jpx Nikkei 400 Eq                       	AMEX      
JPNL      	Direxion Japan Bull 3X                            	AMEX      
JPSE      	JPM Dvsd Rtns US Smallcap Equity ETF              	AMEX      
JPST      	JPM Ultra-Short Income ETF                        	AMEX      
JPUS      	JPM Dvsd Rtns US Equity ETF                       	AMEX      
JPXN      	Jpx-Nikkei 400 Ishares ETF                        	AMEX      
JQUA      	JPM U.S. Quality Factor ETF                       	AMEX      
JUST      	Goldman Sachs Just U.S. Large Cap Equity ETF      	AMEX      
JVAL      	JPM U.S. Value Factor ETF                         	AMEX      
JXI       	Global Utilities Ishares ETF                      	AMEX      
KALL      	Kraneshares MSCI All China Index ETF              	AMEX      
KARS      	Kraneshares Electric Vehicles and Future Mobilit  	AMEX      
KBA       	Kranes Bosera MSCI China A                        	AMEX      
KBE       	S&P Bank ETF SPDR                                 	AMEX      
KCCB      	Kraneshares Ccbs China Corporate High Yield Bond  	AMEX      
KCE       	S&P Capital Markets ETF SPDR                      	AMEX      
KCNY      	Kranes E Fund China Comm Paper ETF                	AMEX      
KEMQ      	Kraneshares Emerging Markets Consumer Technology  	AMEX      
KFYP      	Kranes New China ETF                              	AMEX      
KGRN      	Kraneshares MSCI China Environment Index ETF      	AMEX      
KIE       	S&P Insurance ETF SPDR                            	AMEX      
KIQ       	Kelso Technologies I                              	AMEX      
KLDW      	Exchange Listed Funds Trust Gav                   	AMEX      
KLX       	Xxklx - Market Vectors Steel Index Intraday       	AMEX      
KMED      	Kraneshares Emerging Markets Healthcare Index     	AMEX      
KNG       	ETF Series Solutions ETF CBOE Vest S&P 500 Divid  	AMEX      
KNOW      	All Cap Insider Sentiment Direxion                	AMEX      
KOIN      	Innovation Shares Nextgen Protocol ETF            	AMEX      
KOL       	Coal ETF Vaneck                                   	AMEX      
KOLD      	Ultrashort Natural Gas Proshares                  	AMEX      
KOMP      	SPDR Kensho & New Economies Composite ETF         	AMEX      
KORP      	American Century Dvfd Corp Bond ETF               	AMEX      
KORU      	Direxion South Korea Bull 3X                      	AMEX      
KRE       	S&P Regional Banking ETF SPDR                     	AMEX      
KSA       	Saudi Arabia Ishares MSCI ETF                     	AMEX      
KURE      	Kraneshares MSCI All China Health Care Index ETF  	AMEX      
KWEB      	Kranes CSI China ETF                              	AMEX      
KXI       	Global Cons Staples Ishares ETF                   	AMEX      
LABD      	Direxion S&P Biotech Bear 3X                      	AMEX      
LABU      	Direxion S&P Biotech Bull 3X                      	AMEX      
LBDC      	Etracs Mt Pay 2X Levd Wells Bdc ETN Series B      	AMEX      
LBJ       	Latin America Bull 3X Direxion                    	AMEX      
LBY       	Libbey Inc                                        	AMEX      
LD        	Ipath Bloomberg Lead Subindex Total Return Sm In  	AMEX      
LDRS      	Innovator Ibd ETF Leaders ETF                     	AMEX      
LDUR      	Pimco Low Duration ETF                            	AMEX      
LEAD      	Reality Divcon Leaders Dividend ETF               	AMEX      
LEMB      	Emrg Mkts Local Curr Bond Ishares JPM ETF         	AMEX      
LEU       	Centrus Energy Corp                               	AMEX      
LEVB      	Level Brands Inc                                  	AMEX      
LFEQ      	Vaneck Vectors Ndr Cmg Long/Flat Allocation ETF   	AMEX      
LGL       	LGL Group                                         	AMEX      
LGLV      	SSGA US Large Cap Low Vol Index SPDR              	AMEX      
LIQT      	Liqtech International Inc                         	AMEX      
LIT       	G-X Lithium ETF                                   	AMEX      
LLEX      	Lilis Energy Inc                                  	AMEX      
LLQD      	10+ Year Invst Grade Corp Bond Ishares ETF        	AMEX      
LMLP      	Etracs Mt Pay 2X MLP Ex-Energy ETN                	AMEX      
LNG       	Cheniere Energy                                   	AMEX      
LODE      	Comstock Mining Inc                               	AMEX      
LOUP      	Innovator Loup Frontier Tech E                    	AMEX      
LOV       	Spark Networks Plc                                	AMEX      
LOWC      	ACWI Low Carbon Target MSCI ETF SPDR              	AMEX      
LQD       	Invst Grade Corp Bond Ishares Iboxx $ ETF         	AMEX      
LQDH      	Int Rate Hedged Corp Bond Ishares ETF             	AMEX      
LQDI      	Ishares Inflation Hedged Corporate Bond ETF       	AMEX      
LRET      	Etracs Mt Pay 2X MSCI US REIT Index ETN           	AMEX      
LRGF      	USA Multifactor Ishares Edge MSCI ETF             	AMEX      
LSAF      	Leadershares Alphafactor US Core Equity ETF       	AMEX      
LSST      	Natixis Loomis Sayles Short Duration Income ETF   	AMEX      
LTL       	Ultra Telecommunications Proshares                	AMEX      
LTPZ      	15+ Year US TIPS Index ETF Pimco                  	AMEX      
LTS       	Ladenburg Thalmann Financial Inc                  	AMEX      
LTS-A     	Ladenburg Thalmann Financial Se                   	AMEX      
LTSF      	Ladenburg Thalmann Financial Services Inc. 7.00%  	AMEX      
LTSK      	Ladenburg Thalmann Financial Services Inc 7.25%   	AMEX      
LTSL      	Ladenburg Thalmann Financial Services Inc 6.50%   	AMEX      
LVHB      	Elkhorn Lunt Low Vol/High Beta Tactical ETF       	AMEX      
LVHE      	Legg EM Low Vol Hi Div ETF                        	AMEX      
LVHI      	Legg Intl Low Vol High Div ETF                    	AMEX      
LVIN      	Multifactor Low Volatility International Equity   	AMEX      
LVL       	S&P Global Dividend Opportunities Index Invesco   	AMEX      
LVUS      	Multifactor Low Volatility US Equity ETF          	AMEX      
MAB       	Eaton Vance Massachusetts Muni Bond               	AMEX      
MAG       	MAG Silver Corp                                   	AMEX      
MAGA      	Point Bridge Gop Stock Tracker ETF                	AMEX      
MBG       	Mortgage Backed Bond ETF SPDR                     	AMEX      
MCF       	Contango Oil & Gas Company                        	AMEX      
MCRO      	IQ Hedge Macro Tracker ETF                        	AMEX      
MDY       	S&P Midcap 400 SPDR                               	AMEX      
MDYG      	S&P Midcap Growth ETF SPDR                        	AMEX      
MDYV      	S&P Midcap Value ETF SPDR                         	AMEX      
MEAR      	Short Maturity Muni Bond Ishares ETF              	AMEX      
MEXX      	Direxion Daily MSCI Mexico Bull 3X Shares         	AMEX      
MFDX      	Pimco RAFI Dynamic Multi-Factor Internation       	AMEX      
MFEM      	Pimco RAFI Dynamic Multi-Factor Emerging Ma       	AMEX      
MFMS      	Motley Fool Small-Cap Growth ETF                  	AMEX      
MFUS      	Pimco RAFI Dynamic Multi-Factor U.S. Equity       	AMEX      
MGC       	Megacap 300 Index ETF Vanguard                    	AMEX      
MGK       	Megacap 300 Growth Index ETF Vanguard             	AMEX      
MGV       	Megacap 300 Value Index ETF Vanguard              	AMEX      
MHH       	Mastech Holdings Inc                              	AMEX      
MICR      	Micron Solutions Inc                              	AMEX      
MIDU      	Direxion Mid Cap Bull 3X                          	AMEX      
MIDZ      	Midcap Bear 3X Direxion                           	AMEX      
MINC      	Advisorshares Newfleet Multi-Se                   	AMEX      
MINT      	Enhanced Short-Maturity Strgy ETF Pimco           	AMEX      
MIW       	Eaton Vance Michigan Muni Bond Fund               	AMEX      
MJ        	Etfmg Alternative Harvest ETF                     	AMEX      
MJCO      	Majesco                                           	AMEX      
MLN       	Long Municipal Index ETF Vaneck                   	AMEX      
MLPA      	G-X MLP ETF                                       	AMEX      
MLPB      	Etracs Alerian MLP Infrastruc ETN                 	AMEX      
MLPC      	C-Tracks MLP Miller/Howard Perf Fundamental       	AMEX      
MLPE      	C-Tracks MLP Miller/Howard Fundamental Series B   	AMEX      
MLPG      	Alerian Natural Gas MLP ETN UBS E-Tracs           	AMEX      
MLPI      	Alerian MLP Infrastrctr ETN UBS E-Tracs           	AMEX      
MLPO      	CS S&P MLP Index ETN                              	AMEX      
MLPQ      	Etracs Mt 2X Alerian MLP Infra ETN Series B       	AMEX      
MLPX      	G-X MLP & Energy Infrasture ETF                   	AMEX      
MLPY      	Cushing MLP Hi Income ETN Morgan Stanley          	AMEX      
MLPZ      	Etracs Mt 2X S&P MLP ETN Series B                 	AMEX      
MLQD      	5-10 Year Invst Grade Corp Bond Ishares ETF       	AMEX      
MLSS      	Milestone Scientific                              	AMEX      
MLTI      	CS X-Links Multi-Asset High Income ETN            	AMEX      
MMIN      	IQ Mackay Shields Municipal Insured ETF           	AMEX      
MMIT      	IQ Mackay Municipal Intermediate ETF              	AMEX      
MMTM      	S&P 1500 Momentum Tilt ETF SPDR                   	AMEX      
MMV       	Eaton Vance Massachusetts Muni Income Trust       	AMEX      
MNA       	IQ Merger Arbitrage ETF                           	AMEX      
MNI       	Mcclatchy Company                                 	AMEX      
MOAT      	Wide Moat Vaneck ETF                              	AMEX      
MOC       	Command Security Corp                             	AMEX      
MOM       	US Momentum Mkt Neutral ETF Quantshares           	AMEX      
MOO       	Agribusiness ETF Vaneck                           	AMEX      
MORL      	Etracs Mt Pay 2X Mortgage REIT ETN                	AMEX      
MORT      	Mortgage REIT Vaneck ETF                          	AMEX      
MOTI      	Morningstar Intl Moat Vaneck ETF                  	AMEX      
MRGR      	Merger ETF Proshares                              	AMEX      
MRRL      	Etracs Mt Pay 2X Mortgage REIT ETN Series B       	AMEX      
MSN       	Emerson Radio Corp                                	AMEX      
MSUS      	Lha Market State U.S. Tactical ETF                	AMEX      
MTNB      	Matinas Biopharma Hl                              	AMEX      
MTUM      	USA Momentum Factor Ishares Edge MSCI ETF         	AMEX      
MUB       	Natl Muni Bond Ishares ETF                        	AMEX      
MUNI      	Interm Muni Bond Strgy ETF Pimco                  	AMEX      
MUST      	Columbia Multi-Sector Municipal Income ETF        	AMEX      
MVIN      	Natixis Seeyond Intl Min Vol ETF                  	AMEX      
MVV       	Ultra Midcap 400 Proshares                        	AMEX      
MXC       	Mexco Energy Corp                                 	AMEX      
MXDE      	Nationwide Maximum Diversification Emerging Mark  	AMEX      
MXDU      	Nationwide Max Diverse U.S. Core Equity ETF       	AMEX      
MXI       	Global Materials Ishares ETF                      	AMEX      
MYO       	Myomo Inc                                         	AMEX      
MYY       	Midcap 400 Short Proshares                        	AMEX      
MZZ       	Ultrashort Midcap400 Proshares                    	AMEX      
NACP      	Impact Shares Trust I Impact Shares Naacp Minori  	AMEX      
NAIL      	Direxion Homebuild & Suppliers Bull 3X            	AMEX      
NAK       	Northern Dynasty Minerals                         	AMEX      
NANR      	S&P North American Natural SPDR                   	AMEX      
NAVB      	Navidea Biopharmaceuticals Inc                    	AMEX      
NBH       	Neuberger Berman Intermediate Fund Inc            	AMEX      
NBO       	Neuberger Berman New York Intermediate Fund Inc   	AMEX      
NBW       	Neuberger Berman California Intermediate Fund In  	AMEX      
NBY       	Novabay Pharmaceuticals                           	AMEX      
NEAR      	Short Maturity Bond Ishares ETF                   	AMEX      
NEN       	New England Realty Associates Limited Partnershi  	AMEX      
NES       	Nuverra Environmental Solutions                   	AMEX      
NFA       	Xxnfa - Claymore/Sabrient Insider ETF Index Intr  	AMEX      
NFLT      	Virtus Multi-Sector Uncstd Bond                   	AMEX      
NFO       	Insider Sentiment Invesco ETF                     	AMEX      
NFRA      	Flexshares Global Broad Infr Fund                 	AMEX      
NG        	Novagold Resources Inc                            	AMEX      
NGD       	New Gold Inc                                      	AMEX      
NGE       	G-X Nigeria Index ETF                             	AMEX      
NHC       	National Healthcare Corp                          	AMEX      
NHS       	Neuberger Berman High Yield Strategies            	AMEX      
NIB       	Ipath.B Cocoa Subindex TR ETN                     	AMEX      
NLR       	Uranium+Nuclear Energy Vaneck ETF                 	AMEX      
NML       	Neuberger Berman MLP Income Fun                   	AMEX      
NNVC      	Nanoviricides Inc                                 	AMEX      
NOBL      	S&P 500 Aristocrats Proshares                     	AMEX      
NOG       	Northern Oil and Gas                              	AMEX      
NORW      	G-X Norway ETF                                    	AMEX      
NRCG      	Nrc Group Holdings Corp.                          	AMEX      
NRO       	Neuberger Berman Real Estate Securities           	AMEX      
NSP.W     	Inspiremd Inc Warrant                             	AMEX      
NSP.X     	Inspiremd Inc Series B Warrants                   	AMEX      
NSPR      	Inspiremd Inc                                     	AMEX      
NSU       	Nevsun Resources Ltd                              	AMEX      
NTIP      	Network-1 Sec Solu                                	AMEX      
NTN       	Ntn Buzztime                                      	AMEX      
NTSX      	Wisdomtree 90/60 U.S. Balanced Fund               	AMEX      
NUAG      	Nushares US Aggregate Bond ETF                    	AMEX      
NUBD      	Nushares ESG U.S. Aggregate Bond ETF              	AMEX      
NUDM      	Nushares ESG Intl Developed Markets Equity ETF    	AMEX      
NUEM      	Nushares ESG Emerging Markets Equity ETF          	AMEX      
NUGT      	Gold Miners Bull 3X Direxion ETF                  	AMEX      
NULG      	Nushares ESG Largecap Growth ETF                  	AMEX      
NULV      	Nushares ESG Largecap Value ETF                   	AMEX      
NUMG      	Nushares ESG Midcap Growth ETF                    	AMEX      
NUMV      	Nushares ESG Midcap Value ETF                     	AMEX      
NURE      	Nushares Short-Term REIT ETF                      	AMEX      
NUSA      	1-5 Year U.S. Aggregate Nushares                  	AMEX      
NUSC      	Nushares ESG Smallcap ETF                         	AMEX      
NXE       	Nexgen Energy Ltd                                 	AMEX      
NYF       	New York Muni Bond Ishares ETF                    	AMEX      
NYH       	Eaton Vance New York Muni Bond Fund II            	AMEX      
OASI      	O's Asia Pacific Qlty Divd ETF                    	AMEX      
OBOR      	Kraneshares MSCI One Belt One Road Index ETF      	AMEX      
OCIO      	ETF Series Solutions Trust ETF                    	AMEX      
OCX       	Oncocyte Corp                                     	AMEX      
OEF       	S&P 100 Ishares ETF                               	AMEX      
OEUR      	O's Europe Qlty Divd ETF                          	AMEX      
OEW       	S&P 100 EW Invesco ETF                            	AMEX      
OGCP      	Empire State Realty Op LP Se                      	AMEX      
OGEN      	Oragenics Inc                                     	AMEX      
OGIG      	O'Shares Global Internet Giants ETF               	AMEX      
OIH       	Oil Services Vaneck ETF                           	AMEX      
OIL       	Ipath Series B S&P GSCI Crude Oil                 	AMEX      
OILB      	Ipath S&P GSCI Crude Oil TR Index Series B ETN    	AMEX      
OILD      	Ultrapro Short Crude Oil Proshares                	AMEX      
OILK      	Crude Oil Strategy Proshares                      	AMEX      
OILU      	Ultrapro Crude Oil Proshares                      	AMEX      
OILX      	Etracs S&P GSCI Crude Oil TR ETN                  	AMEX      
OLEM      	Ipath Pure Beta Crude Oil ETN                     	AMEX      
OLO       	DB Crude Oil ETN Powershares                      	AMEX      
OMFL      	Oppenheimer Rus 1000 Dynamic Multifactor ETF      	AMEX      
OMFS      	Oppenheimer Rus 2000 Dynamic Multifactor ETF      	AMEX      
OMOM      	Oppenheimer Rus 1000 Momentum Factor ETF          	AMEX      
ONEO      	Russell 1000 Momentum Focus ETF SPDR              	AMEX      
ONEV      	Russell 1000 Low Vol ETF SPDR                     	AMEX      
ONEY      	Russell 1000 Yield Focus ETF SPDR                 	AMEX      
ONLN      	Proshares Online Retail ETF                       	AMEX      
ONTL      	O's Russell Intl Qlty Divd ETF                    	AMEX      
OPER      	ETF Series Solutions ETF Clearshares Ultra-Short  	AMEX      
OQAL      	Oppenheimer Rus 1000 Quality Factor ETF           	AMEX      
ORM       	Owens Realty Mortgage Inc                         	AMEX      
OSCV      	Opus Small Cap Value Plus ETF                     	AMEX      
OSIZ      	Oppenheimer Rus 1000 Size Factor ETF              	AMEX      
OUNZ      	Gold Shares Vaneck                                	AMEX      
OUSA      	O's U.S. Qlty Divd ETF                            	AMEX      
OUSM      	O's Russell Smallcap Qlty Divd ETF                	AMEX      
OVLC      	U.S. Large Cap Optimized Volatility Invesco ETF   	AMEX      
OVLU      	Oppenheimer Rus 1000 Value Factor ETF             	AMEX      
OVOL      	Oppenheimer Rus 1000 Low Volatility Factor ETF    	AMEX      
OYLD      	Oppenheimer Rus 1000 Yield Factor ETF             	AMEX      
PACA      	Xtrackers MSCI Latin America Pacific Alliance Et  	AMEX      
PAF       	FTSE RAFI Asia Pacific Ex- Japan Invesco ETF      	AMEX      
PAK       	G-X MSCI Pakistan ETF                             	AMEX      
PALL      	Physical Palladium                                	AMEX      
PAVE      	G-X US Infr Development ETF                       	AMEX      
PAWZ      	Proshares Trust                                   	AMEX      
PBD       	Global Clean Energy Invesco ETF                   	AMEX      
PBDM      	Purebetasm FTSE Developed Ex-North America Inves  	AMEX      
PBE       	Dynamic Biotechnology & Genome Invesco ETF        	AMEX      
PBEE      	Purebetasm FTSE Emerging Markets Invesco ETF      	AMEX      
PBJ       	Dynamic Food & Beverage Invesco ETF               	AMEX      
PBND      	Purebetasm US Aggregate Bond Invesco ETF          	AMEX      
PBP       	S&P 500 Buywrite Invesco ETF                      	AMEX      
PBS       	Dynamic Media Invesco ETF                         	AMEX      
PBSM      	Purebetasm MSCI USA Small Cap Invesco ETF         	AMEX      
PBTP      	Purebetasm 0-5 Yr US TIPS Invesco ETF             	AMEX      
PBUS      	Purebetasm MSCI USA Invesco ETF                   	AMEX      
PBW       	Wilderhill Clean Energy Invesco ETF               	AMEX      
PCEF      	CEF Income Composite Invesco ETF                  	AMEX      
PCG-A     	Pacific Gas El 6.00                               	AMEX      
PCG-B     	Pacific Gas El 5.50                               	AMEX      
PCG-C     	Pacific Gas El 5.00                               	AMEX      
PCG-D     	Pacific Gas El 5.00                               	AMEX      
PCG-E     	Pacific Gas El 5.00                               	AMEX      
PCG-G     	Pacific Gas El 4.80                               	AMEX      
PCG-H     	Pacific Gas El 4.50                               	AMEX      
PCG-I     	Pacific Gas El 4.36                               	AMEX      
PCY       	Emerging Markets Sovereign Debt Invesco ETF       	AMEX      
PDN       	FTSE RAFI Dev Markets Ex-U.S. Small-Mid Invesco   	AMEX      
PED       	Pedevco Corp                                      	AMEX      
PEJ       	Dynamic Leisure and Entertainment Invesco ETF     	AMEX      
PEK       	China ETF Vaneck                                  	AMEX      
PEX       	Global Listed Private Proshares                   	AMEX      
PEXL      	Pacer US Export Leaders ETF                       	AMEX      
PFFA      	Virtus Infracap U.S. Preferred Stock ETF          	AMEX      
PFFD      	Global X U.S. Preferred ETF                       	AMEX      
PFFL      	Etracs 2Xmonthly Pay Leveraged Preferred Stock I  	AMEX      
PFFR      	Infracap REIT Preferred ETF                       	AMEX      
PFIG      	Fundamental Investment Grade Corp Bond Invesco E  	AMEX      
PFNX      	Pfenex Inc                                        	AMEX      
PFXF      	Preferred Securities Vaneck ETF                   	AMEX      
PGAL      	G-X FTSE Portugal 20 ETF                          	AMEX      
PGF       	Financial Preferred Invesco ETF                   	AMEX      
PGHY      	Global Short Term Hi-Yld Bond Invesco ETF         	AMEX      
PGM       	Ipatha Platinum Subindex Total Return ETN         	AMEX      
PGMB      	Ipath.B Platinum Subindex TR Series B ETN         	AMEX      
PGX       	Preferred Invesco ETF                             	AMEX      
PHB       	Fundamental Hi-Yld Corp Bond Invesco ETF          	AMEX      
PHDG      	S&P 500 Downside Hedged Invesco ETF               	AMEX      
PHYL      	PGIM Active High Yield Bond ETF                   	AMEX      
PHYS      	Sprott Physical Gold Trust                        	AMEX      
PICB      	Intl Corp Bond Invesco ETF                        	AMEX      
PICK      	Global Metals & Mining Producers Ishares MSCI Et  	AMEX      
PILL      	Direxion Daily Pharmaceutical & Medical Bull 3X   	AMEX      
PIN       	India Invesco ETF                                 	AMEX      
PJP       	Dynamic Pharmaceuticals Invesco ETF               	AMEX      
PJUL      	Innovator S&P 500 Power Buffer ETF                	AMEX      
PKB       	Dynamic Building & Construction Invesco ETF       	AMEX      
PLAG      	Planet Green Holdings Corp.                       	AMEX      
PLCY      	Active Weighting Funds                            	AMEX      
PLG       	Platinum Group Metals Ltd                         	AMEX      
PLM       	Polymet Mining                                    	AMEX      
PLND      	Poland Vaneck ETF                                 	AMEX      
PLTM      	Graniteshares Platinum Shares ETF                 	AMEX      
PLX       	Protalix Biotherapeutics                          	AMEX      
PLY-A     	Plymouth Industrial REIT Inc Cum Red Pfd Ser A    	AMEX      
PLYM      	Plymouth Industrial REIT Inc                      	AMEX      
PMR       	Dynamic Retail Invesco ETF                        	AMEX      
POCT      	Innovator S&P 500 Power Buffer ETF                	AMEX      
PPA       	Aerospace & Defense Invesco ETF                   	AMEX      
PPDM      	Portfolio Developed Markets ETF                   	AMEX      
PPEM      	Portfolio Emerging Markets ETF                    	AMEX      
PPLC      	Portfolio S&P 500 ETF                             	AMEX      
PPLN      	Cushing 30 MLP Index Etns Due June 15 2037        	AMEX      
PPLT      	Physical Platinum                                 	AMEX      
PPMC      	Portfolio S&P Mid Cap ETF                         	AMEX      
PPSC      	Portfolio S&P Small Cap                           	AMEX      
PPTY      	Ppty U.S. Diversified Real Estate ETF             	AMEX      
PQLC      	PGIM Qma Strategic Alpha Large-Cap Core ETF       	AMEX      
PQSG      	PGIM Qma Strategic Alpha Small-Cap Growth ETF     	AMEX      
PQSV      	PGIM ETF Trust ETF PGIM Qma Strategic Alpha Smal  	AMEX      
PRB       	Pre-Refunded Muni ETF Vaneck                      	AMEX      
PREF      	Principal Spectrum Preferred Securities Active E  	AMEX      
PRF       	FTSE RAFI US 1000 Invesco ETF                     	AMEX      
PRID      	Insightshares Lgbt Employment Equality ETF        	AMEX      
PRK       	Park National Corp                                	AMEX      
PRME      	Heitman Global Prime Real Estate ETF FT           	AMEX      
PRNT      	3D Printing ETF                                   	AMEX      
PSI       	Dynamic Semiconductors Invesco ETF                	AMEX      
PSJ       	Dynamic Software Invesco ETF                      	AMEX      
PSK       	Wells Fargo Preferred Stock SPDR                  	AMEX      
PSLV      	Sprott Physical Silver Trust ETV                  	AMEX      
PSMB      	Balanced Multi-Asset Allocation Invesco ETF       	AMEX      
PSMC      	Conservative Multi-Asset Allocation Invesco ETF   	AMEX      
PSMG      	Growth Multi-Asset Allocation Invesco ETF         	AMEX      
PSMM      	Moderately Conservative Multi-Asset Allocation I  	AMEX      
PSP       	Global Listed Private Equity Invesco ETF          	AMEX      
PSQ       	QQQ Short Proshares                               	AMEX      
PSR       	Active U.S. Real Estate Invesco ETF               	AMEX      
PST       	Ultrashort 7-10 Year Treasury Proshares           	AMEX      
PTEU      	Pacer Trendpilot European Index ETF               	AMEX      
PTLC      	Pacer Trendpilot 750 ETF                          	AMEX      
PTMC      	Pacer Trendpilot 450 ETF                          	AMEX      
PTN       	Palatin Technologies                              	AMEX      
PTNQ      	Pacer Trendpilot 100 ETF                          	AMEX      
PULS      	PGIM Ultra Short Bond ETF                         	AMEX      
PUTW      	Wisdomtree CBOE S&P 500 Put Write                 	AMEX      
PUW       	Wilderhill Progressive Energy Invesco ETF         	AMEX      
PVI       	Vrdo Tax-Free Weekly Invesco ETF                  	AMEX      
PW        	Pittsburgh & West Virginia Railroad               	AMEX      
PW-A      	Power REIT 7.75% Series A Cumul                   	AMEX      
PWB       	Dynamic Large Cap Growth Invesco ETF              	AMEX      
PWC       	Dynamic Market Invesco ETF                        	AMEX      
PWS       	Pacer Trendpilot                                  	AMEX      
PWV       	Dynamic Large Cap Value Invesco ETF               	AMEX      
PWZ       	California Amt-Free Municipal Bond Invesco ETF    	AMEX      
PXE       	Dynamic Energy Exploration & Production Invesco   	AMEX      
PXF       	FTSE RAFI Dev Markets Ex-U.S. Invesco ETF         	AMEX      
PXH       	FTSE RAFI Emrg Markets Invesco ETF                	AMEX      
PXJ       	Dynamic Oil & Gas Services Invesco ETF            	AMEX      
PXLG      	Russell Top 200 Pure Growth Invesco ETF           	AMEX      
PXLV      	Russell Top 200 Pure Value Invesco ETF            	AMEX      
PXMG      	Russell Midcap Pure Growth Invesco ETF            	AMEX      
PXMV      	Russell Midcap Pure Value Invesco ETF             	AMEX      
PXQ       	Dynamic Networking Invesco ETF                    	AMEX      
PXR       	Emerging Markets Infrastructure Invesco ETF       	AMEX      
PXSG      	Russell 2000 Pure Growth Invesco ETF              	AMEX      
PXSV      	Russell 2000 Pure Value Invesco ETF               	AMEX      
PYPE      	Etracs NYSE Pickens Core Midstream Index ETN      	AMEX      
PZA       	National Amt-Free Municipal Bond Invesco ETF      	AMEX      
PZD       	Cleantech Invesco ETF                             	AMEX      
PZG       	Paramount Gold and Silver                         	AMEX      
PZI       	Zacks Micro Cap Invesco ETF                       	AMEX      
PZT       	New York Amt-Free Municipal Bond Invesco ETF      	AMEX      
QAI       	IQ Hedge Multi-Strategy Tracker ETF               	AMEX      
QARP      	Xtrackers Russell 1000 US Qarp ETF                	AMEX      
QDEF      	Flexshares Quality Div Def Fund                   	AMEX      
QDF       	Flexshares Quality Div Fund                       	AMEX      
QDIV      	Global X S&P 500 Quality Dividend ETF             	AMEX      
QDYN      	Flexshares Quality Div Dyn Fund                   	AMEX      
QED       	IQ Hedge Event-Driven Tracker ETF                 	AMEX      
QEFA      	EAFE Qlty Mix MSCI ETF SPDR                       	AMEX      
QEMM      	EM Strategicfactors MSCI ETF SPDR                 	AMEX      
QGRO      	American Century Stoxx U.S. Quality Growth ETF    	AMEX      
QGTA      	IQ Leaders Gtaa Tracker ETF                       	AMEX      
QID       	Ultrashort QQQ Proshares                          	AMEX      
QINT      	American Century Quality Diversified Internation  	AMEX      
QLD       	Ultra QQQ Proshares                               	AMEX      
QLS       	IQ Hedge Long Short Tracker ETF                   	AMEX      
QLTA      	AAA - A Rated Corp Bond Ishares ETF               	AMEX      
QMN       	IQ Hedge Market Neutral Tracker ETF               	AMEX      
QMOM      	Quantitative Momentum ETF                         	AMEX      
QQQE      	Nasdaq 100 EW Index Direxion                      	AMEX      
QSY       	Wisdomtree U.S. Quality Shareholder Yield Fund    	AMEX      
QTUM      	Defiance Quantum ETF                              	AMEX      
QUAL      	USA Quality Factor Ishares Edge MSCI ETF          	AMEX      
QUS       	USA Qlty Mix MSCI ETF SPDR                        	AMEX      
QVAL      	US Quantitative Valueshares ETF                   	AMEX      
QVM       	Arrow Qvm Equity Factor ETF                       	AMEX      
QWLD      	World Qlty Mix MSCI ETF SPDR                      	AMEX      
QXGG      	Quantx Risk Managed Growth ETF                    	AMEX      
QXMI      	Quantx Risk Managed Multi-Asset Income ETF        	AMEX      
QXRR      	Quantx Risk Managed Real Return ETF               	AMEX      
QXTR      	Quantx Risk Managed Multi-Asset Total Return ETF  	AMEX      
RAAX      	Vaneck Vectors ETF Trust ETF Vaneck Vectors Real  	AMEX      
RALS      	RAFI Long/Short Proshares                         	AMEX      
RAVI      	Flexshares Ready Access Variable Income           	AMEX      
RBIN      	Nationwide Risk-Based International Equity ETF    	AMEX      
RBUS      	Nationwide Risk-Based U.S. Equity ETF             	AMEX      
RCD       	S&P 500 EW Consumer Discretionary Invesco ETF     	AMEX      
RCG       	Renaissance Capital Growth & Income Fund III      	AMEX      
RDIV      	Ultra Dividend Revenue ETF Oppenheimer            	AMEX      
REDV      	Oppenheimer Emerging Markets Ultra Dividend Reve  	AMEX      
REED      	Reeds Inc                                         	AMEX      
REEM      	Oppenheimer Revenue Weighted ETF Trust ETF        	AMEX      
REET      	Global REIT Ishares ETF                           	AMEX      
REFA      	Oppenheimer International Revenue ETF             	AMEX      
REGL      	S&P Midcap 400 Divd Proshares                     	AMEX      
REI       	Ring Energy Inc                                   	AMEX      
REK       	Real Estate Short Proshares                       	AMEX      
REM       	Mortgage Real Estate Ishares ETF                  	AMEX      
REML      	X-Links Mthy Pay 2X Leveraged Mortgage REIT       	AMEX      
REMX      	Rare Earth/Strategic Metals Vaneck ETF            	AMEX      
RETL      	Retail Bull 3X Direxion                           	AMEX      
REW       	Ultrashort Technology Proshares                   	AMEX      
REZ       	Residential Real Estate Ishares ETF               	AMEX      
RFCI      	Riverfront Core Income Fund ETF                   	AMEX      
RFDA      	Riverfront US Dividend Adv ETF                    	AMEX      
RFFC      	Riverfront US Flex-Cap ETF                        	AMEX      
RFG       	S&P Midcap 400 Pure Growth Invesco ETF            	AMEX      
RFL       	Rafael Holdings Inc                               	AMEX      
RFUN      	Riverfront Unconstrained Income ETF               	AMEX      
RFV       	S&P Midcap 400 Pure Value Invesco ETF             	AMEX      
RGI       	S&P 500 EW Industrials Invesco ETF                	AMEX      
RGLB      	Oppenheimer Global Revenue ETF                    	AMEX      
RHE       	Regional Health Properties                        	AMEX      
RHE-A     	Regional Health Properties 10.875% Series A       	AMEX      
RHS       	S&P 500 EW Consumer Staples Invesco ETF           	AMEX      
RIDV      	Oppenheimer International Ultra Dividend Revenue  	AMEX      
RIF       	Rmr Real Estate Income Fund                       	AMEX      
RIGS      	Riverfront Strategic Income Fund ETF              	AMEX      
RINF      	30 Year Tips/Tsy Spread Proshares                 	AMEX      
RISE      	Sit Rising Rate ETF                               	AMEX      
RJA       	Rogers Agriculture ETN Elements                   	AMEX      
RJI       	Rogers Commodity ETN Elements                     	AMEX      
RJN       	Rogers Energy ETN Elements                        	AMEX      
RJZ       	Rogers Metal ETN Elements                         	AMEX      
RLG-A     	Radiant Logistics Inc 9.75% S                     	AMEX      
RLGT      	Radiant Logistics                                 	AMEX      
RLY       	SSGA Multi-Asset Real Return ETF SPDR             	AMEX      
RNN       	Rexahn Pharmaceuticals                            	AMEX      
ROAM      	Lattice EM Strategy ETF                           	AMEX      
ROBO      	Global Robotics and Automation ETF                	AMEX      
RODM      	Lattice Developed Markets Ex-US ETF               	AMEX      
ROGS      	Lattice Global Smallcap Strategy ETF              	AMEX      
ROM       	Ultra Technology Proshares                        	AMEX      
ROOF      	IQ US Real Estate Smallcap ETF                    	AMEX      
RORE      	Lattice Real Estate Strategy ETF                  	AMEX      
ROUS      	Lattice US Equity Strategy ETF                    	AMEX      
ROX       	Castle Brands                                     	AMEX      
RPG       	S&P 500 Pure Growth Invesco ETF                   	AMEX      
RPUT      	Wisdomtree CBOE Russell 2000 Putwrite Strategy F  	AMEX      
RPV       	S&P 500 Pure Value Invesco ETF                    	AMEX      
RSP       	S&P 500 EW Invesco ETF                            	AMEX      
RSX       	Russia Vaneck ETF                                 	AMEX      
RSXJ      	Russia Smallcap Vaneck ETF                        	AMEX      
RTH       	Retail ETF Vaneck                                 	AMEX      
RTL       	Pacer Benchmark Retail Real Estate Sctr ETF       	AMEX      
RTM       	S&P 500 EW Materials Invesco ETF                  	AMEX      
RUSL      	Russia Bull 3X Direxion                           	AMEX      
RUSS      	Russia Bear 3X Direxion                           	AMEX      
RVNU      	Db-Xt Municipal Infrastructure ETF                	AMEX      
RVP       	Retractable Technologies                          	AMEX      
RVRS      	Reverse Cap Weighted US Large Cap ETF             	AMEX      
RWJ       	Smallcap Revenue ETF Oppenheimer                  	AMEX      
RWK       	Midcap Revenue ETF Oppenheimer                    	AMEX      
RWL       	Largecap Revenue ETF Oppenheimer                  	AMEX      
RWM       	Russell 2000 Short Proshares                      	AMEX      
RWO       	DJ Global Real Estate ETF SPDR                    	AMEX      
RWR       	DJ REIT ETF SPDR                                  	AMEX      
RWW       	Financial Sector Revenue ETF Oppenheimer          	AMEX      
RWX       	DJ Intl Real Estate ETF SPDR                      	AMEX      
RXD       	Ultrashort Health Care Proshares                  	AMEX      
RXI       	Global Cons Disc Ishares ETF                      	AMEX      
RXL       	Ultra Health Care Proshares                       	AMEX      
RYE       	S&P 500 EW Energy Invesco ETF                     	AMEX      
RYF       	S&P 500 EW Financials Invesco ETF                 	AMEX      
RYH       	S&P 500 EW Health Care Invesco ETF                	AMEX      
RYJ       	Raymond James Sb-1 Equity Invesco ETF             	AMEX      
RYT       	S&P 500 EW Technology Invesco ETF                 	AMEX      
RYU       	S&P 500 EW Utilities Invesco ETF                  	AMEX      
RZG       	S&P Smallcap 600 Pure Growth Invesco ETF          	AMEX      
RZV       	S&P Smallcap 600 Pure Value Invesco ETF           	AMEX      
SAA       	Ultra Smallcap 600 Proshares                      	AMEX      
SACH      	Sachem Capital Corp                               	AMEX      
SAGG      	Total Bond Market Bear -1X Direxion               	AMEX      
SAND      	Sandstorm Gold Ltd                                	AMEX      
SBB       	Smallcap 600 Short Proshares                      	AMEX      
SBIO      	Alps Medical Breakthroughs ETF                    	AMEX      
SBM       	Basic Materials Short Proshares                   	AMEX      
SCAP      	Advisorshares Cornerstone Small                   	AMEX      
SCC       	Ultrashort Consumer Services Proshares            	AMEX      
SCE-B     	South CA Edis 408 Pf                              	AMEX      
SCE-C     	South CA Edis 424 Pf                              	AMEX      
SCE-D     	South CA Edis 431 Pf                              	AMEX      
SCE-E     	South CA Edis 478 Pf                              	AMEX      
SCHA      	Schwab US Smallcap ETF                            	AMEX      
SCHB      	Schwab US Broad Market ETF                        	AMEX      
SCHC      	Schwab Intl Smallcap ETF                          	AMEX      
SCHD      	Schwab US Dividend Equity ETF                     	AMEX      
SCHE      	Schwab EM Mkts Equity ETF                         	AMEX      
SCHF      	Schwab Intl Equity ETF                            	AMEX      
SCHG      	Schwab US Largecap Growth ETF                     	AMEX      
SCHH      	Schwab US REIT ETF                                	AMEX      
SCHK      	Schwab 1000 Index ETF                             	AMEX      
SCHM      	Schwab US Midcap ETF                              	AMEX      
SCHO      	Schwab Short-Term US Trsy ETF                     	AMEX      
SCHP      	Schwab US TIPS ETF                                	AMEX      
SCHR      	Schwab Interm-Term US Treasury                    	AMEX      
SCHV      	Schwab US Largecap Value ETF                      	AMEX      
SCHX      	Schwab US Largecap ETF                            	AMEX      
SCHZ      	Schwab US Aggregate Bond ETF                      	AMEX      
SCID      	G-X Scientific Beta Europe ETF                    	AMEX      
SCIF      	India Smallcap ETF Vaneck                         	AMEX      
SCIJ      	G-X Scientific Beta Japan ETF                     	AMEX      
SCIN      	India Smallcap Egshares                           	AMEX      
SCIU      	G-X Scientific Beta US ETF                        	AMEX      
SCIX      	G-X Scientific Beta Asia Ex-Jpn ETF               	AMEX      
SCJ       	Japan Small-Cap Ishares MSCI ETF                  	AMEX      
SCO       	Ultrashort DJ-UBS Crude Oil Proshares             	AMEX      
SCTO      	G-X JPM US Sector Rotator ETF                     	AMEX      
SDCI      	Uscf Summerhaven Dynamic Commodity Strategy No K  	AMEX      
SDD       	Ultrashort Smallcap 600 Proshares                 	AMEX      
SDEM      	G-X Super Dividend EM ETF                         	AMEX      
SDGA      	Impact Shares Sustainable Development Goals Glob  	AMEX      
SDI       	Standard Diversified Opportunities Inc            	AMEX      
SDIV      	G-X Superdividend ETF                             	AMEX      
SDOG      	Alps Sector Dividend Dogs ETF                     	AMEX      
SDOW      	Ultrapro Short Dow 30 Proshares                   	AMEX      
SDP       	Ultrashort Utilities Proshares                    	AMEX      
SDPI      	Superior Drilling Products Inc                    	AMEX      
SDS       	Ultrashort S&P 500 Proshares                      	AMEX      
SDY       	S&P Dividend SPDR                                 	AMEX      
SDYL      	Etracs Mt Pay 2X S&P Div ETN                      	AMEX      
SEA       	Shipping Invesco ETF                              	AMEX      
SEB       	Seaboard Corp                                     	AMEX      
SECT      	Northern Lights IV Main Sector Rotation ETF       	AMEX      
SEF       	Financials Short Proshares                        	AMEX      
SENS      	Senseonics Holdings                               	AMEX      
SFHY      	Wisdomtree Short-Term Hi Yld Corp Bond Fundament  	AMEX      
SFIG      	Wisdomtree Short-Term Corp Bond Fundamental       	AMEX      
SGB       	Southwest Georgia Financial Corp                  	AMEX      
SGDJ      	Alps ETF Trust Sprott Junior Gold                 	AMEX      
SGDM      	Sprott Gold Miners ETF                            	AMEX      
SGG       	Ipatha Sugar Subindex Total Return ETN            	AMEX      
SGGB      	Ipath.B Sugar Subindex TR Series B ETN            	AMEX      
SGOL      	Physical Swiss Gold                               	AMEX      
SH        	S&P 500 Short Proshares                           	AMEX      
SHAG      	Wisdomtree Yield Enhanced U.S. Short-Term Aggreg  	AMEX      
SHE       	SSGA Gender Diversity ETF SPDR                    	AMEX      
SHM       	Short-Term Muni Bond ETF SPDR                     	AMEX      
SHYD      	Short High-Yield Vaneck ETF                       	AMEX      
SHYG      	0-5 Year High Yield Corp Bond Ishares ETF         	AMEX      
SHYL      	Xtrackers Short Duration High Yield Bond ETF      	AMEX      
SIF       	Sifco Industries                                  	AMEX      
SIJ       	Ultrashort Industrials Proshares                  	AMEX      
SIL       	G-X Silver Miners ETF                             	AMEX      
SILJ      	Purefunds ISE Junior Silver ETF                   	AMEX      
SILV      	Silvercrest Metals Inc                            	AMEX      
SIM       	Grupo Simec S.A. De C.V.                          	AMEX      
SIVR      	Physical Silver                                   	AMEX      
SIZ       	US Size Mkt Neutral ETF Quantshares               	AMEX      
SIZE      	USA Size Factor Ishares Edge MSCI ETF             	AMEX      
SJB       	High Yld Short Proshares                          	AMEX      
SJNK      	ST High Yield Bond ETF SPDR                       	AMEX      
SKF       	Ultrashort Financials Proshares                   	AMEX      
SLT       	Salt Trubeta High Exposure ETF                    	AMEX      
SLV       	Silver Trust Ishares                              	AMEX      
SLVP      	Global Silver Miners Ishares MSCI ETF             	AMEX      
SLX       	Steel Vaneck ETF                                  	AMEX      
SLY       	S&P Smallcap 600 SPDR                             	AMEX      
SLYG      	S&P Smallcap Growth ETF SPDR                      	AMEX      
SLYV      	S&P Smallcap Value ETF SPDR                       	AMEX      
SMB       	Municipal Short Vaneck ETF                        	AMEX      
SMDD      	Ultrapro Short Midcap 400 Proshares               	AMEX      
SMDV      	Russell 2000 Divd Proshares                       	AMEX      
SMEZ      	Euro Stoxx Smallcap ETF SPDR                      	AMEX      
SMH       	Semiconductor Vaneck ETF                          	AMEX      
SMHB      	Etracs Monthly Pay 2X Leveraged Small Cap High D  	AMEX      
SMHD      	Etracs Mt Pay 2X US Smallcap Hi Div ETN           	AMEX      
SMIN      	India Small-Cap Ishares MSCI ETF                  	AMEX      
SMLF      	USA Multifactor Small-Cap Ishares Edge MSCI ETF   	AMEX      
SMLL      	Direxion Smallcap Bull                            	AMEX      
SMLV      	SSGA US Smallcap Low Vol Index SPDR               	AMEX      
SMMD      	Russell 2500 Ishares ETF                          	AMEX      
SMMU      	Short-Term Muni Bond Strgy ETF Pimco              	AMEX      
SMMV      	USA Min Vol Small-Cap Ishares Edge MSCI ETF       	AMEX      
SMN       	Ultrashort Basic Materials Proshares              	AMEX      
SMTS      	Sierra Metals Inc                                 	AMEX      
SNMP      	Sanchez Midstream Partners LP                     	AMEX      
SOIL      	G-X Fertilizers/Potash ETF                        	AMEX      
SOVB      	Cambria Sovereign High Yield Bo                   	AMEX      
SOXL      	Semiconductor Bull 3X Direxion                    	AMEX      
SOXS      	Semiconductor Bear 3X Direxion                    	AMEX      
SOYB      	Teucrium Soybean                                  	AMEX      
SPAB      	SPDR Aggregate Bond Portfolio ETF                 	AMEX      
SPDN      	Direxion S&P 500 Bear 1X                          	AMEX      
SPDV      	Aam S&P 500 High Dividend Value ETF               	AMEX      
SPDW      	SPDR World Ex-US Portfolio ETF                    	AMEX      
SPEM      	SPDR Emerging Markets Portfolio ETF               	AMEX      
SPFF      	G-X Superincome Preferred ETF                     	AMEX      
SPHB      	S&P 500 High Beta Invesco ETF                     	AMEX      
SPHD      	S&P 500 High Dividend Low Vol Invesco ETF         	AMEX      
SPHQ      	S&P 500 Quality Invesco ETF                       	AMEX      
SPIB      	SPDR Intermediate Term Corporate Bond Portfolio   	AMEX      
SPLB      	SPDR Long Term Corporate Bond Portfolio ETF       	AMEX      
SPLG      	SPDR Large Cap Portfolio ETF                      	AMEX      
SPLV      	S&P 500 Low Vol Invesco ETF                       	AMEX      
SPMD      	SPDR Mid Cap Portfolio ETF                        	AMEX      
SPMO      	S&P 500 Momentum Invesco ETF                      	AMEX      
SPMV      	S&P 500 Minimum Variance Invesco ETF              	AMEX      
SPPP      	Sprott Physical Platinum and Palladium            	AMEX      
SPSB      	SPDR Short Term Corporate Bond Portfolio ETF      	AMEX      
SPSM      	SPDR Small Cap Portfolio ETF                      	AMEX      
SPTL      	SPDR Long Term Treasury Portfolio ETF             	AMEX      
SPTM      	SPDR Total Stock Market Portfolio ETF             	AMEX      
SPTS      	SPDR Short Term Treasury Portfolio ETF            	AMEX      
SPUU      	Direxion S&P 500 Bull 2X                          	AMEX      
SPVM      	S&P 500 Value With Momentum Invesco ETF           	AMEX      
SPVU      	S&P 500 Enhanced Value Invesco ETF                	AMEX      
SPXB      	Proshares S&P 500 Bond ETF                        	AMEX      
SPXE      	S&P 500 Ex-Energy Proshares                       	AMEX      
SPXL      	Direxion S&P 500 Bull 3X                          	AMEX      
SPXN      	S&P 500 Ex-Financials Proshares                   	AMEX      
SPXS      	Direxion S&P 500 Bear 3X                          	AMEX      
SPXT      	S&P 500 Ex-Technology Proshares                   	AMEX      
SPXU      	Ultrapro Short S&P 500 Proshares                  	AMEX      
SPXV      	S&P 500 Ex-Health Care Proshares                  	AMEX      
SPY       	S&P 500 SPDR                                      	AMEX      
SPYB      	S&P 500 Buyback ETF SPDR                          	AMEX      
SPYD      	SPDR S&P 500 High Dividend Portfolio ETF          	AMEX      
SPYG      	SPDR S&P 500 Growth Portfolio ETF                 	AMEX      
SPYV      	SPDR S&P 500 Value Portfolio ETF                  	AMEX      
SPYX      	S&P 500 Ex-Fossil Fuel ETF SPDR                   	AMEX      
SRCI      	Src Energy Inc                                    	AMEX      
SRLN      	Blackstone Gso Senior Loan SPDR                   	AMEX      
SRS       	Ultrashort Real Estate Proshares                  	AMEX      
SRTY      	Ultrapro Short Russell 2000 Proshares             	AMEX      
SRVR      	Pacer Benchmark & Infrastructure Real Estate Sct  	AMEX      
SSG       	Ultrashort Semiconductors Proshares               	AMEX      
SSO       	Ultra S&P 500 Proshares                           	AMEX      
SSY       	Sunlink Health Systems                            	AMEX      
STIP      	0-5 Year TIPS Bond Ishares ETF                    	AMEX      
STOT      	Short Duration TR Tactical ETF SPDR               	AMEX      
STPZ      	1-5 Year US TIPS Index ETF Pimco                  	AMEX      
SUB       	Short-Term Natl Muni Bond Ishares ETF             	AMEX      
SUSA      	USA ESG Select Ishares MSCI ETF                   	AMEX      
SVM       	Silvercorp Metals Inc                             	AMEX      
SVT       	Servotronics Inc                                  	AMEX      
SVXY      	VIX Short-Term Fut Short Proshares                	AMEX      
SWAN      	Amplify ETF Trust Amplify Blackswan Growth & Tre  	AMEX      
SYE       	MFS Core Equity ETF SPDR                          	AMEX      
SYG       	MFS Growth Equity ETF SPDR                        	AMEX      
SYLD      	Cambria Shareholder Yield ETF                     	AMEX      
SYN       	Synthetic Biologics Inc                           	AMEX      
SYV       	MFS Value Equity ETF SPDR                         	AMEX      
SZK       	Ultrashort Consumer Goods Proshares               	AMEX      
SZNE      	Pacer Cfra-Stovall Equal Weight Seasonal Rotatio  	AMEX      
SZO       	DB Crude Oil -1X ETN Powershares                  	AMEX      
TAGS      	Teucrium Agricultural                             	AMEX      
TAIL      	Cambria Tail Risk ETF                             	AMEX      
TAL.W     	Talos Energy Inc. Warrants                        	AMEX      
TAN       	Solar Invesco ETF                                 	AMEX      
TAO       	China Real Estate Invesco ETF                     	AMEX      
TAT       	Transatlantic Petroleum Ltd                       	AMEX      
TAXF      	American Century Diversified Municipal Bond ETF   	AMEX      
TBF       	20+ Year Short Treasury Proshares                 	AMEX      
TBLU      	Managed Portfolio Series Tortoise Water Fund      	AMEX      
TBT       	Ultrashort 20+ Year Treasury Proshares            	AMEX      
TBX       	7-10 Year Short Treasury Proshares                	AMEX      
TCTL      	Premise Capital Frontier Advantage Dvsfd Tct ETF  	AMEX      
TDTF      	Iboxx 5Yr Target Dur TIPS ETF Flexshares          	AMEX      
TDTT      	Iboxx 3Yr Target Dur TIPS ETF Flexshares          	AMEX      
TECL      	Technology Bull 3X Direxion                       	AMEX      
TECS      	Technology Bear 3X Direxion                       	AMEX      
TERM      	Equitycompass Tactical Risk Manager ETF           	AMEX      
TETF      	Industry Exposure & Fin Srvs ETF                  	AMEX      
TFI       	Muni Bond ETF SPDR                                	AMEX      
TFIV      	Global X Targetincome 5 ETF                       	AMEX      
TFLO      	Treasury Floating Rate Bond Ishares ETF           	AMEX      
TFLT      	Global X Targetincome Plus 2 ETF                  	AMEX      
TGB       	Taseko Mines Ltd                                  	AMEX      
TGC       	Tengasco Inc                                      	AMEX      
THD       	Thailand Ishares MSCI ETF                         	AMEX      
THM       	International Tower Hill Mines Ltd                	AMEX      
TIK       	Tel-Instrument Electronics                        	AMEX      
TILT      	Mstar US Mkt Factors Tilt ETF Flexshares          	AMEX      
TIP       	TIPS Bond Ishares ETF                             	AMEX      
TIPX      	Barclays 1-10 Year TIPS SPDR                      	AMEX      
TIPZ      	Broad U.S. TIPS Index ETF Pimco                   	AMEX      
TIS       	Orchids Paper Products Company                    	AMEX      
TKAT      	Takung Art Co. Ltd                                	AMEX      
TLDH      	Flexshares Dm Ex-US Factor Tilt Index Fund        	AMEX      
TLEH      	Flexshares EM Factor Tilt Index Fund              	AMEX      
TLH       	10-20 Year Treas Bond Ishares ETF                 	AMEX      
TLTD      	Flexshares Dev Mkt Ex-US Factor Tilt Index Fund   	AMEX      
TLTE      	Flexshares EM Factor Tilt Index Fund              	AMEX      
TMF       	20+ Year Trsy Bull 3X Direxion                    	AMEX      
TMFC      	Motley Fool 100 Index ETF                         	AMEX      
TMP       	Tompkinstrustco                                   	AMEX      
TMQ       	Trilogy Metals Inc                                	AMEX      
TMV       	20+ Year Trsy Bear 3X Direxion                    	AMEX      
TNA       	Smallcap Bull 3X Direxion                         	AMEX      
TOK       	Kokusai Ishares MSCI ETF                          	AMEX      
TOLZ      	DJ Brookfield Global Proshares                    	AMEX      
TOTL      	Total Return Tactical ETF SPDR                    	AMEX      
TPHS      	Trinity Pl Hldgs Inc                              	AMEX      
TPOR      	Direxion Daily Transportation Bull 3X Shares      	AMEX      
TPYP      	Tortoise North Amer Pipeline Fund                 	AMEX      
TRT       	Trio-Tech International                           	AMEX      
TRTY      	Cambria Trinity ETF                               	AMEX      
TRX       	Tanzanian Royalty Exploration Corp                	AMEX      
TRXC      	Transenterix Inc                                  	AMEX      
TTAC      	Trimtabs Float Shrink ETF                         	AMEX      
TTAI      	Trimtabs ETF Trust                                	AMEX      
TTT       	Ultrapro Short 20+ Year Trsy Proshares            	AMEX      
TUZ       	1-3 Year US Treasury Index ETF Pimco              	AMEX      
TWM       	Ultrashort Russell 2000 Proshares                 	AMEX      
TYBS      	20+ Year Trsy Bear 1X Direxion                    	AMEX      
TYD       	7-10 Year Treasury Bull 3X Direxion               	AMEX      
TYNS      	7-10 Year Treasury Bear -1X Direxion              	AMEX      
TYO       	7-10 Year Treasury Bear -3X Direxion              	AMEX      
TZA       	Smallcap Bear 3X Direxion                         	AMEX      
UAG       	CMCI Agriculture TR ETN UBS E-Tracs               	AMEX      
UAMY      	U S Antimony Corp                                 	AMEX      
UAUD      	Citigroup Global Markets Holdings Inc             	AMEX      
UAVS      	Enerjex Resources Inc                             	AMEX      
UBG       	CMCI Gold TR ETN UBS E-Tracs                      	AMEX      
UBOT      	Direxion Daily Robotics Artificial Intelligence   	AMEX      
UBR       	Ultra MSCI Brazil Proshares                       	AMEX      
UBT       	Ultra 20+ Year Treasury Proshares                 	AMEX      
UCC       	Ultra Consumer Services Proshares                 	AMEX      
UCHF      	Citigroup Global Markets Holdings Inc             	AMEX      
UCI       	CMCI TR ETN UBS E-Tracs                           	AMEX      
UCIB      	Etracs UBS Bberg Constant Maturity ETN            	AMEX      
UCO       	Ultra DJ-UBS Crude Oil Proshares                  	AMEX      
UCON      	First Trust Tcw Unconstrained Plus Bond ETF       	AMEX      
UDN       	DB US Dollar Index Bearish Fund Invesco           	AMEX      
UDOW      	Ultrapro Dow 30 Proshares                         	AMEX      
UEC       	Uranium Energy                                    	AMEX      
UEUR      	Citigroup Global Markets Holdings Inc             	AMEX      
UEVM      	Usaa MSCI EM Value Momentum Blend Index ETF       	AMEX      
UFAB      	Unique Fabricating Inc                            	AMEX      
UGA       	US Gasoline                                       	AMEX      
UGAZ      	Natural Gas 3X Long ETN Velocityshares            	AMEX      
UGBP      	Citigroup Global Markets Holdings Inc             	AMEX      
UGE       	Ultra Consumer Goods Proshares                    	AMEX      
UGL       	Ultra Gold Proshares                              	AMEX      
UITB      	Usaa Core Intermediate-Term Bond ETF              	AMEX      
UIVM      	Usaa MSCI Intl Value Momentum Blend Index ETF     	AMEX      
UJB       	Ultra High Yield Proshares                        	AMEX      
UJPY      	Citigroup Global Markets Holdings Inc             	AMEX      
UJUL      	Innovator S&P 500 Ultra Buffer ETF                	AMEX      
ULBR      	Citigroup Global Markets Holdings Inc Velocitysh  	AMEX      
ULE       	Ultra Euro Proshares                              	AMEX      
ULST      	SSGA Ultra Short Term Bond SPDR                   	AMEX      
ULVM      	Usaa MSCI USA Value Momentum Blend Index ETF      	AMEX      
UMDD      	Ultrapro Midcap 400 Proshares                     	AMEX      
UNG       	US Natural Gas Fund                               	AMEX      
UNL       	US 12 Month Natural Gas                           	AMEX      
UOCT      	Innovator S&P 500 Ultra Buffer ETF                	AMEX      
UPRO      	Ultrapro S&P 500 Proshares                        	AMEX      
UPV       	Ultra FTSE Europe Proshares                       	AMEX      
UPW       	Ultra Utilities Proshares                         	AMEX      
UQM       	Uqm Technologies Inc                              	AMEX      
URA       	G-X Uranium ETF                                   	AMEX      
URE       	Ultra Real Estate Proshares                       	AMEX      
URG       	Ur Energy Inc                                     	AMEX      
URR       	Euro 2X ETN Vaneck                                	AMEX      
URTH      	World Ishares MSCI ETF                            	AMEX      
URTY      	Ultrapro Russell 2000 Proshares                   	AMEX      
USAI      	American Energy Independence ETF                  	AMEX      
USAS      	Americas Silver Corp                              	AMEX      
USCI      	US Commodity Index                                	AMEX      
USD       	Ultra Semiconductors Proshares                    	AMEX      
USDU      	Wisdomtree USD Bullish Fund                       	AMEX      
USEQ      	Russell 1000 Enhanced EW Invesco ETF              	AMEX      
USFR      	Wisdomtree Floating Rate Treasury Fund            	AMEX      
USHY      	Broad USD High Yield Corp Bond Ishares ETF        	AMEX      
USL       	US 12 Month Oil                                   	AMEX      
USMF      	Wisdomtree U.S. Multifactor Fund                  	AMEX      
USMV      	USA Min Vol Ishares Edge MSCI ETF                 	AMEX      
USO       	US Oil Fund                                       	AMEX      
USOD      	United States 3X Short Oil Fund                   	AMEX      
USOU      	United States 3X Oil Fund                         	AMEX      
USRT      	US REIT Ishares Core ETF                          	AMEX      
UST       	Ultra 7-10 Year Treasury Proshares                	AMEX      
USTB      	Usaa Core Short-Term Bond ETF                     	AMEX      
USV       	CMCI Silver TR ETN UBS E-Tracs                    	AMEX      
USVM      	Usaa MSCI USA Small Cap Value Momentum Blend Ind  	AMEX      
UTES      	Reaves Utilities ETF                              	AMEX      
UTG       	Reaves Utility                                    	AMEX      
UTRN      	Vesper US Large Cap Short-Term Reversal Strategy  	AMEX      
UTSL      	Direxion Daily Utilities Bull 3X Shares           	AMEX      
UUP       	DB US Dollar Index Bullish Fund Invesco           	AMEX      
UUU       	Universal Security Instruments                    	AMEX      
UUU.W     	Energy Fuels Inc Warrants                         	AMEX      
UUUU      	Energy Fuels Inc                                  	AMEX      
UVXY      	Ultra VIX Short-Term Fut Proshares                	AMEX      
UWM       	Ultra Russell 2000 Proshares                      	AMEX      
UWN       	Nevada Gold & Casinos                             	AMEX      
UWT       	Velocity 3X Long Crude Oil                        	AMEX      
UXI       	Ultra Industrials Proshares                       	AMEX      
UYG       	Ultra Financials Proshares                        	AMEX      
UYM       	Ultra Basic Materials Proshares                   	AMEX      
VALQ      	American Century Stoxx U.S. Quality Value ETF     	AMEX      
VAMO      	Cambria Value and Momentum ETF                    	AMEX      
VAW       	Materials ETF Vanguard                            	AMEX      
VB        	Smallcap ETF Vanguard                             	AMEX      
VBK       	Smallcap Growth ETF Vanguard                      	AMEX      
VBND      	Vident Core U.S. Bond Strategy Fund               	AMEX      
VBR       	Smallcap Value ETF Vanguard                       	AMEX      
VCF       	Delaware Colorado Muni Income Fund Inc            	AMEX      
VCR       	Consumer Disc ETF Vanguard                        	AMEX      
VDC       	Consumer Staples ETF Vanguard                     	AMEX      
VDE       	Energy ETF Vanguard                               	AMEX      
VEA       	FTSE Developed Markets Vanguard                   	AMEX      
VEGA      	Advisorshares Star Global Buy-Write ETF           	AMEX      
VEGI      	Global Agriculture Prod Ishares MSCI ETF          	AMEX      
VESH      	Virtus Enhanced Short U.S. Equity ETF             	AMEX      
VEU       	FTSE All-World Ex-US ETF Vanguard                 	AMEX      
VFH       	Financial ETF Vanguard                            	AMEX      
VFL       	Delaware Florida Insured Muni                     	AMEX      
VFLQ      	Vanguard U.S. Liquidity Factor ETF                	AMEX      
VFMF      	Vanguard U.S. Multifactor ETF                     	AMEX      
VFMO      	Vanguard U.S. Momentum Factor ETF                 	AMEX      
VFMV      	Vanguard U.S. Minimum Volatility ETF              	AMEX      
VFQY      	Vanguard U.S. Quality Factor ETF                  	AMEX      
VFVA      	Vanguard Wellington Fund ETF                      	AMEX      
VGFO      	Virtus Wmc Global Factor Opportunities ETF        	AMEX      
VGK       	Europe ETF FTSE Vanguard                          	AMEX      
VGT       	Information Technology ETF Vanguard               	AMEX      
VGZ       	Vista Gold Corp                                   	AMEX      
VHC       	Virnetx Holding Corp                              	AMEX      
VHT       	Healthcare ETF Vanguard                           	AMEX      
VIDI      	Vident Intl Equity Fund                           	AMEX      
VIG       	Dividend Appreciation ETF Vanguard                	AMEX      
VIOG      	S&P Smallcap 600 Growth Vanguard                  	AMEX      
VIOO      	S&P Smallcap 600 Index Vanguard                   	AMEX      
VIOV      	S&P Smallcap 600 Value Vanguard                   	AMEX      
VIS       	Industrials ETF Vanguard                          	AMEX      
VISI      	Volt Information Services Inc                     	AMEX      
VIXM      	VIX Mid-Term Futures Proshares                    	AMEX      
VIXY      	VIX Short-Term Futures Proshares                  	AMEX      
VKI       	Invesco Advantage Muni Income Trust II            	AMEX      
VLU       	S&P 1500 Value Tilt ETF SPDR                      	AMEX      
VLUE      	USA Value Factor Ishares Edge MSCI ETF            	AMEX      
VMIN      	Rex Volmaxx Inverse VIX Weekly                    	AMEX      
VMM       	Delaware Minnesota Muni II                        	AMEX      
VMOT      	Alpha Architect Value Momentum Trend ETF          	AMEX      
VNLA      	Janus Short Duration Income ETF                   	AMEX      
VNM       	Vietnam Vaneck ETF                                	AMEX      
VNQ       	Vanguard Real Estate ETF                          	AMEX      
VNRX      	Volitionrx Ltd                                    	AMEX      
VO        	Midcap ETF Vanguard                               	AMEX      
VOE       	Midcap Value ETF Vanguard                         	AMEX      
VOO       	S&P 500 ETF Vanguard                              	AMEX      
VOOG      	S&P 500 Growth ETF Vanguard                       	AMEX      
VOOV      	S&P 500 Value ETF Vanguard                        	AMEX      
VOT       	Midcap Growth ETF Vanguard                        	AMEX      
VOX       	Telecom Services ETF Vanguard                     	AMEX      
VPL       	Pacific ETF FTSE Vanguard                         	AMEX      
VPU       	Utilities ETF Vanguard                            	AMEX      
VQT       	S&P 500 Dynamic Veqtor ETN Barclays               	AMEX      
VRP       	Variable Rate Preferred Invesco ETF               	AMEX      
VSGX      	Vanguard ESG International Stock ETF              	AMEX      
VSL       	Volshares Large Cap ETF                           	AMEX      
VSS       	FTSE All-World Ex-US Smcp Idx ETF Vanguard        	AMEX      
VT        	Total World Stock Index ETF Vanguard              	AMEX      
VTEB      	Tax-Exempt Bond Vanguard                          	AMEX      
VTI       	Total Stock Market ETF Vanguard                   	AMEX      
VTV       	Value ETF Vanguard                                	AMEX      
VUG       	Growth ETF Vanguard                               	AMEX      
VUSE      	Vident Core US Equity                             	AMEX      
VV        	Largecap ETF Vanguard                             	AMEX      
VWO       	Emrg Mkts ETF MSCI Vanguard                       	AMEX      
VXF       	Extended Market Index ETF Vanguard                	AMEX      
VXX       	Ipath S&P 500 VIX Short-Term Futures ETN          	AMEX      
VXXB      	Ipath S&P 500 VIX Short-Term Futures Series B Et  	AMEX      
VXZ       	Ipath S&P 500 VIX Mid-Term Futures ETN            	AMEX      
VXZB      	Ipath S&P 500 VIX Mid-Term Futures Series B ETN   	AMEX      
VYM       	High Dividend Yld Indx ETF Vanguard               	AMEX      
WBAL      	Wisdomtree Balanced Income Fund                   	AMEX      
WBIA      	WBI Smg Growth Shares                             	AMEX      
WBIB      	WBI Smg Value Shares                              	AMEX      
WBIC      	WBI Smg Yield Shares                              	AMEX      
WBID      	WBI Smg Select Shares                             	AMEX      
WBIE      	WBI Largecap Growth Shares                        	AMEX      
WBIF      	WBI Largecap Value Shares                         	AMEX      
WBIG      	WBI Largecap Growth Shares                        	AMEX      
WBIH      	WBI High Income Shares                            	AMEX      
WBII      	WBI Income Shares                                 	AMEX      
WBIL      	WBI Largecap Select Shares                        	AMEX      
WBIR      	WBI Rotation Shares                               	AMEX      
WBIY      	WBI Largecap Yield Shares                         	AMEX      
WCHN      	Wisdomtree Icbccs S& P China 500 Fund             	AMEX      
WDIV      	S&P Global Dividend SPDR                          	AMEX      
WDRW      	Direxion Regional Banks Bear 3X                   	AMEX      
WEAT      	Teucrium Wheat                                    	AMEX      
WFHY      	Wisdomtree US Hi Yld Corp Bond Fundamental        	AMEX      
WFIG      	Wisdomtree US Corp Bond Fundamental               	AMEX      
WIL       	Barclays Women In Leadership ETF                  	AMEX      
WIP       	DB Intl Govt Infl-Protected Bond SPDR             	AMEX      
WLDR      	Affinity World Leaders Equity ETF                 	AMEX      
WMCR      	Wilshire Micro-Cap Invesco ETF                    	AMEX      
WMW       	Mstar Wide Moat Focus ETN Elements                	AMEX      
WOMN      	Impact Shares Ywca Women's Empowerment ETF        	AMEX      
WPS       	Intl Devd Property Ishares ETF                    	AMEX      
WREI      	Wilshire US REIT Invesco ETF                      	AMEX      
WRN       	Western Copper Corp                               	AMEX      
WTID      	Crude Daily -3X Inverse Proshares                 	AMEX      
WTIU      	Crude Daily 3X Long Proshares                     	AMEX      
WTMF      	Wisdomtree Managed Futures Strategy Fund          	AMEX      
WTT       	Wireless Telecom Group Inc                        	AMEX      
WYDE      	CDS Short N Amer HY Credit Proshares              	AMEX      
WYY       	Widepoint Corp                                    	AMEX      
XAR       	S&P Aerospace & Defense SPDR                      	AMEX      
XBI       	S&P Biotech SPDR                                  	AMEX      
XCEM      	Columbia EM Core Ex-China ETF                     	AMEX      
XDIV      	U.S. Equity Ex-Dividend Fund Series 2027 Shares   	AMEX      
XES       	S&P Oil & Gas Eqpt & Services SPDR                	AMEX      
XHB       	S&P Homebuilders SPDR                             	AMEX      
XHE       	S&P Healthcare Equipment SPDR                     	AMEX      
XHS       	S&P Healthcare Services SPDR                      	AMEX      
XINA      	China A Shares IMI MSCI ETF SPDR                  	AMEX      
XITK      	Factset Innovative Technology SPDR                	AMEX      
XKCP      	SPDR Kensho Clean Power ETF                       	AMEX      
XKFF      	SPDR Kensho Final Frontiers ETF                   	AMEX      
XKFS      	SPDR Kensho Future Security ETF                   	AMEX      
XKII      	SPDR Kensho Intelligent Structures ETF            	AMEX      
XKST      	SPDR Kensho Smart Mobility ETF                    	AMEX      
XLB       	S&P 500 Materials Sector SPDR                     	AMEX      
XLC       	S&P 500 Communication Sector SPDR                 	AMEX      
XLE       	S&P 500 Energy Sector SPDR                        	AMEX      
XLF       	S&P 500 Financials Sector SPDR                    	AMEX      
XLG       	S&P 500 Top 50 Invesco ETF                        	AMEX      
XLI       	S&P 500 Industrial Sector SPDR                    	AMEX      
XLK       	S&P 500 Info Tech Sector SPDR                     	AMEX      
XLP       	S&P 500 Cons Staples Sector SPDR                  	AMEX      
XLRE      	S&P 500 Real Estate Sector SPDR                   	AMEX      
XLU       	S&P 500 Utilities Sector SPDR                     	AMEX      
XLV       	S&P 500 Healthcare Sector SPDR                    	AMEX      
XLY       	S&P 500 Cons Disc Sector SPDR                     	AMEX      
XME       	S&P Metals & Mining SPDR                          	AMEX      
XMLV      	S&P Midcap Low Vol Invesco ETF                    	AMEX      
XMPT      	CEF Municipal Income ETF Vaneck                   	AMEX      
XMX       	Wisdomtree Global Ex-Mexico Equity Fund           	AMEX      
XNTK      	SPDR Series Trust                                 	AMEX      
XOP       	S&P Oil & Gas Expl & Prod SPDR                    	AMEX      
XPH       	S&P Pharmaceuticals SPDR                          	AMEX      
XPL       	Solitario Zinc Corp                               	AMEX      
XPP       	Ultra FTSE China 25 Proshares                     	AMEX      
XRLV      	S&P 500 Ex-Rate Sensitive Low Vol Invesco ETF     	AMEX      
XRT       	S&P Retail SPDR                                   	AMEX      
XSD       	S&P Semiconductor SPDR                            	AMEX      
XSHD      	S&P Smallcap High Dividend Low Vol Invesco ETF    	AMEX      
XSHQ      	S&P Smallcap Quality Invesco ETF                  	AMEX      
XSLV      	S&P Smallcap Low Vol Invesco ETF                  	AMEX      
XSOE      	Wisdomtree EM Ex-Soe Fund                         	AMEX      
XSW       	S&P Software & Srvs ETF SPDR                      	AMEX      
XTH       	S&P Tech Hardware Et SPDR                         	AMEX      
XTL       	S&P 500 Telecom Sector SPDR                       	AMEX      
XTN       	S&P Transportation SPDR                           	AMEX      
XTNT      	Xtant Medical Holdings Inc                        	AMEX      
XUSA      	Quantx Dynamic Beta US Equity ETF                 	AMEX      
XVZ       	Ipath S&P 500 Dynamic VIX ETN                     	AMEX      
XWEB      	S&P Internet ETF SPDR                             	AMEX      
XXII      	22nd Century Group Inc                            	AMEX      
YANG      	Direxion FTSE China Bear 3X                       	AMEX      
YAO       	China All-Cap Invesco ETF                         	AMEX      
YCL       	Ultra Yen Proshares                               	AMEX      
YCS       	Ultrashort Yen Proshares                          	AMEX      
YINN      	Direxion FTSE China Bull 3X                       	AMEX      
YLD       	Principal Edge Active Income ETF                  	AMEX      
YMLI      	High Income Infrastructure MLP Fund Vaneck        	AMEX      
YMLP      	High Income MLP ETF Yorkville                     	AMEX      
YUMA      	Yuma Energy Inc                                   	AMEX      
YXI       	China 25 Short Proshares                          	AMEX      
YYY       	Yieldshares High Income ETF                       	AMEX      
ZCAN      	SPDR Solactive Canada ETF                         	AMEX      
ZDEU      	SPDR Solactive Germany ETF                        	AMEX      
ZDGE      	Zedge Inc Class B                                 	AMEX      
ZGBR      	SPDR Solactive United Kingdom ETF                 	AMEX      
ZHOK      	SPDR Solactive Hong Kong ETF                      	AMEX      
ZJPN      	SPDR Solactive Japan ETF                          	AMEX      
ZMLP      	Direxion Zacks MLP High Income ETF                	AMEX      
ZOM       	Zomedica Pharmaceuticals Corp                     	AMEX      
ZROZ      	25+ Year Zero Cpn U.S. Trsy Idx ETF Pimco         	AMEX      
ZSL       	Ultrashort Silver Proshares                       	AMEX      
