AEDAUD    	UAE Dirham / Australian Dollar                    	FOREX     
AEDCAD    	UAE Dirham / Canadian Dollar                      	FOREX     
AEDCHF    	UAE Dirham / Swiss Franc                          	FOREX     
AEDDKK    	UAE Dirham / Danish Krone                         	FOREX     
AEDEUR    	UAE Dirham / Euro Dollar                          	FOREX     
AEDGBP    	UAE Dirham / Pound Sterling                       	FOREX     
AEDINR    	UAE Dirham / Indian Rupee                         	FOREX     
AEDJPY    	UAE Dirham / Japanese Yen                         	FOREX     
AEDNOK    	UAE Dirham / Norwegian Krone                      	FOREX     
AEDNZD    	UAE Dirham / New Zealand Dollar                   	FOREX     
AEDPKR    	UAE Dirham / Pakistan Rupee                       	FOREX     
AEDSAR    	UAE Dirham / Saudi Riyal                          	FOREX     
AEDSEK    	UAE Dirham / Swedish Krona                        	FOREX     
AEDUSD    	UAE Dirham / US Dollar                            	FOREX     
AEDZAR    	UAE Dirham / South African Rand                   	FOREX     
ALLGBP    	Lek / Pound Sterling                              	FOREX     
ARSAUD    	Argentine Peso / Australian Dollar                	FOREX     
ARSBRL    	Argentine Peso / Brazilian Real                   	FOREX     
ARSCAD    	Argentine Peso / Canadian Dollar                  	FOREX     
ARSCHF    	Argentine Peso / Swiss Franc                      	FOREX     
ARSEUR    	Argentine Peso / Euro Dollar                      	FOREX     
ARSGBP    	Argentine Peso / Pound Sterling                   	FOREX     
ARSHKD    	Argentine Peso / Hong Kong Dollar                 	FOREX     
ARSHUF    	Argentine Peso / Hungarian Forint                 	FOREX     
ARSJPY    	Argentine Peso / Japanese Yen                     	FOREX     
ARSMXN    	Argentine Peso / Mexican Peso                     	FOREX     
ARSSGD    	Argentine Peso / Singapore Dollar                 	FOREX     
ARSUSD    	Argentine Peso / US Dollar                        	FOREX     
ARSZAR    	Argentine Peso / South African Rand               	FOREX     
AUDAED    	Australian Dollar / UAE Dirham                    	FOREX     
AUDARS    	Australian Dollar / Argentine Peso                	FOREX     
AUDBRL    	Australian Dollar / Brazilian Real                	FOREX     
AUDCAD    	Australian Dollar / Canadian Dollar               	FOREX     
AUDCHF    	Australian Dollar / Swiss Franc                   	FOREX     
AUDCNH    	Australian Dollar / Renminbi (Offshore)           	FOREX     
AUDCNY    	Australian Dollar / Yuan Renminbi                 	FOREX     
AUDCZK    	Australian Dollar / Czech Koruna                  	FOREX     
AUDDKK    	Australian Dollar / Danish Krone                  	FOREX     
AUDEUR    	Australian Dollar / Euro Dollar                   	FOREX     
AUDFJD    	Australian Dollar / Fiji Dollar                   	FOREX     
AUDGBP    	Australian Dollar / Pound Sterling                	FOREX     
AUDHKD    	Australian Dollar / Hong Kong Dollar              	FOREX     
AUDHUF    	Australian Dollar / Hungarian Forint              	FOREX     
AUDIDR    	Australian Dollar / Indian Rupiah                 	FOREX     
AUDILS    	Australian Dollar / New Israeli Sheqel            	FOREX     
AUDINR    	Australian Dollar / Indian Rupee                  	FOREX     
AUDJPY    	Australian Dollar / Japanese Yen                  	FOREX     
AUDKRW    	Australian Dollar / Korean Won                    	FOREX     
AUDMXN    	Australian Dollar / Mexican Peso                  	FOREX     
AUDMYR    	Australian Dollar / Malaysian Ringgit             	FOREX     
AUDNOK    	Australian Dollar / Norwegian Krone               	FOREX     
AUDNZD    	Australian Dollar / New Zealand Dollar            	FOREX     
AUDPHP    	Australian Dollar / Philippine Peso               	FOREX     
AUDPKR    	Australian Dollar / Pakistan Rupee                	FOREX     
AUDPLN    	Australian Dollar / Polish Zloty                  	FOREX     
AUDSEK    	Australian Dollar / Swedish Krona                 	FOREX     
AUDSGD    	Australian Dollar / Singapore Dollar              	FOREX     
AUDTHB    	Australian Dollar / Thai Baht                     	FOREX     
AUDTRY    	Australian Dollar / Turkish Lira                  	FOREX     
AUDTWD    	Australian Dollar / New Taiwan Dollar             	FOREX     
AUDUSD    	Australian Dollar / US Dollar                     	FOREX     
AUDZAR    	Australian Dollar / South African Rand            	FOREX     
AWGUSD    	Aruban Guilder / US Dollar                        	FOREX     
BDTGBP    	Taka / Pound Sterling                             	FOREX     
BDTJPY    	Taka / Japanese Yen                               	FOREX     
BGNCNY    	Bulgarian Lev / Yuan Renminbi                     	FOREX     
BGNDKK    	Bulgarian Lev / Danish Krone                      	FOREX     
BGNPLN    	Bulgarian Lev / Polish Zloty                      	FOREX     
BGNUSD    	Bulgarian Lev / US Dollar                         	FOREX     
BHDEUR    	Bahraini Dinar / Euro Dollar                      	FOREX     
BHDPKR    	Bahraini Dinar / Pakistan Rupee                   	FOREX     
BHDUSD    	Bahraini Dinar / US Dollar                        	FOREX     
BNDGBP    	Brunei Dollar / Pound Sterling                    	FOREX     
BRLARS    	Brazilian Real / Argentine Peso                   	FOREX     
BRLAUD    	Brazilian Real / Australian Dollar                	FOREX     
BRLCAD    	Brazilian Real / Canadian Dollar                  	FOREX     
BRLCHF    	Brazilian Real / Swiss Franc                      	FOREX     
BRLEUR    	Brazilian Real / Euro Dollar                      	FOREX     
BRLHKD    	Brazilian Real / Hong Kong Dollar                 	FOREX     
BRLJPY    	Brazilian Real / Japanese Yen                     	FOREX     
BRLKRW    	Brazilian Real / Korean Won                       	FOREX     
BRLMXN    	Brazilian Real / Mexican Peso                     	FOREX     
BRLRUB    	Brazilian Real / Russian Ruble                    	FOREX     
BRLSEK    	Brazilian Real / Swedish Krona                    	FOREX     
BRLSGD    	Brazilian Real / Singapore Dollar                 	FOREX     
BRLUSD    	Brazilian Real / US Dollar                        	FOREX     
BRLZAR    	Brazilian Real / South African Rand               	FOREX     
BWPCHF    	Pula / Swiss Franc                                	FOREX     
BWPEUR    	Pula / Euro Dollar                                	FOREX     
BWPGBP    	Pula / Pound Sterling                             	FOREX     
BWPUSD    	Pula / US Dollar                                  	FOREX     
BWPZAR    	Pula / South African Rand                         	FOREX     
CADAED    	Canadian Dollar / UAE Dirham                      	FOREX     
CADARS    	Canadian Dollar / Argentine Peso                  	FOREX     
CADAUD    	Canadian Dollar / Australian Dollar               	FOREX     
CADBRL    	Canadian Dollar / Brazilian Real                  	FOREX     
CADCHF    	Canadian Dollar / Swiss Franc                     	FOREX     
CADCNH    	Canadian Dollar / Renminbi (Offshore)             	FOREX     
CADCNY    	Canadian Dollar / Yuan Renminbi                   	FOREX     
CADDKK    	Canadian Dollar / Danish Krone                    	FOREX     
CADEUR    	Canadian Dollar / Euro Dollar                     	FOREX     
CADGBP    	Canadian Dollar / Pound Sterling                  	FOREX     
CADHKD    	Canadian Dollar / Hong Kong Dollar                	FOREX     
CADIDR    	Canadian Dollar / Indian Rupiah                   	FOREX     
CADILS    	Canadian Dollar / New Israeli Sheqel              	FOREX     
CADINR    	Canadian Dollar / Indian Rupee                    	FOREX     
CADISK    	Canadian Dollar / Iceland Krona                   	FOREX     
CADJPY    	Canadian Dollar / Japanese Yen                    	FOREX     
CADKRW    	Canadian Dollar / Korean Won                      	FOREX     
CADKWD    	Canadian Dollar / Kuwaiti Dinar                   	FOREX     
CADMXN    	Canadian Dollar / Mexican Peso                    	FOREX     
CADMYR    	Canadian Dollar / Malaysian Ringgit               	FOREX     
CADNOK    	Canadian Dollar / Norwegian Krone                 	FOREX     
CADNZD    	Canadian Dollar / New Zealand Dollar              	FOREX     
CADPKR    	Canadian Dollar / Pakistan Rupee                  	FOREX     
CADPLN    	Canadian Dollar / Polish Zloty                    	FOREX     
CADRUB    	Canadian Dollar / Russian Ruble                   	FOREX     
CADSEK    	Canadian Dollar / Swedish Krona                   	FOREX     
CADSGD    	Canadian Dollar / Singapore Dollar                	FOREX     
CADTHB    	Canadian Dollar / Thai Baht                       	FOREX     
CADTRY    	Canadian Dollar / Turkish Lira                    	FOREX     
CADTWD    	Canadian Dollar / New Taiwan Dollar               	FOREX     
CADUSD    	Canadian Dollar / US Dollar                       	FOREX     
CADZAR    	Canadian Dollar / South African Rand              	FOREX     
CDFUSD    	Franc Congolais / US Dollar                       	FOREX     
CHFAED    	Swiss Franc / UAE Dirham                          	FOREX     
CHFARS    	Swiss Franc / Argentine Peso                      	FOREX     
CHFAUD    	Swiss Franc / Australian Dollar                   	FOREX     
CHFBRL    	Swiss Franc / Brazilian Real                      	FOREX     
CHFBWP    	Swiss Franc / Pula                                	FOREX     
CHFCAD    	Swiss Franc / Canadian Dollar                     	FOREX     
CHFCNH    	Swiss Franc / Renminbi (Offshore)                 	FOREX     
CHFCNY    	Swiss Franc / Yuan Renminbi                       	FOREX     
CHFCZK    	Swiss Franc / Czech Koruna                        	FOREX     
CHFDKK    	Swiss Franc / Danish Krone                        	FOREX     
CHFEUR    	Swiss Franc / Euro Dollar                         	FOREX     
CHFGBP    	Swiss Franc / Pound Sterling                      	FOREX     
CHFHKD    	Swiss Franc / Hong Kong Dollar                    	FOREX     
CHFHUF    	Swiss Franc / Hungarian Forint                    	FOREX     
CHFIDR    	Swiss Franc / Indian Rupiah                       	FOREX     
CHFILS    	Swiss Franc / New Israeli Sheqel                  	FOREX     
CHFINR    	Swiss Franc / Indian Rupee                        	FOREX     
CHFISK    	Swiss Franc / Iceland Krona                       	FOREX     
CHFJPY    	Swiss Franc / Japanese Yen                        	FOREX     
CHFKRW    	Swiss Franc / Korean Won                          	FOREX     
CHFMXN    	Swiss Franc / Mexican Peso                        	FOREX     
CHFMYR    	Swiss Franc / Malaysian Ringgit                   	FOREX     
CHFNOK    	Swiss Franc / Norwegian Krone                     	FOREX     
CHFNZD    	Swiss Franc / New Zealand Dollar                  	FOREX     
CHFPKR    	Swiss Franc / Pakistan Rupee                      	FOREX     
CHFPLN    	Swiss Franc / Polish Zloty                        	FOREX     
CHFRON    	Swiss Franc / Romanian Leu                        	FOREX     
CHFRUB    	Swiss Franc / Russian Ruble                       	FOREX     
CHFSEK    	Swiss Franc / Swedish Krona                       	FOREX     
CHFSGD    	Swiss Franc / Singapore Dollar                    	FOREX     
CHFSZL    	Swiss Franc / Lilangeni                           	FOREX     
CHFTHB    	Swiss Franc / Thai Baht                           	FOREX     
CHFTRY    	Swiss Franc / Turkish Lira                        	FOREX     
CHFTWD    	Swiss Franc / New Taiwan Dollar                   	FOREX     
CHFUSD    	Swiss Franc / US Dollar                           	FOREX     
CHFUZS    	Swiss Franc / Uzbekistan Sum                      	FOREX     
CHFZAR    	Swiss Franc / South African Rand                  	FOREX     
CLPEUR    	Chilean Peso / Euro Dollar                        	FOREX     
CLPGBP    	Chilean Peso / Pound Sterling                     	FOREX     
CLPUSD    	Chilean Peso / US Dollar                          	FOREX     
CNHHKD    	Renminbi (Offshore) / Hong Kong Dollar            	FOREX     
CNHIDR    	Renminbi (Offshore) / Indonesian Rupiah           	FOREX     
CNHINR    	Renminbi (Offshore) / Indian Rupee                	FOREX     
CNHJPY    	Renminbi (Offshore) / Japanese Yen                	FOREX     
CNHKRW    	Renminbi (Offshore) / Korean Won                  	FOREX     
CNHPHP    	Renminbi (Offshore) / Philippine Peso             	FOREX     
CNHTHB    	Renminbi (Offshore) / Thai Baht                   	FOREX     
CNHTWD    	Renminbi (Offshore) / New Taiwan Dollar           	FOREX     
CNYAUD    	Yuan Renminbi / Australian Dollar                 	FOREX     
CNYBGN    	Yuan Renminbi / Bulgarian Lev                     	FOREX     
CNYCAD    	Yuan Renminbi / Canadian Dollar                   	FOREX     
CNYCHF    	Yuan Renminbi / Swiss Franc                       	FOREX     
CNYDKK    	Yuan Renminbi / Danish Krone                      	FOREX     
CNYEUR    	Yuan Renminbi / Euro Dollar                       	FOREX     
CNYGBP    	Yuan Renminbi / Pound Sterling                    	FOREX     
CNYHKD    	Yuan Renminbi / Hong Kong Dollar                  	FOREX     
CNYJPY    	Yuan Renminbi / Japanese Yen                      	FOREX     
CNYKRW    	Yuan Renminbi / Korean Won                        	FOREX     
CNYNZD    	Yuan Renminbi / New Zealand Dollar                	FOREX     
CNYPLN    	Yuan Renminbi / Polish Zloty                      	FOREX     
CNYUSD    	Yuan Renminbi / US Dollar                         	FOREX     
CNYZAR    	Yuan Renminbi / South African Rand                	FOREX     
COPDKK    	Colombian Peso / Danish Krone                     	FOREX     
COPPLN    	Colombian Peso / Polish Zloty                     	FOREX     
CRCGBP    	Costa Rican Colon / Pound Sterling                	FOREX     
CYPZAR    	Cyprus Pound / South African Rand                 	FOREX     
CZKCHF    	Czech Koruna / Swiss Franc                        	FOREX     
CZKDKK    	Czech Koruna / Danish Krone                       	FOREX     
CZKEUR    	Czech Koruna / Euro Dollar                        	FOREX     
CZKJPY    	Czech Koruna / Japanese Yen                       	FOREX     
CZKMXN    	Czech Koruna / Mexican Peso                       	FOREX     
CZKNOK    	Czech Koruna / Norwegian Krone                    	FOREX     
CZKPLN    	Czech Koruna / Polish Zloty                       	FOREX     
CZKSEK    	Czech Koruna / Swedish Krona                      	FOREX     
CZKUSD    	Czech Koruna / US Dollar                          	FOREX     
DJFGBP    	Djibouti Franc / Pound Sterling                   	FOREX     
DKKAED    	Danish Krone / UAE Dirham                         	FOREX     
DKKAUD    	Danish Krone / Australian Dollar                  	FOREX     
DKKBGN    	Danish Krone / Bulgarian Lev                      	FOREX     
DKKCAD    	Danish Krone / Canadian Dollar                    	FOREX     
DKKCHF    	Danish Krone / Swiss Franc                        	FOREX     
DKKCNY    	Danish Krone / Yuan Renminbi                      	FOREX     
DKKCOP    	Danish Krone / Colombian Peso                     	FOREX     
DKKCZK    	Danish Krone / Czech Koruna                       	FOREX     
DKKEUR    	Danish Krone / Euro Dollar                        	FOREX     
DKKGBP    	Danish Krone / Pound Sterling                     	FOREX     
DKKHKD    	Danish Krone / Hong Kong Dollar                   	FOREX     
DKKHUF    	Danish Krone / Hungarian Forint                   	FOREX     
DKKINR    	Danish Krone / Indian Rupee                       	FOREX     
DKKISK    	Danish Krone / Iceland Krona                      	FOREX     
DKKJPY    	Danish Krone / Japanese Yen                       	FOREX     
DKKMXN    	Danish Krone / Mexican Peso                       	FOREX     
DKKMYR    	Danish Krone / Malaysian Ringgit                  	FOREX     
DKKNOK    	Danish Krone / Norwegian Krone                    	FOREX     
DKKNZD    	Danish Krone / New Zealand Dollar                 	FOREX     
DKKPHP    	Danish Krone / Philippine Peso                    	FOREX     
DKKPKR    	Danish Krone / Pakistan Rupee                     	FOREX     
DKKPLN    	Danish Krone / Polish Zloty                       	FOREX     
DKKSEK    	Danish Krone / Swedish Krona                      	FOREX     
DKKSGD    	Danish Krone / Singapore Dollar                   	FOREX     
DKKTHB    	Danish Krone / Thai Baht                          	FOREX     
DKKTRY    	Danish Krone / Turkish Lira                       	FOREX     
DKKTWD    	Danish Krone / New Taiwan Dollar                  	FOREX     
DKKUAH    	Danish Krone / Hryvnia                            	FOREX     
DKKUSD    	Danish Krone / US Dollar                          	FOREX     
DKKZAR    	Danish Krone / South African Rand                 	FOREX     
DOPGBP    	Dominican Peso / Pound Sterling                   	FOREX     
DZDEUR    	Algerian Dinar / Euro Dollar                      	FOREX     
DZDUSD    	Algerian Dinar / US Dollar                        	FOREX     
EGPEUR    	Egyptian Pound / Euro Dollar                      	FOREX     
EGPJPY    	Egyptian Pound / Japanese Yen                     	FOREX     
EGPPKR    	Egyptian Pound / Pakistan Rupee                   	FOREX     
EGPUSD    	Egyptian Pound / US Dollar                        	FOREX     
ETBGBP    	Ethiopian Birr / Pound Sterling                   	FOREX     
EURAED    	Euro Dollar / UAE Dirham                          	FOREX     
EURAFN    	Euro Dollar / Afghani                             	FOREX     
EURALL    	Euro Dollar / Lek                                 	FOREX     
EURAMD    	Euro Dollar / Armenian Dram                       	FOREX     
EURARS    	Euro Dollar / Argentine Peso                      	FOREX     
EURAUD    	Euro Dollar / Australian Dollar                   	FOREX     
EURBAM    	Euro Dollar / Convertible Marks                   	FOREX     
EURBBD    	Euro Dollar / Barbados Dollar                     	FOREX     
EURBDT    	Euro Dollar / Taka                                	FOREX     
EURBGN    	Euro Dollar / Bulgarian Lev                       	FOREX     
EURBHD    	Euro Dollar / Bahraini Dinar                      	FOREX     
EURBIF    	Euro Dollar / Burundi Franc                       	FOREX     
EURBND    	Euro Dollar / Brunei Dollar                       	FOREX     
EURBOB    	Euro Dollar / Boliviano                           	FOREX     
EURBRL    	Euro Dollar / Brazilian Real                      	FOREX     
EURBSD    	Euro Dollar / Bahamian Dollar                     	FOREX     
EURBWP    	Euro Dollar / Pula                                	FOREX     
EURBZD    	Euro Dollar / Belize Dollar                       	FOREX     
EURCAD    	Euro Dollar / Canadian Dollar                     	FOREX     
EURCHF    	Euro Dollar / Swiss Franc                         	FOREX     
EURCLP    	Euro Dollar / Chilean Peso                        	FOREX     
EURCNH    	Euro Dollar / Renminbi (Offshore)                 	FOREX     
EURCNY    	Euro Dollar / Yuan Renminbi                       	FOREX     
EURCOP    	Euro Dollar / Colombian Peso                      	FOREX     
EURCRC    	Euro Dollar / Costa Rican Colon                   	FOREX     
EURCUP    	Euro Dollar / Cuban Peso                          	FOREX     
EURCVE    	Euro Dollar / Cape Verde Escudo                   	FOREX     
EURCZK    	Euro Dollar / Czech Koruna                        	FOREX     
EURDJF    	Euro Dollar / Djibouti Franc                      	FOREX     
EURDKK    	Euro Dollar / Danish Krone                        	FOREX     
EURDOP    	Euro Dollar / Dominican Peso                      	FOREX     
EURDZD    	Euro Dollar / Algerian Dinar                      	FOREX     
EUREGP    	Euro Dollar / Egyptian Pound                      	FOREX     
EURETB    	Euro Dollar / Ethiopian Birr                      	FOREX     
EURFJD    	Euro Dollar / Fiji Dollar                         	FOREX     
EURGBP    	Euro Dollar / Pound Sterling                      	FOREX     
EURGHS    	Euro Dollar / Cedi                                	FOREX     
EURGNF    	Euro Dollar / Guinea Franc                        	FOREX     
EURGTQ    	Euro Dollar / Guatemalan Quetzal                  	FOREX     
EURHKD    	Euro Dollar / Hong Kong Dollar                    	FOREX     
EURHNL    	Euro Dollar / Honduran Lempira                    	FOREX     
EURHRK    	Euro Dollar / Croatian kuna                       	FOREX     
EURHTG    	Euro Dollar / Gourde                              	FOREX     
EURHUF    	Euro Dollar / Hungarian Forint                    	FOREX     
EURIDR    	Euro Dollar / Indian Rupiah                       	FOREX     
EURILS    	Euro Dollar / New Israeli Sheqel                  	FOREX     
EURINR    	Euro Dollar / Indian Rupee                        	FOREX     
EURIQD    	Euro Dollar / Iraqi Dinar                         	FOREX     
EURISK    	Euro Dollar / Iceland Krona                       	FOREX     
EURJMD    	Euro Dollar / Jamaican Dollar                     	FOREX     
EURJOD    	Euro Dollar / Jordanian Dinar                     	FOREX     
EURJPY    	Euro Dollar / Japanese Yen                        	FOREX     
EURKES    	Euro Dollar / Kenyan Shilling                     	FOREX     
EURKHR    	Euro Dollar / Riel                                	FOREX     
EURKRW    	Euro Dollar / Korean Won                          	FOREX     
EURKWD    	Euro Dollar / Kuwaiti Dinar                       	FOREX     
EURKYD    	Euro Dollar / Cayman Islands Dollar               	FOREX     
EURKZT    	Euro Dollar / Tenge                               	FOREX     
EURLAK    	Euro Dollar / Kip                                 	FOREX     
EURLBP    	Euro Dollar / Lebanese Pound                      	FOREX     
EURLKR    	Euro Dollar / Sri Lanka Rupee                     	FOREX     
EURLSL    	Euro Dollar / Loti                                	FOREX     
EURLYD    	Euro Dollar / Lybian Dinar                        	FOREX     
EURMAD    	Euro Dollar / Moroccan Dirham                     	FOREX     
EURMDL    	Euro Dollar / Moldovan Leu                        	FOREX     
EURMKD    	Euro Dollar / Denar                               	FOREX     
EURMMK    	Euro Dollar / Kyat                                	FOREX     
EURMOP    	Euro Dollar / Pataca                              	FOREX     
EURMRO    	Euro Dollar / Ouguiya                             	FOREX     
EURMUR    	Euro Dollar / Mauritius Rupee                     	FOREX     
EURMVR    	Euro Dollar / Rufiyaa                             	FOREX     
EURMWK    	Euro Dollar / Kwacha                              	FOREX     
EURMXN    	Euro Dollar / Mexican Peso                        	FOREX     
EURMYR    	Euro Dollar / Malaysian Ringgit                   	FOREX     
EURNAD    	Euro Dollar / Namibia Dollar                      	FOREX     
EURNGN    	Euro Dollar / Naira                               	FOREX     
EURNIO    	Euro Dollar / Cordoba Oro                         	FOREX     
EURNOK    	Euro Dollar / Norwegian Krone                     	FOREX     
EURNPR    	Euro Dollar / Nepalese Rupee                      	FOREX     
EURNZD    	Euro Dollar / New Zealand Dollar                  	FOREX     
EUROMR    	Euro Dollar / Rial Omani                          	FOREX     
EURPAB    	Euro Dollar / Balboa                              	FOREX     
EURPEN    	Euro Dollar / Nuevo Sol                           	FOREX     
EURPGK    	Euro Dollar / Papua New Guinea Kina               	FOREX     
EURPHP    	Euro Dollar / Philippine Peso                     	FOREX     
EURPKR    	Euro Dollar / Pakistan Rupee                      	FOREX     
EURPLN    	Euro Dollar / Polish Zloty                        	FOREX     
EURPYG    	Euro Dollar / Guarani                             	FOREX     
EURQAR    	Euro Dollar / Qatari Rial                         	FOREX     
EURRON    	Euro Dollar / Romanian Leu                        	FOREX     
EURRSD    	Euro Dollar / Serbian Dinar                       	FOREX     
EURRUB    	Euro Dollar / Russian Ruble                       	FOREX     
EURRWF    	Euro Dollar / Rwanda Franc                        	FOREX     
EURSAR    	Euro Dollar / Saudi Riyal                         	FOREX     
EURSCR    	Euro Dollar / Seychelles Rupee                    	FOREX     
EURSDD    	Euro Dollar / Sudanese Dinar                      	FOREX     
EURSEK    	Euro Dollar / Swedish Krona                       	FOREX     
EURSGD    	Euro Dollar / Singapore Dollar                    	FOREX     
EURSOS    	Euro Dollar / Somali Shilling                     	FOREX     
EURSTD    	Euro Dollar / Dobra                               	FOREX     
EURSVC    	Euro Dollar / El Salvador Colon                   	FOREX     
EURSZL    	Euro Dollar / Lilangeni                           	FOREX     
EURTHB    	Euro Dollar / Thai Baht                           	FOREX     
EURTND    	Euro Dollar / Tunisian Dinar                      	FOREX     
EURTRY    	Euro Dollar / Turkish Lira                        	FOREX     
EURTTD    	Euro Dollar / Trinidad and Tobago Dollar          	FOREX     
EURTWD    	Euro Dollar / New Taiwan Dollar                   	FOREX     
EURTZS    	Euro Dollar / Tanzanian Shilling                  	FOREX     
EURUAH    	Euro Dollar / Hryvnia                             	FOREX     
EURUGX    	Euro Dollar / Uganda Shilling                     	FOREX     
EURUSD    	Euro Dollar / US Dollar                           	FOREX     
EURUYU    	Euro Dollar / Peso Uruguayo                       	FOREX     
EURUZS    	Euro Dollar / Uzbekistan Sum                      	FOREX     
EURVEF    	Euro Dollar / Venezualan bolivar fuerte           	FOREX     
EURVND    	Euro Dollar / Dong                                	FOREX     
EURXAF    	Euro Dollar / CFA Franc BEAC                      	FOREX     
EURXOF    	Euro Dollar / CFA Franc BCEAO                     	FOREX     
EURXPF    	Euro Dollar / CFP Franc                           	FOREX     
EURYER    	Euro Dollar / Yemeni Rial                         	FOREX     
EURZAR    	Euro Dollar / South African Rand                  	FOREX     
FJDGBP    	Fiji Dollar / Pound Sterling                      	FOREX     
FJDUSD    	Fiji Dollar / US Dollar                           	FOREX     
GBPAED    	Pound Sterling / UAE Dirham                       	FOREX     
GBPALL    	Pound Sterling / Lek                              	FOREX     
GBPARS    	Pound Sterling / Argentine Peso                   	FOREX     
GBPAUD    	Pound Sterling / Australian Dollar                	FOREX     
GBPBDT    	Pound Sterling / Taka                             	FOREX     
GBPBGN    	Pound Sterling / Bulgarian Lev                    	FOREX     
GBPBHD    	Pound Sterling / Bahraini Dinar                   	FOREX     
GBPBIF    	Pound Sterling / Burundi Franc                    	FOREX     
GBPBMD    	Pound Sterling / Bermudian Dollar                 	FOREX     
GBPBND    	Pound Sterling / Brunei Dollar                    	FOREX     
GBPBRL    	Pound Sterling / Brazilian Real                   	FOREX     
GBPBWP    	Pound Sterling / Pula                             	FOREX     
GBPCAD    	Pound Sterling / Canadian Dollar                  	FOREX     
GBPCHF    	Pound Sterling / Swiss Franc                      	FOREX     
GBPCLP    	Pound Sterling / Chilean Peso                     	FOREX     
GBPCNH    	Pound Sterling / Renminbi (Offshore)              	FOREX     
GBPCNY    	Pound Sterling / Yuan Renminbi                    	FOREX     
GBPCOP    	Pound Sterling / Colombian Peso                   	FOREX     
GBPCRC    	Pound Sterling / Costa Rican Colon                	FOREX     
GBPCZK    	Pound Sterling / Czech Koruna                     	FOREX     
GBPDJF    	Pound Sterling / Djibouti Franc                   	FOREX     
GBPDKK    	Pound Sterling / Danish Krone                     	FOREX     
GBPDOP    	Pound Sterling / Dominican Peso                   	FOREX     
GBPDZD    	Pound Sterling / Algerian Dinar                   	FOREX     
GBPEGP    	Pound Sterling / Egyptian Pound                   	FOREX     
GBPETB    	Pound Sterling / Ethiopian Birr                   	FOREX     
GBPEUR    	Pound Sterling / Euro Dollar                      	FOREX     
GBPFJD    	Pound Sterling / Fiji Dollar                      	FOREX     
GBPGTQ    	Pound Sterling / Guatemalan Quetzal               	FOREX     
GBPHKD    	Pound Sterling / Hong Kong Dollar                 	FOREX     
GBPHNL    	Pound Sterling / Honduran Lempira                 	FOREX     
GBPHRK    	Pound Sterling / Croatian kuna                    	FOREX     
GBPHTG    	Pound Sterling / Gourde                           	FOREX     
GBPHUF    	Pound Sterling / Hungarian Forint                 	FOREX     
GBPIDR    	Pound Sterling / Indian Rupiah                    	FOREX     
GBPILS    	Pound Sterling / New Israeli Sheqel               	FOREX     
GBPINR    	Pound Sterling / Indian Rupee                     	FOREX     
GBPIQD    	Pound Sterling / Iraqi Dinar                      	FOREX     
GBPISK    	Pound Sterling / Iceland Krona                    	FOREX     
GBPJMD    	Pound Sterling / Jamaican Dollar                  	FOREX     
GBPJOD    	Pound Sterling / Jordanian Dinar                  	FOREX     
GBPJPY    	Pound Sterling / Japanese Yen                     	FOREX     
GBPKES    	Pound Sterling / Kenyan Shilling                  	FOREX     
GBPKRW    	Pound Sterling / Korean Won                       	FOREX     
GBPKWD    	Pound Sterling / Kuwaiti Dinar                    	FOREX     
GBPKZT    	Pound Sterling / Tenge                            	FOREX     
GBPLBP    	Pound Sterling / Lebanese Pound                   	FOREX     
GBPLKR    	Pound Sterling / Sri Lanka Rupee                  	FOREX     
GBPMAD    	Pound Sterling / Moroccan Dirham                  	FOREX     
GBPMUR    	Pound Sterling / Mauritius Rupee                  	FOREX     
GBPMVR    	Pound Sterling / Rufiyaa                          	FOREX     
GBPMWK    	Pound Sterling / Kwacha                           	FOREX     
GBPMXN    	Pound Sterling / Mexican Peso                     	FOREX     
GBPMYR    	Pound Sterling / Malaysian Ringgit                	FOREX     
GBPNGN    	Pound Sterling / Naira                            	FOREX     
GBPNIO    	Pound Sterling / Cordoba Oro                      	FOREX     
GBPNOK    	Pound Sterling / Norwegian Krone                  	FOREX     
GBPNZD    	Pound Sterling / New Zealand Dollar               	FOREX     
GBPOMR    	Pound Sterling / Rial Omani                       	FOREX     
GBPPEN    	Pound Sterling / Nuevo Sol                        	FOREX     
GBPPGK    	Pound Sterling / Papua New Guinea Kina            	FOREX     
GBPPHP    	Pound Sterling / Philippine Peso                  	FOREX     
GBPPKR    	Pound Sterling / Pakistan Rupee                   	FOREX     
GBPPLN    	Pound Sterling / Polish Zloty                     	FOREX     
GBPQAR    	Pound Sterling / Qatari Rial                      	FOREX     
GBPRON    	Pound Sterling / Romanian Leu                     	FOREX     
GBPRSD    	Pound Sterling / Serbian Dinar                    	FOREX     
GBPRUB    	Pound Sterling / Russian Ruble                    	FOREX     
GBPSAR    	Pound Sterling / Saudi Riyal                      	FOREX     
GBPSCR    	Pound Sterling / Seychelles Rupee                 	FOREX     
GBPSEK    	Pound Sterling / Swedish Krona                    	FOREX     
GBPSGD    	Pound Sterling / Singapore Dollar                 	FOREX     
GBPSZL    	Pound Sterling / Lilangeni                        	FOREX     
GBPTHB    	Pound Sterling / Thai Baht                        	FOREX     
GBPTND    	Pound Sterling / Tunisian Dinar                   	FOREX     
GBPTRY    	Pound Sterling / Turkish Lira                     	FOREX     
GBPTTD    	Pound Sterling / Trinidad and Tobago Dollar       	FOREX     
GBPTWD    	Pound Sterling / New Taiwan Dollar                	FOREX     
GBPTZS    	Pound Sterling / Tanzanian Shilling               	FOREX     
GBPUAH    	Pound Sterling / Hryvnia                          	FOREX     
GBPUGX    	Pound Sterling / Uganda Shilling                  	FOREX     
GBPUSD    	Pound Sterling / US Dollar                        	FOREX     
GBPVND    	Pound Sterling / Dong                             	FOREX     
GBPXAF    	Pound Sterling / CFA Franc BEAC                   	FOREX     
GBPXCD    	Pound Sterling / East Caribbean Dollar            	FOREX     
GBPXPF    	Pound Sterling / CFP Franc                        	FOREX     
GBPZAR    	Pound Sterling / South African Rand               	FOREX     
GHSEUR    	Cedi / Euro Dollar                                	FOREX     
GHSUSD    	Cedi / US Dollar                                  	FOREX     
GTQGBP    	Guatemalan Quetzal / Pound Sterling               	FOREX     
HKDARS    	Hong Kong Dollar / Argentine Peso                 	FOREX     
HKDAUD    	Hong Kong Dollar / Australian Dollar              	FOREX     
HKDBRL    	Hong Kong Dollar / Brazilian Real                 	FOREX     
HKDCAD    	Hong Kong Dollar / Canadian Dollar                	FOREX     
HKDCHF    	Hong Kong Dollar / Swiss Franc                    	FOREX     
HKDCNY    	Hong Kong Dollar / Yuan Renminbi                  	FOREX     
HKDDKK    	Hong Kong Dollar / Danish Krone                   	FOREX     
HKDEUR    	Hong Kong Dollar / Euro Dollar                    	FOREX     
HKDGBP    	Hong Kong Dollar / Pound Sterling                 	FOREX     
HKDIDR    	Hong Kong Dollar / Indian Rupiah                  	FOREX     
HKDINR    	Hong Kong Dollar / Indian Rupee                   	FOREX     
HKDJPY    	Hong Kong Dollar / Japanese Yen                   	FOREX     
HKDKRW    	Hong Kong Dollar / Korean Won                     	FOREX     
HKDMXN    	Hong Kong Dollar / Mexican Peso                   	FOREX     
HKDMYR    	Hong Kong Dollar / Malaysian Ringgit              	FOREX     
HKDNZD    	Hong Kong Dollar / New Zealand Dollar             	FOREX     
HKDPKR    	Hong Kong Dollar / Pakistan Rupee                 	FOREX     
HKDPLN    	Hong Kong Dollar / Polish Zloty                   	FOREX     
HKDSEK    	Hong Kong Dollar / Swedish Krona                  	FOREX     
HKDSGD    	Hong Kong Dollar / Singapore Dollar               	FOREX     
HKDTHB    	Hong Kong Dollar / Thai Baht                      	FOREX     
HKDTWD    	Hong Kong Dollar / New Taiwan Dollar              	FOREX     
HKDUSD    	Hong Kong Dollar / US Dollar                      	FOREX     
HKDZAR    	Hong Kong Dollar / South African Rand             	FOREX     
HNLGBP    	Honduran Lempira / Pound Sterling                 	FOREX     
HRKEUR    	Croatian kuna / Euro Dollar                       	FOREX     
HRKPLN    	Croatian kuna / Polish Zloty                      	FOREX     
HRKUSD    	Croatian kuna / US Dollar                         	FOREX     
HTGGBP    	Gourde / Pound Sterling                           	FOREX     
HUFARS    	Hungarian Forint / Argentine Peso                 	FOREX     
HUFCHF    	Hungarian Forint / Swiss Franc                    	FOREX     
HUFDKK    	Hungarian Forint / Danish Krone                   	FOREX     
HUFEUR    	Hungarian Forint / Euro Dollar                    	FOREX     
HUFPLN    	Hungarian Forint / Polish Zloty                   	FOREX     
HUFUSD    	Hungarian Forint / US Dollar                      	FOREX     
IDRAUD    	Indonesia Rupiah / Australian Dollar              	FOREX     
IDRCAD    	Indonesia Rupiah / Canadian Dollar                	FOREX     
IDRCHF    	Indonesia Rupiah / Swiss Franc                    	FOREX     
IDRCNY    	Indonesia Rupiah / Yuan Renminbi                  	FOREX     
IDREUR    	Indonesia Rupiah / Euro Dollar                    	FOREX     
IDRGBP    	Indonesia Rupiah / Pound Sterling                 	FOREX     
IDRHKD    	Indonesia Rupiah / Hong Kong Dollar               	FOREX     
IDRINR    	Indonesia Rupiah / Indian Rupee                   	FOREX     
IDRJPY    	Indonesia Rupiah / Japanese Yen                   	FOREX     
IDRKRW    	Indonesia Rupiah / Korean Won                     	FOREX     
IDRMYR    	Indonesia Rupiah / Malaysian Ringgit              	FOREX     
IDRNZD    	Indonesia Rupiah / New Zealand Dollar             	FOREX     
IDRSGD    	Indonesia Rupiah / Singapore Dollar               	FOREX     
IDRTHB    	Indonesia Rupiah / Thai Baht                      	FOREX     
IDRTWD    	Indonesia Rupiah / New Taiwan Dollar              	FOREX     
IDRUSD    	Indonesia Rupiah / US Dollar                      	FOREX     
IDRZAR    	Indonesia Rupiah / South African Rand             	FOREX     
ILSAUD    	New Israeli Sheqel / Australian Dollar            	FOREX     
ILSCAD    	New Israeli Sheqel / Canadian Dollar              	FOREX     
ILSCHF    	New Israeli Sheqel / Swiss Franc                  	FOREX     
ILSJOD    	New Israeli Sheqel / Jordanian Dinar              	FOREX     
ILSJPY    	New Israeli Sheqel / Japanese Yen                 	FOREX     
ILSPLN    	New Israeli Sheqel / Polish Zloty                 	FOREX     
ILSSEK    	New Israeli Sheqel / Swedish Krona                	FOREX     
ILSUSD    	New Israeli Sheqel / US Dollar                    	FOREX     
INRAUD    	Indian Rupee / Australian Dollar                  	FOREX     
INRCAD    	Indian Rupee / Canadian Dollar                    	FOREX     
INRCHF    	Indian Rupee / Swiss Franc                        	FOREX     
INRCNY    	Indian Rupee / Yuan Renminbi                      	FOREX     
INREUR    	Indian Rupee / Euro Dollar                        	FOREX     
INRGBP    	Indian Rupee / Pound Sterling                     	FOREX     
INRHKD    	Indian Rupee / Hong Kong Dollar                   	FOREX     
INRJPY    	Indian Rupee / Japanese Yen                       	FOREX     
INRKRW    	Indian Rupee / Korean Won                         	FOREX     
INRMYR    	Indian Rupee / Malaysian Ringgit                  	FOREX     
INRNZD    	Indian Rupee / New Zealand Dollar                 	FOREX     
INRPKR    	Indian Rupee / Pakistan Rupee                     	FOREX     
INRSEK    	Indian Rupee / Swedish Krona                      	FOREX     
INRTHB    	Indian Rupee / Thai Baht                          	FOREX     
INRTWD    	Indian Rupee / New Taiwan Dollar                  	FOREX     
INRUSD    	Indian Rupee / US Dollar                          	FOREX     
INRZAR    	Indian Rupee / South African Rand                 	FOREX     
IQDGBP    	Iraqi Dinar / Pound Sterling                      	FOREX     
ISKCHF    	Iceland Krona / Swiss Franc                       	FOREX     
ISKDKK    	Iceland Krona / Danish Krone                      	FOREX     
ISKGBP    	Iceland Krona / Pound Sterling                    	FOREX     
ISKNOK    	Iceland Krona / Norwegian Krone                   	FOREX     
ISKSEK    	Iceland Krona / Swedish Krona                     	FOREX     
JMDGBP    	Jamaican Dollar / Pound Sterling                  	FOREX     
JODAED    	Jordanian Dinar / UAE Dirham                      	FOREX     
JODILS    	Jordanian Dinar / New Israeli Sheqel              	FOREX     
JODUSD    	Jordanian Dinar / US Dollar                       	FOREX     
JPYAED    	Japanese Yen / UAE Dirham                         	FOREX     
JPYARS    	Japanese Yen / Argentine Peso                     	FOREX     
JPYAUD    	Japanese Yen / Australian Dollar                  	FOREX     
JPYBRL    	Japanese Yen / Brazilian Real                     	FOREX     
JPYCAD    	Japanese Yen / Canadian Dollar                    	FOREX     
JPYCHF    	Japanese Yen / Swiss Franc                        	FOREX     
JPYCLP    	Japanese Yen / Chilean Peso                       	FOREX     
JPYCNY    	Japanese Yen / Yuan Renminbi                      	FOREX     
JPYCZK    	Japanese Yen / Czech Koruna                       	FOREX     
JPYDKK    	Japanese Yen / Danish Krone                       	FOREX     
JPYEUR    	Japanese Yen / Euro Dollar                        	FOREX     
JPYGBP    	Japanese Yen / Pound Sterling                     	FOREX     
JPYHKD    	Japanese Yen / Hong Kong Dollar                   	FOREX     
JPYIDR    	Japanese Yen / Indian Rupiah                      	FOREX     
JPYILS    	Japanese Yen / New Israeli Sheqel                 	FOREX     
JPYINR    	Japanese Yen / Indian Rupee                       	FOREX     
JPYISK    	Japanese Yen / Iceland Krona                      	FOREX     
JPYKRW    	Japanese Yen / Korean Won                         	FOREX     
JPYMXN    	Japanese Yen / Mexican Peso                       	FOREX     
JPYMYR    	Japanese Yen / Malaysian Ringgit                  	FOREX     
JPYNOK    	Japanese Yen / Norwegian Krone                    	FOREX     
JPYNZD    	Japanese Yen / New Zealand Dollar                 	FOREX     
JPYPKR    	Japanese Yen / Pakistan Rupee                     	FOREX     
JPYPLN    	Japanese Yen / Polish Zloty                       	FOREX     
JPYRUB    	Japanese Yen / Russian Ruble                      	FOREX     
JPYSEK    	Japanese Yen / Swedish Krona                      	FOREX     
JPYTHB    	Japanese Yen / Thai Baht                          	FOREX     
JPYTWD    	Japanese Yen / New Taiwan Dollar                  	FOREX     
JPYUSD    	Japanese Yen / US Dollar                          	FOREX     
JPYZAR    	Japanese Yen / South African Rand                 	FOREX     
KESEUR    	Kenyan Shilling / Euro Dollar                     	FOREX     
KESUSD    	Kenyan Shilling / US Dollar                       	FOREX     
KESZAR    	Kenyan Shilling / South African Rand              	FOREX     
KMFUSD    	Comoro Franc / US Dollar                          	FOREX     
KRWAUD    	Korean Won / Australian Dollar                    	FOREX     
KRWBRL    	Korean Won / Brazilian Real                       	FOREX     
KRWCAD    	Korean Won / Canadian Dollar                      	FOREX     
KRWCHF    	Korean Won / Swiss Franc                          	FOREX     
KRWCNY    	Korean Won / Yuan Renminbi                        	FOREX     
KRWEUR    	Korean Won / Euro Dollar                          	FOREX     
KRWGBP    	Korean Won / Pound Sterling                       	FOREX     
KRWHKD    	Korean Won / Hong Kong Dollar                     	FOREX     
KRWIDR    	Korean Won / Indian Rupiah                        	FOREX     
KRWINR    	Korean Won / Indian Rupee                         	FOREX     
KRWJPY    	Korean Won / Japanese Yen                         	FOREX     
KRWMYR    	Korean Won / Malaysian Ringgit                    	FOREX     
KRWNZD    	Korean Won / New Zealand Dollar                   	FOREX     
KRWRUB    	Korean Won / Russian Ruble                        	FOREX     
KRWSEK    	Korean Won / Swedish Krona                        	FOREX     
KRWSGD    	Korean Won / Singapore Dollar                     	FOREX     
KRWTHB    	Korean Won / Thai Baht                            	FOREX     
KRWTWD    	Korean Won / New Taiwan Dollar                    	FOREX     
KRWUSD    	Korean Won / US Dollar                            	FOREX     
KRWZAR    	Korean Won / South African Rand                   	FOREX     
KWDAED    	Kuwaiti Dinar / UAE Dirham                        	FOREX     
KWDGBP    	Kuwaiti Dinar / Pound Sterling                    	FOREX     
KWDPKR    	Kuwaiti Dinar / Pakistan Rupee                    	FOREX     
KWDUSD    	Kuwaiti Dinar / US Dollar                         	FOREX     
KZTGBP    	Tenge / Pound Sterling                            	FOREX     
LBPUSD    	Lebanese Pound / US Dollar                        	FOREX     
LKRUSD    	Sri Lanka Rupee / US Dollar                       	FOREX     
LRDUSD    	Liberian Dollar / US Dollar                       	FOREX     
LTLPLN    	Lithuanian Litas / Polish Zloty                   	FOREX     
MADGBP    	Moroccan Dirham / Pound Sterling                  	FOREX     
MADUSD    	Moroccan Dirham / US Dollar                       	FOREX     
MDLEUR    	Moldovan Leu / Euro Dollar                        	FOREX     
MDLUSD    	Moldovan Leu / US Dollar                          	FOREX     
MKDUSD    	Denar / US Dollar                                 	FOREX     
MUREUR    	Mauritius Rupee / Euro Dollar                     	FOREX     
MURGBP    	Mauritius Rupee / Pound Sterling                  	FOREX     
MURUSD    	Mauritius Rupee / US Dollar                       	FOREX     
MURZAR    	Mauritius Rupee / South African Rand              	FOREX     
MVRUSD    	Rufiyaa / US Dollar                               	FOREX     
MWKGBP    	Kwacha / Pound Sterling                           	FOREX     
MXNARS    	Mexican Peso / Argentine Peso                     	FOREX     
MXNAUD    	Mexican Peso / Australian Dollar                  	FOREX     
MXNBRL    	Mexican Peso / Brazilian Real                     	FOREX     
MXNCAD    	Mexican Peso / Canadian Dollar                    	FOREX     
MXNCHF    	Mexican Peso / Swiss Franc                        	FOREX     
MXNCZK    	Mexican Peso / Czech Koruna                       	FOREX     
MXNDKK    	Mexican Peso / Danish Krone                       	FOREX     
MXNEUR    	Mexican Peso / Euro Dollar                        	FOREX     
MXNGBP    	Mexican Peso / Pound Sterling                     	FOREX     
MXNHKD    	Mexican Peso / Hong Kong Dollar                   	FOREX     
MXNJPY    	Mexican Peso / Japanese Yen                       	FOREX     
MXNSGD    	Mexican Peso / Singapore Dollar                   	FOREX     
MXNUSD    	Mexican Peso / US Dollar                          	FOREX     
MXNZAR    	Mexican Peso / South African Rand                 	FOREX     
MYRAUD    	Malaysian Ringgit / Australian Dollar             	FOREX     
MYRCAD    	Malaysian Ringgit / Canadian Dollar               	FOREX     
MYRCHF    	Malaysian Ringgit / Swiss Franc                   	FOREX     
MYRCNH    	Malaysian Ringgit / Renminbi (Offshore)           	FOREX     
MYRCNY    	Malaysian Ringgit / Yuan Renminbi                 	FOREX     
MYRDKK    	Malaysian Ringgit / Danish Krone                  	FOREX     
MYREUR    	Malaysian Ringgit / Euro Dollar                   	FOREX     
MYRGBP    	Malaysian Ringgit / Pound Sterling                	FOREX     
MYRHKD    	Malaysian Ringgit / Hong Kong Dollar              	FOREX     
MYRIDR    	Malaysian Ringgit / Indian Rupiah                 	FOREX     
MYRINR    	Malaysian Ringgit / Indian Rupee                  	FOREX     
MYRJPY    	Malaysian Ringgit / Japanese Yen                  	FOREX     
MYRKRW    	Malaysian Ringgit / Korean Won                    	FOREX     
MYRNZD    	Malaysian Ringgit / New Zealand Dollar            	FOREX     
MYRPKR    	Malaysian Ringgit / Pakistan Rupee                	FOREX     
MYRSGD    	Malaysian Ringgit / Singapore Dollar              	FOREX     
MYRTHB    	Malaysian Ringgit / Thai Baht                     	FOREX     
MYRTWD    	Malaysian Ringgit / New Taiwan Dollar             	FOREX     
MYRUSD    	Malaysian Ringgit / US Dollar                     	FOREX     
MYRZAR    	Malaysian Ringgit / South African Rand            	FOREX     
NGNGBP    	Naira / Pound Sterling                            	FOREX     
NGNJPY    	Naira / Japanese Yen                              	FOREX     
NIOGBP    	Cordoba Oro / Pound Sterling                      	FOREX     
NOKCAD    	Norwegian Krone / Canadian Dollar                 	FOREX     
NOKCHF    	Norwegian Krone / Swiss Franc                     	FOREX     
NOKCNH    	Norwegian Krone / Renminbi (Offshore)             	FOREX     
NOKDKK    	Norwegian Krone / Danish Krone                    	FOREX     
NOKEUR    	Norwegian Krone / Euro Dollar                     	FOREX     
NOKGBP    	Norwegian Krone / Pound Sterling                  	FOREX     
NOKINR    	Norwegian Krone / Indian Rupee                    	FOREX     
NOKISK    	Norwegian Krone / Iceland Krona                   	FOREX     
NOKJPY    	Norwegian Krone / Japanese Yen                    	FOREX     
NOKPLN    	Norwegian Krone / Polish Zloty                    	FOREX     
NOKSEK    	Norwegian Krone / Swedish Krona                   	FOREX     
NOKUSD    	Norwegian Krone / US Dollar                       	FOREX     
NOKZAR    	Norwegian Krone / South African Rand              	FOREX     
NZDAED    	New Zealand Dollar / UAE Dirham                   	FOREX     
NZDAUD    	New Zealand Dollar / Australian Dollar            	FOREX     
NZDCAD    	New Zealand Dollar / Canadian Dollar              	FOREX     
NZDCHF    	New Zealand Dollar / Swiss Franc                  	FOREX     
NZDCNH    	New Zealand Dollar / Renminbi (Offshore)          	FOREX     
NZDCNY    	New Zealand Dollar / Yuan Renminbi                	FOREX     
NZDCZK    	New Zealand Dollar / Czech Koruna                 	FOREX     
NZDDKK    	New Zealand Dollar / Danish Krone                 	FOREX     
NZDEUR    	New Zealand Dollar / Euro Dollar                  	FOREX     
NZDGBP    	New Zealand Dollar / Pound Sterling               	FOREX     
NZDHKD    	New Zealand Dollar / Hong Kong Dollar             	FOREX     
NZDHUF    	New Zealand Dollar / Hungarian Forint             	FOREX     
NZDIDR    	New Zealand Dollar / Indian Rupiah                	FOREX     
NZDINR    	New Zealand Dollar / Indian Rupee                 	FOREX     
NZDJPY    	New Zealand Dollar / Japanese Yen                 	FOREX     
NZDKRW    	New Zealand Dollar / Korean Won                   	FOREX     
NZDMXN    	New Zealand Dollar / Mexican Peso                 	FOREX     
NZDMYR    	New Zealand Dollar / Malaysian Ringgit            	FOREX     
NZDNOK    	New Zealand Dollar / Norwegian Krone              	FOREX     
NZDPHP    	New Zealand Dollar / Philippine Peso              	FOREX     
NZDPKR    	New Zealand Dollar / Pakistan Rupee               	FOREX     
NZDPLN    	New Zealand Dollar / Polish Zloty                 	FOREX     
NZDSEK    	New Zealand Dollar / Swedish Krona                	FOREX     
NZDSGD    	New Zealand Dollar / Singapore Dollar             	FOREX     
NZDTHB    	New Zealand Dollar / Thai Baht                    	FOREX     
NZDTRY    	New Zealand Dollar / Turkish Lira                 	FOREX     
NZDTWD    	New Zealand Dollar / New Taiwan Dollar            	FOREX     
NZDUSD    	New Zealand Dollar / US Dollar                    	FOREX     
NZDZAR    	New Zealand Dollar / South African Rand           	FOREX     
OMRAED    	Rial Omani / UAE Dirham                           	FOREX     
OMRGBP    	Rial Omani / Pound Sterling                       	FOREX     
OMRPKR    	Rial Omani / Pakistan Rupee                       	FOREX     
OMRUSD    	Rial Omani / US Dollar                            	FOREX     
OMRZAR    	Rial Omani / South African Rand                   	FOREX     
PENGBP    	Nuevo Sol / Pound Sterling                        	FOREX     
PGKGBP    	Papua New Guinea Kina / Pound Sterling            	FOREX     
PHPAUD    	Philippine Peso / Australian Dollar               	FOREX     
PHPDKK    	Philippine Peso / Danish Krone                    	FOREX     
PHPGBP    	Philippine Peso / Pound Sterling                  	FOREX     
PHPJPY    	Philippine Peso / Japanese Yen                    	FOREX     
PHPNZD    	Philippine Peso / New Zealand Dollar              	FOREX     
PHPUSD    	Philippine Peso / US Dollar                       	FOREX     
PKRGBP    	Pakistan Rupee / Pound Sterling                   	FOREX     
PKRJPY    	Pakistan Rupee / Japanese Yen                     	FOREX     
PKRZAR    	Pakistan Rupee / South African Rand               	FOREX     
PLNCHF    	Polish Zloty / Swiss Franc                        	FOREX     
PLNCOP    	Polish Zloty / Colombian Peso                     	FOREX     
PLNCZK    	Polish Zloty / Czech Koruna                       	FOREX     
PLNDKK    	Polish Zloty / Danish Krone                       	FOREX     
PLNEUR    	Polish Zloty / Euro Dollar                        	FOREX     
PLNGBP    	Polish Zloty / Pound Sterling                     	FOREX     
PLNHUF    	Polish Zloty / Hungarian Forint                   	FOREX     
PLNILS    	Polish Zloty / New Israeli Sheqel                 	FOREX     
PLNJPY    	Polish Zloty / Japanese Yen                       	FOREX     
PLNNOK    	Polish Zloty / Norwegian Krone                    	FOREX     
PLNRUB    	Polish Zloty / Russian Ruble                      	FOREX     
PLNSEK    	Polish Zloty / Swedish Krona                      	FOREX     
PLNUSD    	Polish Zloty / US Dollar                          	FOREX     
QARAED    	Qatari Rial / UAE Dirham                          	FOREX     
QARGBP    	Qatari Rial / Pound Sterling                      	FOREX     
QARPKR    	Qatari Rial / Pakistan Rupee                      	FOREX     
QARUSD    	Qatari Rial / US Dollar                           	FOREX     
QARZAR    	Qatari Rial / South African Rand                  	FOREX     
RONCHF    	Romanian Leu / Swiss Franc                        	FOREX     
RONGBP    	Romanian Leu / Pound Sterling                     	FOREX     
RONPLN    	Romanian Leu / Polish Zloty                       	FOREX     
RONUSD    	Romanian Leu / US Dollar                          	FOREX     
RSDUSD    	Serbian Dinar / US Dollar                         	FOREX     
RUBCHF    	Russian Ruble / Swiss Franc                       	FOREX     
RUBGBP    	Russian Ruble / Pound Sterling                    	FOREX     
RUBJPY    	Russian Ruble / Japanese Yen                      	FOREX     
RUBKRW    	Russian Ruble / Korean Won                        	FOREX     
RUBPLN    	Russian Ruble / Polish Zloty                      	FOREX     
RUBUSD    	Russian Ruble / US Dollar                         	FOREX     
SAREUR    	Saudi Riyal / Euro Dollar                         	FOREX     
SARPKR    	Saudi Riyal / Pakistan Rupee                      	FOREX     
SARUSD    	Saudi Riyal / US Dollar                           	FOREX     
SCRGBP    	Seychelles Rupee / Pound Sterling                 	FOREX     
SCRUSD    	Seychelles Rupee / US Dollar                      	FOREX     
SEKAUD    	Swedish Krona / Australian Dollar                 	FOREX     
SEKCAD    	Swedish Krona / Canadian Dollar                   	FOREX     
SEKCHF    	Swedish Krona / Swiss Franc                       	FOREX     
SEKCNH    	Swedish Krona / Renminbi (Offshore)               	FOREX     
SEKCZK    	Swedish Krona / Czech Koruna                      	FOREX     
SEKDKK    	Swedish Krona / Danish Krone                      	FOREX     
SEKEUR    	Swedish Krona / Euro Dollar                       	FOREX     
SEKGBP    	Swedish Krona / Pound Sterling                    	FOREX     
SEKILS    	Swedish Krona / New Israeli Sheqel                	FOREX     
SEKINR    	Swedish Krona / Indian Rupee                      	FOREX     
SEKISK    	Swedish Krona / Iceland Krona                     	FOREX     
SEKJPY    	Swedish Krona / Japanese Yen                      	FOREX     
SEKNOK    	Swedish Krona / Norwegian Krone                   	FOREX     
SEKPLN    	Swedish Krona / Polish Zloty                      	FOREX     
SEKUSD    	Swedish Krona / US Dollar                         	FOREX     
SEKZAR    	Swedish Krona / South African Rand                	FOREX     
SGDAED    	Singapore Dollar / UAE Dirham                     	FOREX     
SGDARS    	Singapore Dollar / Argentine Peso                 	FOREX     
SGDAUD    	Singapore Dollar / Australian Dollar              	FOREX     
SGDBRL    	Singapore Dollar / Brazilian Real                 	FOREX     
SGDCAD    	Singapore Dollar / Canadian Dollar                	FOREX     
SGDCHF    	Singapore Dollar / Swiss Franc                    	FOREX     
SGDCNH    	Singapore Dollar / Renminbi (Offshore)            	FOREX     
SGDCNY    	Singapore Dollar / Yuan Renminbi                  	FOREX     
SGDDKK    	Singapore Dollar / Danish Krone                   	FOREX     
SGDEUR    	Singapore Dollar / Euro Dollar                    	FOREX     
SGDGBP    	Singapore Dollar / Pound Sterling                 	FOREX     
SGDHKD    	Singapore Dollar / Hong Kong Dollar               	FOREX     
SGDIDR    	Singapore Dollar / Indian Rupiah                  	FOREX     
SGDINR    	Singapore Dollar / Indian Rupee                   	FOREX     
SGDJPY    	Singapore Dollar / Japanese Yen                   	FOREX     
SGDKRW    	Singapore Dollar / Korean Won                     	FOREX     
SGDMXN    	Singapore Dollar / Mexican Peso                   	FOREX     
SGDMYR    	Singapore Dollar / Malaysian Ringgit              	FOREX     
SGDNZD    	Singapore Dollar / New Zealand Dollar             	FOREX     
SGDPKR    	Singapore Dollar / Pakistan Rupee                 	FOREX     
SGDPLN    	Singapore Dollar / Polish Zloty                   	FOREX     
SGDSEK    	Singapore Dollar / Swedish Krona                  	FOREX     
SGDTHB    	Singapore Dollar / Thai Baht                      	FOREX     
SGDTWD    	Singapore Dollar / New Taiwan Dollar              	FOREX     
SGDUSD    	Singapore Dollar / US Dollar                      	FOREX     
SGDZAR    	Singapore Dollar / South African Rand             	FOREX     
SHPUSD    	Saint Helena Pound / US Dollar                    	FOREX     
SLLUSD    	Leone / US Dollar                                 	FOREX     
SZLCHF    	Lilangeni / Swiss Franc                           	FOREX     
SZLEUR    	Lilangeni / Euro Dollar                           	FOREX     
SZLGBP    	Lilangeni / Pound Sterling                        	FOREX     
SZLUSD    	Lilangeni / US Dollar                             	FOREX     
THBAUD    	Thai Baht / Australian Dollar                     	FOREX     
THBCAD    	Thai Baht / Canadian Dollar                       	FOREX     
THBCHF    	Thai Baht / Swiss Franc                           	FOREX     
THBCNY    	Thai Baht / Yuan Renminbi                         	FOREX     
THBEUR    	Thai Baht / Euro Dollar                           	FOREX     
THBGBP    	Thai Baht / Pound Sterling                        	FOREX     
THBHKD    	Thai Baht / Hong Kong Dollar                      	FOREX     
THBIDR    	Thai Baht / Indian Rupiah                         	FOREX     
THBINR    	Thai Baht / Indian Rupee                          	FOREX     
THBJPY    	Thai Baht / Japanese Yen                          	FOREX     
THBKRW    	Thai Baht / Korean Won                            	FOREX     
THBMYR    	Thai Baht / Malaysian Ringgit                     	FOREX     
THBNZD    	Thai Baht / New Zealand Dollar                    	FOREX     
THBPKR    	Thai Baht / Pakistan Rupee                        	FOREX     
THBSGD    	Thai Baht / Singapore Dollar                      	FOREX     
THBTWD    	Thai Baht / New Taiwan Dollar                     	FOREX     
THBUSD    	Thai Baht / US Dollar                             	FOREX     
THBZAR    	Thai Baht / South African Rand                    	FOREX     
TNDGBP    	Tunisian Dinar / Pound Sterling                   	FOREX     
TNDUSD    	Tunisian Dinar / US Dollar                        	FOREX     
TRYCHF    	Turkish Lira / Swiss Franc                        	FOREX     
TRYDKK    	Turkish Lira / Danish Krone                       	FOREX     
TRYJPY    	Turkish Lira / Japanese Yen                       	FOREX     
TRYPLN    	Turkish Lira / Polish Zloty                       	FOREX     
TRYUSD    	Turkish Lira / US Dollar                          	FOREX     
TRYZAR    	Turkish Lira / South African Rand                 	FOREX     
TTDGBP    	Trinidad and Tobago Dollar / Pound Sterling       	FOREX     
TWDAUD    	New Taiwan Dollar / Australian Dollar             	FOREX     
TWDCAD    	New Taiwan Dollar / Canadian Dollar               	FOREX     
TWDCHF    	New Taiwan Dollar / Swiss Franc                   	FOREX     
TWDCNY    	New Taiwan Dollar / Yuan Renminbi                 	FOREX     
TWDDKK    	New Taiwan Dollar / Danish Krone                  	FOREX     
TWDGBP    	New Taiwan Dollar / Pound Sterling                	FOREX     
TWDHKD    	New Taiwan Dollar / Hong Kong Dollar              	FOREX     
TWDIDR    	New Taiwan Dollar / Indian Rupiah                 	FOREX     
TWDINR    	New Taiwan Dollar / Indian Rupee                  	FOREX     
TWDJPY    	New Taiwan Dollar / Japanese Yen                  	FOREX     
TWDKRW    	New Taiwan Dollar / Korean Won                    	FOREX     
TWDMYR    	New Taiwan Dollar / Malaysian Ringgit             	FOREX     
TWDNZD    	New Taiwan Dollar / New Zealand Dollar            	FOREX     
TWDPKR    	New Taiwan Dollar / Pakistan Rupee                	FOREX     
TWDSEK    	New Taiwan Dollar / Swedish Krona                 	FOREX     
TWDSGD    	New Taiwan Dollar / Singapore Dollar              	FOREX     
TWDTHB    	New Taiwan Dollar / Thai Baht                     	FOREX     
TWDUSD    	New Taiwan Dollar / US Dollar                     	FOREX     
TWDZAR    	New Taiwan Dollar / South African Rand            	FOREX     
TZSZAR    	Tanzanian Shilling / South African Rand           	FOREX     
UAHDKK    	Hryvnia / Danish Krone                            	FOREX     
UAHEUR    	Hryvnia / Euro Dollar                             	FOREX     
UAHPLN    	Hryvnia / Polish Zloty                            	FOREX     
UAHUSD    	Hryvnia / US Dollar                               	FOREX     
USDAED    	US Dollar / UAE Dirham                            	FOREX     
USDAFN    	US Dollar / Afghani                               	FOREX     
USDALL    	US Dollar / Lek                                   	FOREX     
USDAMD    	US Dollar / Armenian Dram                         	FOREX     
USDARS    	US Dollar / Argentine Peso                        	FOREX     
USDAUD    	US Dollar / Australian Dollar                     	FOREX     
USDAWG    	US Dollar / Aruban Guilder                        	FOREX     
USDBDT    	US Dollar / Taka                                  	FOREX     
USDBGN    	US Dollar / Bulgarian Lev                         	FOREX     
USDBHD    	US Dollar / Bahraini Dinar                        	FOREX     
USDBIF    	US Dollar / Burundi Franc                         	FOREX     
USDBMD    	US Dollar / Bermudian Dollar                      	FOREX     
USDBND    	US Dollar / Brunei Dollar                         	FOREX     
USDBOB    	US Dollar / Boliviano                             	FOREX     
USDBRL    	US Dollar / Brazilian Real                        	FOREX     
USDBWP    	US Dollar / Pula                                  	FOREX     
USDBZD    	US Dollar / Belize Dollar                         	FOREX     
USDCAD    	US Dollar / Canadian Dollar                       	FOREX     
USDCDF    	US Dollar / Franc Congolais                       	FOREX     
USDCHF    	US Dollar / Swiss Franc                           	FOREX     
USDCLP    	US Dollar / Chilean Peso                          	FOREX     
USDCNH    	US Dollar / Renminbi (Offshore)                   	FOREX     
USDCNY    	US Dollar / Yuan Renminbi                         	FOREX     
USDCOP    	US Dollar / Colombian Peso                        	FOREX     
USDCRC    	US Dollar / Costa Rican Colon                     	FOREX     
USDCUP    	US Dollar / Cuban Peso                            	FOREX     
USDCVE    	US Dollar / Cape Verde Escudo                     	FOREX     
USDCZK    	US Dollar / Czech Koruna                          	FOREX     
USDDJF    	US Dollar / Djibouti Franc                        	FOREX     
USDDKK    	US Dollar / Danish Krone                          	FOREX     
USDDOP    	US Dollar / Dominican Peso                        	FOREX     
USDDZD    	US Dollar / Algerian Dinar                        	FOREX     
USDEGP    	US Dollar / Egyptian Pound                        	FOREX     
USDETB    	US Dollar / Ethiopian Birr                        	FOREX     
USDEUR    	US Dollar / Euro Dollar                           	FOREX     
USDFJD    	US Dollar / Fiji Dollar                           	FOREX     
USDGBP    	US Dollar / Pound Sterling                        	FOREX     
USDGEL    	US Dollar / Lari                                  	FOREX     
USDGHS    	US Dollar / Cedi                                  	FOREX     
USDGMD    	US Dollar / Dalasi                                	FOREX     
USDGNF    	US Dollar / Guinea Franc                          	FOREX     
USDGTQ    	US Dollar / Guatemalan Quetzal                    	FOREX     
USDHKD    	US Dollar / Hong Kong Dollar                      	FOREX     
USDHNL    	US Dollar / Honduran Lempira                      	FOREX     
USDHRK    	US Dollar / Croatian kuna                         	FOREX     
USDHTG    	US Dollar / Gourde                                	FOREX     
USDHUF    	US Dollar / Hungarian Forint                      	FOREX     
USDIDR    	US Dollar / Indian Rupiah                         	FOREX     
USDILS    	US Dollar / New Israeli Sheqel                    	FOREX     
USDINR    	US Dollar / Indian Rupee                          	FOREX     
USDIQD    	US Dollar / Iraqi Dinar                           	FOREX     
USDISK    	US Dollar / Iceland Krona                         	FOREX     
USDJOD    	US Dollar / Jordanian Dinar                       	FOREX     
USDJPY    	US Dollar / Japanese Yen                          	FOREX     
USDKES    	US Dollar / Kenyan Shilling                       	FOREX     
USDKHR    	US Dollar / Riel                                  	FOREX     
USDKMF    	US Dollar / Comoro Franc                          	FOREX     
USDKRW    	US Dollar / Korean Won                            	FOREX     
USDKWD    	US Dollar / Kuwaiti Dinar                         	FOREX     
USDKZT    	US Dollar / Tenge                                 	FOREX     
USDLAK    	US Dollar / Kip                                   	FOREX     
USDLBP    	US Dollar / Lebanese Pound                        	FOREX     
USDLKR    	US Dollar / Sri Lanka Rupee                       	FOREX     
USDLRD    	US Dollar / Liberian Dollar                       	FOREX     
USDLSL    	US Dollar / Loti                                  	FOREX     
USDLYD    	US Dollar / Lybian Dinar                          	FOREX     
USDMAD    	US Dollar / Moroccan Dirham                       	FOREX     
USDMDL    	US Dollar / Moldovan Leu                          	FOREX     
USDMKD    	US Dollar / Denar                                 	FOREX     
USDMMK    	US Dollar / Kyat                                  	FOREX     
USDMOP    	US Dollar / Pataca                                	FOREX     
USDMRO    	US Dollar / Ouguiya                               	FOREX     
USDMUR    	US Dollar / Mauritius Rupee                       	FOREX     
USDMVR    	US Dollar / Rufiyaa                               	FOREX     
USDMWK    	US Dollar / Kwacha                                	FOREX     
USDMXN    	US Dollar / Mexican Peso                          	FOREX     
USDMYR    	US Dollar / Malaysian Ringgit                     	FOREX     
USDNAD    	US Dollar / Namibia Dollar                        	FOREX     
USDNGN    	US Dollar / Naira                                 	FOREX     
USDNIO    	US Dollar / Cordoba Oro                           	FOREX     
USDNOK    	US Dollar / Norwegian Krone                       	FOREX     
USDNPR    	US Dollar / Nepalese Rupee                        	FOREX     
USDNZD    	US Dollar / New Zealand Dollar                    	FOREX     
USDOMR    	US Dollar / Rial Omani                            	FOREX     
USDPAB    	US Dollar / Balboa                                	FOREX     
USDPEN    	US Dollar / Nuevo Sol                             	FOREX     
USDPGK    	US Dollar / Papua New Guinea Kina                 	FOREX     
USDPHP    	US Dollar / Philippine Peso                       	FOREX     
USDPKR    	US Dollar / Pakistan Rupee                        	FOREX     
USDPLN    	US Dollar / Polish Zloty                          	FOREX     
USDPYG    	US Dollar / Guarani                               	FOREX     
USDQAR    	US Dollar / Qatari Rial                           	FOREX     
USDRON    	US Dollar / Romanian Leu                          	FOREX     
USDRSD    	US Dollar / Serbian Dinar                         	FOREX     
USDRUB    	US Dollar / Russian Ruble                         	FOREX     
USDRWF    	US Dollar / Rwanda Franc                          	FOREX     
USDSAR    	US Dollar / Saudi Riyal                           	FOREX     
USDSCR    	US Dollar / Seychelles Rupee                      	FOREX     
USDSDD    	US Dollar / Sudanese Dinar                        	FOREX     
USDSEK    	US Dollar / Swedish Krona                         	FOREX     
USDSGD    	US Dollar / Singapore Dollar                      	FOREX     
USDSLL    	US Dollar / Leone                                 	FOREX     
USDSOS    	US Dollar / Somali Shilling                       	FOREX     
USDSTD    	US Dollar / Dobra                                 	FOREX     
USDSVC    	US Dollar / El Salvador Colon                     	FOREX     
USDSZL    	US Dollar / Lilangeni                             	FOREX     
USDTHB    	US Dollar / Thai Baht                             	FOREX     
USDTND    	US Dollar / Tunisian Dinar                        	FOREX     
USDTRY    	US Dollar / Turkish Lira                          	FOREX     
USDTWD    	US Dollar / New Taiwan Dollar                     	FOREX     
USDTZS    	US Dollar / Tanzanian Shilling                    	FOREX     
USDUAH    	US Dollar / Hryvnia                               	FOREX     
USDUYU    	US Dollar / Peso Uruguayo                         	FOREX     
USDUZS    	US Dollar / Uzbekistan Sum                        	FOREX     
USDVEF    	US Dollar / Venezualan bolivar fuerte             	FOREX     
USDVND    	US Dollar / Dong                                  	FOREX     
USDXAF    	US Dollar / CFA Franc BEAC                        	FOREX     
USDXOF    	US Dollar / CFA Franc BCEAO                       	FOREX     
USDXPF    	US Dollar / CFP Franc                             	FOREX     
USDYER    	US Dollar / Yemeni Rial                           	FOREX     
USDZAR    	US Dollar / South African Rand                    	FOREX     
UYUEUR    	Peso Uruguayo / Euro Dollar                       	FOREX     
UYUUSD    	Peso Uruguayo / US Dollar                         	FOREX     
UZSCHF    	Uzbekistan Sum / Swiss Franc                      	FOREX     
VEFEUR    	Venezualan bolivar fuerte / Euro Dollar           	FOREX     
VEFUSD    	Venezualan bolivar fuerte / US Dollar             	FOREX     
VNDJPY    	Dong / Japanese Yen                               	FOREX     
VNDXAF    	Dong / CFA Franc BEAC                             	FOREX     
XAGARS    	Silver / Argentine Peso                           	FOREX     
XAGAUD    	Silver / Australian Dollar                        	FOREX     
XAGBRL    	Silver / Brazilian Real                           	FOREX     
XAGCAD    	Silver / Canadian Dollar                          	FOREX     
XAGCHF    	Silver / Swiss Franc                              	FOREX     
XAGCNY    	Silver / Yuan Renminbi                            	FOREX     
XAGEUR    	Silver / Euro Dollar                              	FOREX     
XAGGBP    	Silver / Pound Sterling                           	FOREX     
XAGHKD    	Silver / Hong Kong Dollar                         	FOREX     
XAGIDR    	Silver / Indonesian Rupiah                        	FOREX     
XAGINR    	Silver / Indian Rupee                             	FOREX     
XAGJPY    	Silver / Japanese Yen                             	FOREX     
XAGKRW    	Silver / Korean Won                               	FOREX     
XAGMXN    	Silver / Mexican Peso                             	FOREX     
XAGRUB    	Silver / Russian Ruble                            	FOREX     
XAGSAR    	Silver / Saudi Riyal                              	FOREX     
XAGTRY    	Silver / Turkish Lira                             	FOREX     
XAGUSD    	Silver / US Dollar                                	FOREX     
XAGZAR    	Silver / South African Rand                       	FOREX     
XAUARS    	Gold / Argentine Peso                             	FOREX     
XAUAUD    	Gold / Australian Dollar                          	FOREX     
XAUBRL    	Gold / Brazilian Real                             	FOREX     
XAUCAD    	Gold / Canadian Dollar                            	FOREX     
XAUCHF    	Gold / Swiss Franc                                	FOREX     
XAUCNY    	Gold / Yuan Renminbi                              	FOREX     
XAUEUR    	Gold / Euro Dollar                                	FOREX     
XAUGBP    	Gold / Pound Sterling                             	FOREX     
XAUHKD    	Gold / Hong Kong Dollar                           	FOREX     
XAUIDR    	Gold / Indonesian Rupiah                          	FOREX     
XAUINR    	Gold / Indian Rupee                               	FOREX     
XAUJPY    	Gold / Japanese Yen                               	FOREX     
XAUKRW    	Gold / Korean Won                                 	FOREX     
XAUMXN    	Gold / Mexican Peso                               	FOREX     
XAUPLN    	Gold / Polish Zloty                               	FOREX     
XAURUB    	Gold / Russian Ruble                              	FOREX     
XAUSAR    	Gold / Saudi Riyal                                	FOREX     
XAUTHB    	Gold / Thai Baht                                  	FOREX     
XAUTRY    	Gold / Turkish Lira                               	FOREX     
XAUUSD    	Gold / US Dollar                                  	FOREX     
XAUZAR    	Gold / South African Rand                         	FOREX     
XCDGBP    	East Caribbean Dollar / Pound Sterling            	FOREX     
XPDEUR    	Palladium / Euro Dollar                           	FOREX     
XPDGBP    	Palladium / Pound Sterling                        	FOREX     
XPDUSD    	Palladium / US Dollar                             	FOREX     
XPFGBP    	CFP Franc / Pound Sterling                        	FOREX     
XPTEUR    	Platinum / Euro Dollar                            	FOREX     
XPTGBP    	Platinum / Pound Sterling                         	FOREX     
XPTUSD    	Platinum / US Dollar                              	FOREX     
YERUSD    	Yemeni Rial / US Dollar                           	FOREX     
ZARAED    	South African Rand / UAE Dirham                   	FOREX     
ZARARS    	South African Rand / Argentine Peso               	FOREX     
ZARAUD    	South African Rand / Australian Dollar            	FOREX     
ZARBRL    	South African Rand / Brazilian Real               	FOREX     
ZARBWP    	South African Rand / Pula                         	FOREX     
ZARCAD    	South African Rand / Canadian Dollar              	FOREX     
ZARCHF    	South African Rand / Swiss Franc                  	FOREX     
ZARCNY    	South African Rand / Yuan Renminbi                	FOREX     
ZARCYP    	South African Rand / Cyprus Pound                 	FOREX     
ZARDKK    	South African Rand / Danish Krone                 	FOREX     
ZAREUR    	South African Rand / Euro Dollar                  	FOREX     
ZARGBP    	South African Rand / Pound Sterling               	FOREX     
ZARHKD    	South African Rand / Hong Kong Dollar             	FOREX     
ZARIDR    	South African Rand / Indian Rupiah                	FOREX     
ZARINR    	South African Rand / Indian Rupee                 	FOREX     
ZARJPY    	South African Rand / Japanese Yen                 	FOREX     
ZARKES    	South African Rand / Kenyan Shilling              	FOREX     
ZARKRW    	South African Rand / Korean Won                   	FOREX     
ZARMUR    	South African Rand / Mauritius Rupee              	FOREX     
ZARMXN    	South African Rand / Mexican Peso                 	FOREX     
ZARMYR    	South African Rand / Malaysian Ringgit            	FOREX     
ZARNOK    	South African Rand / Norwegian Krone              	FOREX     
ZARNZD    	South African Rand / New Zealand Dollar           	FOREX     
ZAROMR    	South African Rand / Rial Omani                   	FOREX     
ZARPHP    	South African Rand / Philippine Peso              	FOREX     
ZARPKR    	South African Rand / Pakistan Rupee               	FOREX     
ZARPLN    	South African Rand / Polish Zloty                 	FOREX     
ZARSEK    	South African Rand / Swedish Krona                	FOREX     
ZARSGD    	South African Rand / Singapore Dollar             	FOREX     
ZARTHB    	South African Rand / Thai Baht                    	FOREX     
ZARTRY    	South African Rand / Turkish Lira                 	FOREX     
ZARTWD    	South African Rand / New Taiwan Dollar            	FOREX     
ZARUSD    	South African Rand / US Dollar                    	FOREX     
