ADDA.IDX  	AMEX Advance Decline Difference                   	INDEX     
ADDD.IDX  	OTC Advance Decline Difference                    	INDEX     
ADDE.IDX  	ETFS Advance - Decline                            	INDEX     
ADDN.IDX  	NYSE Advance Decline Difference                   	INDEX     
ADDQ.IDX  	NASD Advance Decline Difference                   	INDEX     
ADDS.IDX  	TSX Advance Decline Difference                    	INDEX     
ADDT.IDX  	Total Advance Decline Difference                  	INDEX     
ADDV.IDX  	Tsxv Advance Decline Difference                   	INDEX     
ADDX.IDX  	CAD Total Advance Decline Difference              	INDEX     
ADR.IDX   	AMEX Internationl Market Index                    	INDEX     
ADRA.IDX  	AMEX Advance Decline Ratio                        	INDEX     
ADRD.IDX  	OTC Advance Decline Ratio                         	INDEX     
ADRE.IDX  	ETFS  Advance Decline Ratio                       	INDEX     
ADRN.IDX  	NYSE Advance Decline Ratio                        	INDEX     
ADRQ.IDX  	NASD Advance Decline Ratio                        	INDEX     
ADRS.IDX  	TSX Advance Decline Ratio                         	INDEX     
ADRT.IDX  	Total Advance Decline Ratio                       	INDEX     
ADRV.IDX  	Tsxv Advance Decline Ratio                        	INDEX     
ADRX.IDX  	CAD Total Advance Decline Ratio                   	INDEX     
ADVA.IDX  	AMEX Advancing Stocks                             	INDEX     
ADVD.IDX  	OTC Advancing Stocks                              	INDEX     
ADVE.IDX  	ETFS  Advancing Stocks                            	INDEX     
ADVN.IDX  	NYSE Advancing Stocks                             	INDEX     
ADVQ.IDX  	NASD Advancing Stocks                             	INDEX     
ADVS.IDX  	TSX Advancing Stocks                              	INDEX     
ADVT.IDX  	Total Advancing Stocks                            	INDEX     
ADVV.IDX  	Tsxv Advancing Stocks                             	INDEX     
ADVX.IDX  	CAD Total Advancing Stocks                        	INDEX     
AEX.IDX   	AEX General - Netherlands                         	INDEX     
AMZ.IDX   	Alerian Mlp Index                                 	INDEX     
ASHD.IDX  	AMEX Declining Stocks                             	INDEX     
ASHF.IDX  	AMEX Advances - Declines                          	INDEX     
ASHR.IDX  	AMEX Advance Decline Ratio                        	INDEX     
ASHU.IDX  	AMEX Advancing Stocks                             	INDEX     
ATX.IDX   	ATX - Austria                                     	INDEX     
ATXR.IDX  	S&P C.S. Ga-Atlanta Home Price Index              	INDEX     
AVDA.IDX  	AMEX Advances Declines Volume Difference          	INDEX     
AVDD.IDX  	OTC Advance Decline Volume Difference             	INDEX     
AVDE.IDX  	ETFS  Advances - Declines Volume                  	INDEX     
AVDN.IDX  	NYSE Advances Declines Volume Difference          	INDEX     
AVDQ.IDX  	NASD Advances Declines Volume Difference          	INDEX     
AVDS.IDX  	TSX Advance Decline Volume Difference             	INDEX     
AVDT.IDX  	Total Advances Declines Volume Difference         	INDEX     
AVDV.IDX  	Tsxv Advance Decline Volume Difference            	INDEX     
AVDX.IDX  	CAD Total Advance Decline Volume Difference       	INDEX     
AVLD.IDX  	AMEX Declining Volume                             	INDEX     
AVLF.IDX  	AMEX Advance Decline Volume Difference            	INDEX     
AVLR.IDX  	AMEX Advance Decline Vol Ratio                    	INDEX     
AVLU.IDX  	AMEX Advancing Volume                             	INDEX     
AVRA.IDX  	AMEX Advance Decline Volume Ratio                 	INDEX     
AVRD.IDX  	OTC Advance Decline Volume Ratio                  	INDEX     
AVRE.IDX  	ETFS  Advance / Decline Volume                    	INDEX     
AVRN.IDX  	NYSE Advance Decline Volume Ratio                 	INDEX     
AVRQ.IDX  	NASD Advance Decline Volume Ratio                 	INDEX     
AVRS.IDX  	TSX Advance Decline Volume Ratio                  	INDEX     
AVRT.IDX  	Total Advance Decline Volume Ratio                	INDEX     
AVRV.IDX  	Tsxv Advance Decline Volume Ratio                 	INDEX     
AVRX.IDX  	CAD Total Advance Decline Volume Ratio            	INDEX     
AVVA.IDX  	AMEX Advancing Volume                             	INDEX     
AVVD.IDX  	OTC Advancing Volume                              	INDEX     
AVVE.IDX  	ETFS  Advancing Volume                            	INDEX     
AVVN.IDX  	NYSE Advancing Volume                             	INDEX     
AVVQ.IDX  	NASD Advancing Volume                             	INDEX     
AVVS.IDX  	TSX Advancing Volume                              	INDEX     
AVVT.IDX  	Total Advancing Volume                            	INDEX     
AVVV.IDX  	Tsxv Advancing Volume                             	INDEX     
AVVX.IDX  	CAD Total Advancing Volume                        	INDEX     
BANK.IDX  	Nasdaq Bank                                       	INDEX     
BCMA.IDX  	Barchart Market Momentum Index Advances           	INDEX     
BCMC.IDX  	Barchart TSX Market Momentum Index                	INDEX     
BCMD.IDX  	Barchart Market Momentum Index Declines           	INDEX     
BCME.IDX  	Barchart TSX Market Momentum Index Advances       	INDEX     
BCMF.IDX  	Barchart TSX Market Momentum Index Declines       	INDEX     
BCMG.IDX  	Barchart TSX Market Momentum Index Unch           	INDEX     
BCMM.IDX  	Barchart Market Momentum Index                    	INDEX     
BCMU.IDX  	Barchart Market Momentum Index Unch               	INDEX     
BDMA.IDX  	Barchart Market Momentum Advances Yesterday       	INDEX     
BDMC.IDX  	Barchart TSX Market Momentum Yesterday            	INDEX     
BDMD.IDX  	Barchart Market Momentum Declines Yesterday       	INDEX     
BDME.IDX  	Barchart TSX Market Momentum Advances Yesterday   	INDEX     
BDMF.IDX  	Barchart TSX Market Momentum Declines Yesterday   	INDEX     
BDMG.IDX  	Barchart TSX Market Momentum Unch Yesterday       	INDEX     
BDMM.IDX  	Barchart Market Momentum Yesterday                	INDEX     
BDMU.IDX  	Barchart Market Momentum Unch Yesterday           	INDEX     
BFMA.IDX  	Barchart Market Momentum Advances Last Week       	INDEX     
BFMC.IDX  	Barchart TSX Market Momentum Last Week            	INDEX     
BFMD.IDX  	Barchart Market Momentum Declines Last Week       	INDEX     
BFME.IDX  	Barchart TSX Market Momentum Advances Last Week   	INDEX     
BFMF.IDX  	Barchart TSX Market Momentum Declines Last Week   	INDEX     
BFMG.IDX  	Barchart TSX Market Momentum Unch Last Week       	INDEX     
BFMM.IDX  	Barchart Market Momentum Last Week                	INDEX     
BFMU.IDX  	Barchart Market Momentum Unch Last Week           	INDEX     
BFX.IDX   	BEL 20 - Belgium                                  	INDEX     
BGMA.IDX  	Barchart Market Momentum Advances Last Month      	INDEX     
BGMC.IDX  	Barchart TSX Market Momentum Last Month           	INDEX     
BGMD.IDX  	Barchart Market Momentum Declines Last Month      	INDEX     
BGME.IDX  	Barchart TSX Market Momentum Advances Last Month  	INDEX     
BGMF.IDX  	Barchart TSX Market Momentum Declines Last Month  	INDEX     
BGMG.IDX  	Barchart TSX Market Momentum Unch Last Month      	INDEX     
BGMM.IDX  	Barchart Market Momentum Last Month               	INDEX     
BGMU.IDX  	Barchart Market Momentum Unch Last Month          	INDEX     
BJE.IDX   	NYSE Arca Mini-Biotechnology In-                  	INDEX     
BKNIF.IDX 	Bank Nifty                                        	INDEX     
BKX.IDX   	KBW Bank Index                                    	INDEX     
BOXR.IDX  	S&P C.S. Ma-Boston Home Price Index               	INDEX     
BRTI.IDX  	Bitcoin Real Time Index                           	INDEX     
BSESN.IDX 	BSE 30 - India                                    	INDEX     
BTK.IDX   	AMEX Biotechnology Index                          	INDEX     
BTS.IDX   	AMEX Biotechnology Index Final                    	INDEX     
BVSP.IDX  	Bovespa - Brazil                                  	INDEX     
BWH.IDX   	POWERSHARES WILDERHILL CLEAN EN                   	INDEX     
BXD.IDX   	CBOE DJIA BUYWRITE INDEX                          	INDEX     
BXM.IDX   	CBOE BUYWRITE MONTHLY INDEX                       	INDEX     
BXN.IDX   	CBOE BUYWRITE MONTHLY INDEX                       	INDEX     
BXR.IDX   	CBOE RUSSELL 2000 BUYWRITE INDE                   	INDEX     
BXY.IDX   	CBOE S& P 500 BUYWRITE    INDEX                   	INDEX     
BZJ.IDX   	NYSE Arca Mini-Oil Index                          	INDEX     
CAC40.IDX 	Paris CAC 40                                      	INDEX     
CASE.IDX  	Egyptian EGX30                                    	INDEX     
CELS.IDX  	NASDAQ Clean Edge Green Energy                    	INDEX     
CEX.IDX   	S& P Chemicals Index                              	INDEX     
CEXR.IDX  	S&P C.S. Oh-Cleveland Home Price Index            	INDEX     
CHXR.IDX  	S&P C.S. Il-Chicago Home Price Index              	INDEX     
CIV.IDX   	Cboe/Cbot Corn Volatility Index                   	INDEX     
CKG.IDX   	S&P 600 Barra Grwth                               	INDEX     
COMP.IDX  	Nasdaq Composite                                  	INDEX     
CPH.IDX   	AMEX China Settle                                 	INDEX     
CPR.IDX   	Copper Index                                      	INDEX     
CRXR.IDX  	S&P C.S. Nc-Charlotte Home Price Index            	INDEX     
CS2R.IDX  	S&P C.S. 20-City Composite Home Price Index       	INDEX     
CSXR.IDX  	S&P C.S. 10-City Composite Home Price Index       	INDEX     
CVK.IDX   	Smcp 600Barr Val                                  	INDEX     
CYM.IDX   	Claymore Yield ETF Iopv                           	INDEX     
CZH.IDX   	AMEX CHINA INDX                                   	INDEX     
DAX.IDX   	Frankfurt Dax                                     	INDEX     
DAXR.IDX  	S&P C.S. Tx-Dallas Home Price Index               	INDEX     
DCFI.IDX  	DOW Comp Stocks Above 50-Day Average              	INDEX     
DCOF.IDX  	DOW Comp Stocks Above 150-Day Average             	INDEX     
DCOH.IDX  	DOW Comp Stocks Above 100-Day Average             	INDEX     
DCSE.IDX  	Djw US Semiconductor                              	INDEX     
DCTH.IDX  	DOW Comp Stocks Above 200-Day Average             	INDEX     
DCTW.IDX  	DOW Comp Stocks Above 20-Day Average              	INDEX     
DDA.IDX   	DJIA VOLATILITY INDEX - OFFER S                   	INDEX     
DDB.IDX   	DJIA VOLATILITY INDEX - BID SID                   	INDEX     
DDO.IDX   	AMEX Disk Drive Index Final Set                   	INDEX     
DDX.IDX   	AMEX Disk Drive Index                             	INDEX     
DECA.IDX  	AMEX Declining Stocks                             	INDEX     
DECD.IDX  	OTC Declining Stocks                              	INDEX     
DECE.IDX  	ETFS  Declining Stocks                            	INDEX     
DECN.IDX  	NYSE Declining Stocks                             	INDEX     
DECQ.IDX  	NASD Declining Stocks                             	INDEX     
DECS.IDX  	TSX Declining Stocks                              	INDEX     
DECT.IDX  	Total Declining Stocks                            	INDEX     
DECV.IDX  	Tsxv Declining Stocks                             	INDEX     
DECX.IDX  	CAD Total Declining Stocks                        	INDEX     
DEXR.IDX  	S&P C.S. Mi-Detroit Home Price Index              	INDEX     
DFI.IDX   	AMEX Defense Index                                	INDEX     
DGE.IDX   	AMEX Equal Weighted Pharma Index                  	INDEX     
DHC.IDX   	DYNAMIC HLTHCARE INTELL                           	INDEX     
DHD.IDX   	DYNAMIC BANKING INTELL                            	INDEX     
DIFI.IDX  	DOW Indu Stocks Above 50-Day Average              	INDEX     
DIOF.IDX  	DOW Indu Stocks Above 150-Day Average             	INDEX     
DIOH.IDX  	DOW Indu Stocks Above 100-Day Average             	INDEX     
DITH.IDX  	DOW Indu Stocks Above 200-Day Average             	INDEX     
DITW.IDX  	DOW Indu Stocks Above 20-Day Average              	INDEX     
DIVD.IDX  	S&P 500 ANNUAL DIVIDEND - 10X                     	INDEX     
DIVQ.IDX  	NASDAQ Dividend Achievers Index                   	INDEX     
DJC.IDX   	Dow Jones Composite Average                       	INDEX     
DJEC.IDX  	DJ INTERNET COMMERCE IND                          	INDEX     
DJI.IDX   	DJ Industrial Average                             	INDEX     
DJT.IDX   	DJ Transport Average                              	INDEX     
DJU.IDX   	DJ Utility Average                                	INDEX     
DJWO.IDX  	DJ WORLD STOCK INDEX                              	INDEX     
DLTC.IDX  	U.S. Large-Cap Technology Index                   	INDEX     
DMT.IDX   	Dly Mirrow Idx                                    	INDEX     
DNXR.IDX  	S&P C.S. Co-Denver Home Price Index               	INDEX     
DOI.IDX   	AMEX Defense Index Final Settle                   	INDEX     
DOWE.IDX  	INDUSTRIALS EU$                                   	INDEX     
DRCI.IDX  	DJ COMPREIT                                       	INDEX     
DREI.IDX  	DJ EQUITYREIT                                     	INDEX     
DRG.IDX   	AMEX Pharmaceutical Index                         	INDEX     
DRO.IDX   	AMEX Pharmaceutical Index Final                   	INDEX     
DSAE.IDX  	DJ US AERODEF                                     	INDEX     
DSAF.IDX  	DJ US DELIVRYSRV                                  	INDEX     
DSAG.IDX  	DJ US ASSETMNG                                    	INDEX     
DSAI.IDX  	DJ US ELECEQUIP                                   	INDEX     
DSAL.IDX  	DJ US ALUMINUM                                    	INDEX     
DSAM.IDX  	DJ US MEDEQUIP                                    	INDEX     
DSAP.IDX  	DJ US AUTOPARTS                                   	INDEX     
DSAR.IDX  	DJ US AIRLINES                                    	INDEX     
DSAS.IDX  	DJ US AEROSPACE                                   	INDEX     
DSAT.IDX  	DJ US AUTOPARTS                                   	INDEX     
DSAU.IDX  	DJ US AUTOMOBILE                                  	INDEX     
DSAV.IDX  	DJ US MEDIAAGN                                    	INDEX     
DSBC.IDX  	DJ US BRDCASTENT                                  	INDEX     
DSBD.IDX  	DJ US BLDGMATFIX                                  	INDEX     
DSBE.IDX  	DJ US BSTRNGEMP                                   	INDEX     
DSBK.IDX  	DJ US BANKS                                       	INDEX     
DSBM.IDX  	DJ US BASICMAT                                    	INDEX     
DSBS.IDX  	DJ US BSCRSRCES                                   	INDEX     
DSBT.IDX  	DJ US BIOTECHNO                                   	INDEX     
DSBV.IDX  	DJ US BEVERAGES                                   	INDEX     
DSCA.IDX  	DJ US GAMBLING                                    	INDEX     
DSCC.IDX  	DJ US COMMCHEM                                    	INDEX     
DSCE.IDX  	DJ US CONSELECT                                   	INDEX     
DSCF.IDX  	DJ US CLOTHACCSS                                  	INDEX     
DSCG.IDX  	DJ US TRAVLEIS                                    	INDEX     
DSCH.IDX  	DJ US CHEMICALS                                   	INDEX     
DSCL.IDX  	DJ US COAL                                        	INDEX     
DSCM.IDX  	DJ US PERSPROD                                    	INDEX     
DSCN.IDX  	DJ US CONSMATRLS                                  	INDEX     
DSCP.IDX  	DJ US CTNRS&PKNG                                  	INDEX     
DSCR.IDX  	DJ US CMPTRHRDWR                                  	INDEX     
DSCS.IDX  	DJ US SPLTYCNSRV                                  	INDEX     
DSCT.IDX  	DJ US SEMICONDTR                                  	INDEX     
DSCX.IDX  	DJ US SPCLTYCHEM                                  	INDEX     
DSCY.IDX  	DJ US CONSUMSRV                                   	INDEX     
DSDB.IDX  	DJ US BREWERS                                     	INDEX     
DSDN.IDX  	DJ US DEFENSE                                     	INDEX     
DSDR.IDX  	DJ US FDDRGRET                                    	INDEX     
DSDS.IDX  	DJ US INSUPPLIER                                  	INDEX     
DSDT.IDX  	U.S. Diversified REITs Index                      	INDEX     
DSDV.IDX  	DJ US CMPTRSRV                                    	INDEX     
DSEC.IDX  	DJ US ELCCOMPEQP                                  	INDEX     
DSEE.IDX  	DJ US ELECEQUP                                    	INDEX     
DSEH.IDX  	U.S. Real Estate Holding & Development Index      	INDEX     
DSEN.IDX  	DJ US OIL&GAS                                     	INDEX     
DSES.IDX  	U.S. Real Estate Services Index                   	INDEX     
DSEU.IDX  	DJ US ELECTRCTY                                   	INDEX     
DSFA.IDX  	DJ US FINADMIN                                    	INDEX     
DSFB.IDX  	DJ US FOOD&BEV                                    	INDEX     
DSFC.IDX  	DJ US FXLNTELCM                                   	INDEX     
DSFD.IDX  	DJ US FOODRTWHSL                                  	INDEX     
DSFE.IDX  	DJ US INDUSTMACH                                  	INDEX     
DSFH.IDX  	DJ US FURNISHNG                                   	INDEX     
DSFI.IDX  	DJ US FINCLSRV                                    	INDEX     
DSFN.IDX  	DJ US FINANCIALS                                  	INDEX     
DSFO.IDX  	DJ US FOODPRODRS                                  	INDEX     
DSFP.IDX  	DJ US FOODPRDCTS                                  	INDEX     
DSFR.IDX  	DJ US FORESTPAPR                                  	INDEX     
DSFT.IDX  	DJ US FOOTWEAR                                    	INDEX     
DSFV.IDX  	U.S. Financial Services Index                     	INDEX     
DSGF.IDX  	DJ US GENFINAN                                    	INDEX     
DSGI.IDX  	DJ US GENINDUST                                   	INDEX     
DSGT.IDX  	DJ US GENRETAIL                                   	INDEX     
DSGU.IDX  	DJ US GASDISTRIB                                  	INDEX     
DSHB.IDX  	DJ US HOMECONS                                    	INDEX     
DSHC.IDX  	DJ US HLTHCARE                                    	INDEX     
DSHD.IDX  	DJ US DURHLDPROD                                  	INDEX     
DSHG.IDX  	DJ US HLDGOODS                                    	INDEX     
DSHI.IDX  	DJ US HMIMPRETL                                   	INDEX     
DSHL.IDX  	U.S. Hotel & Lodging REITs Index                  	INDEX     
DSHN.IDX  	DJ US NDURHLDPRD                                  	INDEX     
DSHP.IDX  	DJ US HLTHCRPVDR                                  	INDEX     
DSHR.IDX  	DJ US COMRVEHTRK                                  	INDEX     
DSHV.IDX  	DJ US HVYCONS                                     	INDEX     
DSIB.IDX  	DJ US INSBROKERS                                  	INDEX     
DSID.IDX  	DJ US DVSFINDUS                                   	INDEX     
DSIF.IDX  	DJ US FLLINEINS                                   	INDEX     
DSIG.IDX  	DJ US INDGDS&SRV                                  	INDEX     
DSIL.IDX  	DJ US LIFEINSUR                                   	INDEX     
DSIM.IDX  	DJ US INDMETALS                                   	INDEX     
DSIN.IDX  	DJ US INDSTRIALS                                  	INDEX     
DSIO.IDX  	U.S. Industrial & Office REITs Index              	INDEX     
DSIP.IDX  	DJ US PROPCASINS                                  	INDEX     
DSIQ.IDX  	DJ US INDSTENGNG                                  	INDEX     
DSIR.IDX  	DJ US INSURANCE                                   	INDEX     
DSIS.IDX  	DJ US SUPPORTSRV                                  	INDEX     
DSIT.IDX  	DJ US INDSTTRANS                                  	INDEX     
DSIU.IDX  	DJ US REINSURAN                                   	INDEX     
DSIV.IDX  	DJ US BUSSUPSRV                                   	INDEX     
DSIX.IDX  	DJ US NLIFEINSUR                                  	INDEX     
DSLE.IDX  	DJ US LEISGOODS                                   	INDEX     
DSLG.IDX  	DJ US HOTELS                                      	INDEX     
DSLW.IDX  	DJ US LOWCAP                                      	INDEX     
DSMC.IDX  	DJ US HCREQPSRV                                   	INDEX     
DSME.IDX  	DJ US MEDIA                                       	INDEX     
DSMF.IDX  	DJ US MORTGFIN                                    	INDEX     
DSMG.IDX  	DJ US MINING                                      	INDEX     
DSMR.IDX  	U.S. Mortgage REITs Index                         	INDEX     
DSMS.IDX  	DJ US MDSUPPLIES                                  	INDEX     
DSMT.IDX  	DJ US MARTRANSPT                                  	INDEX     
DSMU.IDX  	DJ US MULUTILTES                                  	INDEX     
DSNC.IDX  	DJ US CONSUMGDS                                   	INDEX     
DSNF.IDX  	DJ US NONFERMET                                   	INDEX     
DSNG.IDX  	DJ US PERHLDGDS                                   	INDEX     
DSNS.IDX  	DJ US INTERNET                                    	INDEX     
DSOE.IDX  	DJ US ELECOFFEQP                                  	INDEX     
DSOG.IDX  	DJ US OILGAS                                      	INDEX     
DSOI.IDX  	DJ US OILEQPSRV                                   	INDEX     
DSOL.IDX  	DJ US INTGOILGAS                                  	INDEX     
DSOQ.IDX  	DJ US OILEQPSRV                                   	INDEX     
DSOS.IDX  	DJ US EXPLPROD                                    	INDEX     
DSPB.IDX  	DJ US PUBLISHING                                  	INDEX     
DSPC.IDX  	DJ US WSTDSPSRV                                   	INDEX     
DSPG.IDX  	DJ US PERSGOODS                                   	INDEX     
DSPL.IDX  	DJ US PIPELINES                                   	INDEX     
DSPM.IDX  	DJ US GOLDMNG                                     	INDEX     
DSPN.IDX  	DJ US PHARMBIO                                    	INDEX     
DSPP.IDX  	DJ US PAPER                                       	INDEX     
DSPR.IDX  	DJ US PHARMCTCLS                                  	INDEX     
DSPT.IDX  	DJ US PLTPRECMET                                  	INDEX     
DSRA.IDX  	DJ US APPRLRET                                    	INDEX     
DSRB.IDX  	DJ US BRDLNRET                                    	INDEX     
DSRD.IDX  	DJ US DRUGRET                                     	INDEX     
DSRE.IDX  	U.S. Real Estate Index                            	INDEX     
DSRH.IDX  	DJ US RESTHLDG                                    	INDEX     
DSRI.IDX  	DJ US RESTINVTR                                   	INDEX     
DSRL.IDX  	U.S. Retail REITs Index                           	INDEX     
DSRN.IDX  	U.S. Residential REITs Index                      	INDEX     
DSRP.IDX  	DJ US RECPRODUCT                                  	INDEX     
DSRQ.IDX  	DJ US RECSERVICE                                  	INDEX     
DSRR.IDX  	DJ US RAILROADS                                   	INDEX     
DSRS.IDX  	DJ US SPLTYRET                                    	INDEX     
DSRT.IDX  	DJ US RETAIL                                      	INDEX     
DSRU.IDX  	DJ US RESTRBARS                                   	INDEX     
DSSB.IDX  	DJ US INVSRV                                      	INDEX     
DSSC.IDX  	DJ US SEMCNDCTRS                                  	INDEX     
DSSD.IDX  	DJ US SOFTDRINKS                                  	INDEX     
DSSF.IDX  	DJ US CONSUMFIN                                   	INDEX     
DSSP.IDX  	DJ US SPECIALFIN                                  	INDEX     
DSSR.IDX  	U.S. Specialty REITs Index                        	INDEX     
DSST.IDX  	DJ US STEEL                                       	INDEX     
DSSV.IDX  	DJ US SFTCPTRSRV                                  	INDEX     
DSSW.IDX  	DJ US SOFTWARE                                    	INDEX     
DSTB.IDX  	DJ US TOBACCO                                     	INDEX     
DSTC.IDX  	DJ US TECHNOLOGY                                  	INDEX     
DSTK.IDX  	DJ US TRUCKING                                    	INDEX     
DSTL.IDX  	DJ US TELECOM                                     	INDEX     
DSTP.IDX  	DJ US TOPCAP                                      	INDEX     
DSTQ.IDX  	DJ US TECHHRDEQ                                   	INDEX     
DSTR.IDX  	DJ US TIRES                                       	INDEX     
DSTS.IDX  	DJ US TRANSSRV                                    	INDEX     
DSTT.IDX  	DJ US TRVLTOUR                                    	INDEX     
DSTY.IDX  	DJ US TOYS                                        	INDEX     
DSUO.IDX  	DJ US GASWTRMUT                                   	INDEX     
DSUT.IDX  	DJ US UTILITIES                                   	INDEX     
DSVE.IDX  	U.S. Conventional Electricity Index               	INDEX     
DSVN.IDX  	DJ US DISVINTNER                                  	INDEX     
DSWC.IDX  	DJ US MOBTELECOM                                  	INDEX     
DSWU.IDX  	DJ US WATER                                       	INDEX     
DTCI.IDX  	DJ COMPREIT TR                                    	INDEX     
DTEI.IDX  	DJ EQUITYREIT TR                                  	INDEX     
DTFI.IDX  	DOW Tran Stocks Above 50-Day Average              	INDEX     
DTFX.IDX  	CME FX Index                                      	INDEX     
DTOF.IDX  	DOW Tran Stocks Above 150-Day Average             	INDEX     
DTOH.IDX  	DOW Tran Stocks Above 100-Day Average             	INDEX     
DTTH.IDX  	DOW Tran Stocks Above 200-Day Average             	INDEX     
DTTW.IDX  	DOW Tran Stocks Above 20-Day Average              	INDEX     
DTWC.IDX  	DJ COMPAVGTR                                      	INDEX     
DTWI.IDX  	DJ INDUS AVG TR                                   	INDEX     
DTWT.IDX  	DJ TRANSAVGTR                                     	INDEX     
DTWU.IDX  	DJ UTILITYAVGTR                                   	INDEX     
DUBS.IDX  	DJ UBS COMMODITY INDEX                            	INDEX     
DUFI.IDX  	DOW Util Stocks Above 50-Day Average              	INDEX     
DUOF.IDX  	DOW Util Stocks Above 150-Day Average             	INDEX     
DUOH.IDX  	DOW Util Stocks Above 100-Day Average             	INDEX     
DUSL.IDX  	DJ US LRGCAP                                      	INDEX     
DUSM.IDX  	DJ US MIDCAP                                      	INDEX     
DUSS.IDX  	DJ US SMLCAP                                      	INDEX     
DUTH.IDX  	DOW Util Stocks Above 200-Day Average             	INDEX     
DUTW.IDX  	DOW Util Stocks Above 20-Day Average              	INDEX     
DVAA.IDX  	S&P 500 FORWARD DIVD - 2010                       	INDEX     
DVAB.IDX  	S&P 500 FORWARD DIVD - 2011                       	INDEX     
DVCA.IDX  	AMEX Declining Volume                             	INDEX     
DVCD.IDX  	OTC Declining Volume                              	INDEX     
DVCE.IDX  	ETFS  Declining Volume                            	INDEX     
DVCN.IDX  	NYSE Declining Volume                             	INDEX     
DVCQ.IDX  	NASD Declining Volume                             	INDEX     
DVCS.IDX  	TSX Declining Volume                              	INDEX     
DVCT.IDX  	Total Declining Volume                            	INDEX     
DVCV.IDX  	Tsxv Declining Volume                             	INDEX     
DVCX.IDX  	CAD Total Declining Volume                        	INDEX     
DVDE.IDX  	IMPLIED FORWARD DVS DECEMBER                      	INDEX     
DVJN.IDX  	IMPLIED FORWARD DVS JUNE                          	INDEX     
DVMR.IDX  	IMPLIED FORWARD DVS MARCH                         	INDEX     
DVS.IDX   	S&P 500 DIVIDEND INDEX - 10X                      	INDEX     
DVST.IDX  	IMPLIED FORWARD DVS SEPTEMBER                     	INDEX     
DWC.IDX   	DJ Wilshire 5000 Index (Full Cap)                 	INDEX     
DWCB.IDX  	DJ US BANKS TOTAL INDEX                           	INDEX     
DWE.IDX   	DYNAMIC ENERGY EXPLORATION & PR                   	INDEX     
DWJ.IDX   	DYNAMIC IURANCE INTELLIDEX                        	INDEX     
DWO.IDX   	DYNAMIC OIL SERVICES INTELLIDEX                   	INDEX     
DWR.IDX   	DYNAMIC RETAIL INTELLIDEX                         	INDEX     
DWU.IDX   	DYNAMIC UTILITIES INTELLIDEX                      	INDEX     
DWY.IDX   	DYNAMIC TELECOMMUNICATION & WIR                   	INDEX     
DXG.IDX   	AMEX Spade Defense Setl                           	INDEX     
DXS.IDX   	SPADE DEFEE                                       	INDEX     
DXY.IDX   	U.S. Dollar Index                                 	INDEX     
DYH.IDX   	Dynamic Top 200 Intell                            	INDEX     
DYI.IDX   	AMEX Dynamic Market Intellidex                    	INDEX     
DYO.IDX   	AMEX Dynamic Otc Intellidex                       	INDEX     
DZC.IDX   	DYNAMIC SOFTWARE INTELLIDEX                       	INDEX     
DZE.IDX   	DYNAMIC SEMICONDUCTOR INTELLIDE                   	INDEX     
DZF.IDX   	DYNAMIC FOOD & BEVERAGE INTELLI                   	INDEX     
DZH.IDX   	DYNAMIC HARDWARE & CO ELEC IN                     	INDEX     
DZL.IDX   	DYNAMIC LEISURE&ENTERTAINMENT I                   	INDEX     
DZM.IDX   	DYNAMIC MEDIA INTELLIDEX                          	INDEX     
DZN.IDX   	DYNAMIC NETWORKING INTELLIDEX                     	INDEX     
DZO.IDX   	Dynamic Biotech & Genome Intell                   	INDEX     
DZR.IDX   	DYNAMIC PHARMACEUTICAL INTELLID                   	INDEX     
ECO.IDX   	Wh Clean Energy                                   	INDEX     
EED.IDX   	Claymore Bric ETF Iopv                            	INDEX     
EVZ.IDX   	CBOE EURO CURR VOL IND                            	INDEX     
EZB.IDX   	DYNAMIC BS MT INTELLIDEX                          	INDEX     
EZF.IDX   	DYNAMIC FINCL INTELLIDEX                          	INDEX     
EZK.IDX   	DYNAMIC ENRGY INTELLIDEX                          	INDEX     
EZL.IDX   	DYNAMIC INDUS INTELLIDEX                          	INDEX     
EZS.IDX   	DYNAMIC CN ST INTELLIDEX                          	INDEX     
EZV.IDX   	DYNAMIC TECHN INTELLIDEX                          	INDEX     
EZX.IDX   	DYNAMIC HLTHC INTELLIDEX                          	INDEX     
EZZ.IDX   	DYNAMIC CN DS INTELLIDEX                          	INDEX     
FBV.IDX   	Powershrs Db G10 Fd Iopv                          	INDEX     
FTSA.IDX  	FTSE 350                                          	INDEX     
FTSE.IDX  	FTSE 100 Index                                    	INDEX     
FTSEMIB.IDX	FTSE MIB Index                                    	INDEX     
FTSEMIBN.IDX	FTSE MIB Net Total Return                         	INDEX     
FTSM.IDX  	FTSE Mid 250 Index                                	INDEX     
FVX.IDX   	5-YEAR TREASURY NOTE                              	INDEX     
GDM.IDX   	AMEX GOLD MINERS                                  	INDEX     
GLD.IDX   	Gold Index                                        	INDEX     
GMI.IDX   	Mkt Vector Gold Min Iopv                          	INDEX     
GNX.IDX   	GSCI Spot Return                                  	INDEX     
GVX.IDX   	Goldman Sachs Livestock Sub Index                 	INDEX     
GVZ.IDX   	GSTI SERVICES INDEX SETTLEMENT                    	INDEX     
HGX.IDX   	Phlx Hsg Sector Index                             	INDEX     
HIGA.IDX  	AMEX New Highs                                    	INDEX     
HIGD.IDX  	OTC New Highs                                     	INDEX     
HIGN.IDX  	NYSE New Highs                                    	INDEX     
HIGQ.IDX  	NASD New Highs                                    	INDEX     
HIGS.IDX  	TSX New Highs                                     	INDEX     
HIGV.IDX  	Tsxv New Highs                                    	INDEX     
HKO.IDX   	AMEX Hong Kong Opt Flt Rt Index                   	INDEX     
HKX.IDX   	AMEX Hong Kong 30 Index                           	INDEX     
HSI.IDX   	Hang Seng Index                                   	INDEX     
HUI.IDX   	AMEX Gold Bugs Index                              	INDEX     
HUV.IDX   	AMEX Gold Bugs Index Final Sett                   	INDEX     
HVX.IDX   	Mkt Vector Env Serv Iopv                          	INDEX     
HWI.IDX   	AMEX Computer Hardware Index                      	INDEX     
HWO.IDX   	Computer Hardware Index Fnl Set                   	INDEX     
ICK.IDX   	ISE Chindia Index                                 	INDEX     
IDX.IDX   	S&P 400 Midcap Index                              	INDEX     
IEB.IDX   	DYNAMIC LARGE CAP INTELL                          	INDEX     
IEK.IDX   	DYNAMIC MID CAP INTELL                            	INDEX     
IEY.IDX   	DYNAMIC SMALL CAP INTELL                          	INDEX     
ILH.IDX   	Dynamic Lg Cap Gr Intellidex                      	INDEX     
ILJ.IDX   	Dynamic Mid Cp Gr Intellidex                      	INDEX     
ILK.IDX   	Dynamic Sml Cp Gr Intellidex                      	INDEX     
ILP.IDX   	Dynamic Mid Cp Valu Intellidex                    	INDEX     
ILR.IDX   	DYNAMIC AGR GRWTH INTLDX                          	INDEX     
ILU.IDX   	DYNAMIC DEEP VAL INTELDX                          	INDEX     
ILW.IDX   	Dynamic Lg Cp Valu Intellidex                     	INDEX     
ILZ.IDX   	Dynamic Sml Cp Valu Intellidex                    	INDEX     
INDS.IDX  	Nasdaq Industrial                                 	INDEX     
INSR.IDX  	Nasdaq Inurance                                   	INDEX     
IPSA.IDX  	IPSA - Chile                                      	INDEX     
IQX.IDX   	S&P 500 EQUAL WEIGHT                              	INDEX     
IQZ.IDX   	S&P 1000                                          	INDEX     
IRX.IDX   	13-WEEK TREASURY BILL                             	INDEX     
ITAIM.IDX 	FTSE AIM Italia Index                             	INDEX     
ITLMS.IDX 	FTSE Italia All-Share Index                       	INDEX     
ITLMSC.IDX	FTSE Italia All-Share Capped Index                	INDEX     
ITMC.IDX  	FTSE Italia Mid Cap Index                         	INDEX     
ITSC.IDX  	FTSE Italia Small Cap Index                       	INDEX     
ITSTAR.IDX	FTSE Italia STAR Index                            	INDEX     
IUX.IDX   	Russell 2000 Stock Index                          	INDEX     
IVX.IDX   	S&P 500 Value                                     	INDEX     
IXB.IDX   	Materials Select Sector Index                     	INDEX     
IXCO.IDX  	Nasdaq Computer                                   	INDEX     
IXE.IDX   	The Energy Select Sector Index                    	INDEX     
IXF.IDX   	Nasdaq Financial 100                              	INDEX     
IXHC.IDX  	NASDAQ Health Care Index                          	INDEX     
IXI.IDX   	Industrial Select Sector Index                    	INDEX     
IXM.IDX   	Financial Select Sector Index                     	INDEX     
IXR.IDX   	Consumer Staples Select Sector Index              	INDEX     
IXT.IDX   	Technology Select Sector Index                    	INDEX     
IXTC.IDX  	Nasdaq Telecommunications                         	INDEX     
IXU.IDX   	Utilities Select Sector Index                     	INDEX     
IXV.IDX   	Healthcare Select Sector Index                    	INDEX     
IXY.IDX   	Consumer Discretionary Select Sector Index        	INDEX     
JBV.IDX   	NYSE Arca Mini-Broker/Dealer  I-                  	INDEX     
JKSE.IDX  	Jakarta Composite Index                           	INDEX     
JPN.IDX   	AMEX Japan Index                                  	INDEX     
JPV.IDX   	AMEX Japan Index Final Settleme                   	INDEX     
JX.IDX    	Tsx Venture Composite Index                       	INDEX     
KBK.IDX   	NYSE Arca Mini-Pharmaceutical I-                  	INDEX     
KDX.IDX   	KBW Finsec Dividend Yield Index                   	INDEX     
KDY.IDX   	AMEX Hong Kong Index Float Rate                   	INDEX     
KIX.IDX   	KBW Insurance Index                               	INDEX     
KLCI.IDX  	Kuala Lumpur Composite                            	INDEX     
KLX.IDX   	Mkt Vectors Steel Iopv                            	INDEX     
KPX.IDX   	KBW Property & Casualty Index                     	INDEX     
KRX.IDX   	KBW Regional Banking Index                        	INDEX     
KS11.IDX  	Seoul Composite                                   	INDEX     
KSX.IDX   	KBW Capital Markets Index                         	INDEX     
KYX.IDX   	KBW Premium Yield Equity REIT Index               	INDEX     
LOWA.IDX  	AMEX New Lows                                     	INDEX     
LOWD.IDX  	OTC New Lows                                      	INDEX     
LOWN.IDX  	NYSE New Lows                                     	INDEX     
LOWQ.IDX  	NASD New Lows                                     	INDEX     
LOWS.IDX  	TSX New Lows                                      	INDEX     
LOWV.IDX  	Tsxv New Lows                                     	INDEX     
LVXR.IDX  	S&P C.S. Nv-Las Vegas Home Price Index            	INDEX     
LXXR.IDX  	S&P C.S. Ca-Los Angeles Home Price Index          	INDEX     
M1HA.IDX  	1-Month Highs AMEX                                	INDEX     
M1HD.IDX  	1-Month Highs Otcbb                               	INDEX     
M1HE.IDX  	1-Month Highs ETFS                                	INDEX     
M1HH.IDX  	1-Month Highs Price GT $10                        	INDEX     
M1HL.IDX  	1-Month Highs Price Lt $10                        	INDEX     
M1HN.IDX  	1-Month Highs NYSE                                	INDEX     
M1HP.IDX  	1-Month Highs Sp500                               	INDEX     
M1HQ.IDX  	1-Month Highs Nasdaq                              	INDEX     
M1HU.IDX  	1-Month Highs Volume Lt 100K                      	INDEX     
M1HV.IDX  	1-Month Highs Volume GT 100K                      	INDEX     
M1HX.IDX  	1-Month Highs Overall                             	INDEX     
M1LA.IDX  	1-Month Lows AMEX                                 	INDEX     
M1LD.IDX  	1-Month Lows Otcbb                                	INDEX     
M1LE.IDX  	1-Month Lows ETFS                                 	INDEX     
M1LH.IDX  	1-Month Lows Price GT $10                         	INDEX     
M1LL.IDX  	1-Month Lows Price Lt $10                         	INDEX     
M1LN.IDX  	1-Month Lows NYSE                                 	INDEX     
M1LP.IDX  	1-Month Lows Sp500                                	INDEX     
M1LQ.IDX  	1-Month Lows Nasdaq                               	INDEX     
M1LU.IDX  	1-Month Lows Volume Lt 100K                       	INDEX     
M1LV.IDX  	1-Month Lows Volume GT 100K                       	INDEX     
M1LX.IDX  	1-Month Lows Overall                              	INDEX     
M3HA.IDX  	3-Month Highs AMEX                                	INDEX     
M3HD.IDX  	3-Month Highs Otcbb                               	INDEX     
M3HE.IDX  	3-Month Highs ETFS                                	INDEX     
M3HH.IDX  	3-Month Highs Price GT $10                        	INDEX     
M3HL.IDX  	3-Month Highs Price Lt $10                        	INDEX     
M3HN.IDX  	3-Month Highs NYSE                                	INDEX     
M3HP.IDX  	3-Month Highs Sp500                               	INDEX     
M3HQ.IDX  	3-Month Highs Nasdaq                              	INDEX     
M3HU.IDX  	3-Month Highs Volume Lt 100K                      	INDEX     
M3HV.IDX  	3-Month Highs Volume GT 100K                      	INDEX     
M3HX.IDX  	3-Month Highs Overall                             	INDEX     
M3LA.IDX  	3-Month Lows AMEX                                 	INDEX     
M3LD.IDX  	3-Month Lows Otcbb                                	INDEX     
M3LE.IDX  	3-Month Lows ETFS                                 	INDEX     
M3LH.IDX  	3-Month Lows Price GT $10                         	INDEX     
M3LL.IDX  	3-Month Lows Price Lt $10                         	INDEX     
M3LN.IDX  	3-Month Lows NYSE                                 	INDEX     
M3LP.IDX  	3-Month Lows Sp500                                	INDEX     
M3LQ.IDX  	3-Month Lows Nasdaq                               	INDEX     
M3LU.IDX  	3-Month Lows Volume Lt 100K                       	INDEX     
M3LV.IDX  	3-Month Lows Volume GT 100K                       	INDEX     
M3LX.IDX  	3-Month Lows Overall                              	INDEX     
M6HA.IDX  	6-Month Highs AMEX                                	INDEX     
M6HD.IDX  	6-Month Highs Otcbb                               	INDEX     
M6HE.IDX  	6-Month Highs ETFS                                	INDEX     
M6HH.IDX  	6-Month Highs Price GT $10                        	INDEX     
M6HL.IDX  	6-Month Highs Price Lt $10                        	INDEX     
M6HN.IDX  	6-Month Highs NYSE                                	INDEX     
M6HP.IDX  	6-Month Highs Sp500                               	INDEX     
M6HQ.IDX  	6-Month Highs Nasdaq                              	INDEX     
M6HU.IDX  	6-Month Highs Volume Lt 100K                      	INDEX     
M6HV.IDX  	6-Month Highs Volume GT 100K                      	INDEX     
M6HX.IDX  	6-Month Highs Overall                             	INDEX     
M6LA.IDX  	6-Month Lows AMEX                                 	INDEX     
M6LD.IDX  	6-Month Lows Otcbb                                	INDEX     
M6LE.IDX  	6-Month Lows ETFS                                 	INDEX     
M6LH.IDX  	6-Month Lows Price GT $10                         	INDEX     
M6LL.IDX  	6-Month Lows Price Lt $10                         	INDEX     
M6LN.IDX  	6-Month Lows NYSE                                 	INDEX     
M6LP.IDX  	6-Month Lows Sp500                                	INDEX     
M6LQ.IDX  	6-Month Lows Nasdaq                               	INDEX     
M6LU.IDX  	6-Month Lows Volume Lt 100K                       	INDEX     
M6LV.IDX  	6-Month Lows Volume GT 100K                       	INDEX     
M6LX.IDX  	6-Month Lows Overall                              	INDEX     
MAHA.IDX  	52-Week Highs AMEX                                	INDEX     
MAHD.IDX  	52-Week Highs Otcbb                               	INDEX     
MAHE.IDX  	52-Week Highs ETFS                                	INDEX     
MAHH.IDX  	52-Week Highs Price GT $10                        	INDEX     
MAHL.IDX  	52-Week Highs Price Lt $10                        	INDEX     
MAHN.IDX  	52-Week Highs NYSE                                	INDEX     
MAHP.IDX  	52-Week Highs Sp500                               	INDEX     
MAHQ.IDX  	52-Week Highs Nasdaq                              	INDEX     
MAHU.IDX  	52-Week Highs Volume Lt 100K                      	INDEX     
MAHV.IDX  	52-Week Highs Volume GT 100K                      	INDEX     
MAHX.IDX  	52-Week Highs Overall                             	INDEX     
MALA.IDX  	52-Week Lows AMEX                                 	INDEX     
MALD.IDX  	52-Week Lows Otcbb                                	INDEX     
MALE.IDX  	52-Week Lows ETFS                                 	INDEX     
MALH.IDX  	52-Week Lows Price GT $10                         	INDEX     
MALL.IDX  	52-Week Lows Price Lt $10                         	INDEX     
MALN.IDX  	52-Week Lows NYSE                                 	INDEX     
MALP.IDX  	52-Week Lows Sp500                                	INDEX     
MALQ.IDX  	52-Week Lows Nasdaq                               	INDEX     
MALU.IDX  	52-Week Lows Volume Lt 100K                       	INDEX     
MALV.IDX  	52-Week Lows Volume GT 100K                       	INDEX     
MALX.IDX  	52-Week Lows Overall                              	INDEX     
MDO.IDX   	Mid Opn/Cls Avge                                  	INDEX     
MERV.IDX  	Merval - Argentina                                	INDEX     
MEV.IDX   	AMEX Mexico Index Settlement                      	INDEX     
MFX.IDX   	KBW Mortgage Finance Index                        	INDEX     
MGD.IDX   	Midcp 400Barra                                    	INDEX     
MIA.IDX   	Mid O/C/H/L Avg                                   	INDEX     
MID.IDX   	Midcap 400 Idx                                    	INDEX     
MIH.IDX   	Mid Hi/Lo Avge                                    	INDEX     
MIV.IDX   	Mid-Cap Settle                                    	INDEX     
MIXR.IDX  	S&P C.S. Fl-Miami Home Price Index                	INDEX     
MLO.IDX   	AMEX Merrill Lynch Tech 100                       	INDEX     
MMFI.IDX  	Percent of Stocks Above 50-Day Average            	INDEX     
MMOF.IDX  	Percent of Stocks Above 150-Day Average           	INDEX     
MMOH.IDX  	Percent of Stocks Above 100-Day Average           	INDEX     
MMTH.IDX  	Percent of Stocks Above 200-Day Average           	INDEX     
MMTW.IDX  	Percent of Stocks Above 20-Day Average            	INDEX     
MNFI.IDX  	Percent Above 50-Day Average Yesterday            	INDEX     
MNG.IDX   	AMEX MINI-NATURAL GAS INDEX                       	INDEX     
MNOF.IDX  	Percent Above 150-Day Average Yesterday           	INDEX     
MNOH.IDX  	Percent Above 100-Day Average Yesterday           	INDEX     
MNTH.IDX  	Percent Above 200-Day Average Yesterday           	INDEX     
MNTW.IDX  	Percent Above 20-Day Average Yesterday            	INDEX     
MNXR.IDX  	S&P C.S. Mn-Minneapolis Home Price Index          	INDEX     
MOFI.IDX  	Percent Above 50-Day Average Last Week            	INDEX     
MOOF.IDX  	Percent Above 150-Day Average Last Week           	INDEX     
MOOH.IDX  	Percent Above 100-Day Average Last Week           	INDEX     
MOTH.IDX  	Percent Above 200-Day Average Last Week           	INDEX     
MOTW.IDX  	Percent Above 20-Day Average Last Week            	INDEX     
MPFI.IDX  	Percent Above 50-Day Average Last Month           	INDEX     
MPOF.IDX  	Percent Above 150-Day Average Last Month          	INDEX     
MPOH.IDX  	Percent Above 100-Day Average Last Month          	INDEX     
MPTH.IDX  	Percent Above 200-Day Average Last Month          	INDEX     
MPTW.IDX  	Percent Above 20-Day Average Last Month           	INDEX     
MSH.IDX   	AMEX Morgan Stanley Hi Tech 35                    	INDEX     
MTFI.IDX  	TSX Percent of Stocks Above 50-Day Average        	INDEX     
MTOF.IDX  	TSX Percent of Stocks Above 150-Day Average       	INDEX     
MTOH.IDX  	TSX Percent of Stocks Above 100-Day Average       	INDEX     
MTTH.IDX  	TSX Percent of Stocks Above 200-Day Average       	INDEX     
MTTW.IDX  	TSX Percent of Stocks Above 20-Day Average        	INDEX     
MUFI.IDX  	TSX Percent Above 50-Day Average Yesterday        	INDEX     
MUOF.IDX  	TSX Percent Above 150-Day Average Yesterday       	INDEX     
MUOH.IDX  	TSX Percent Above 100-Day Average Yesterday       	INDEX     
MUTH.IDX  	TSX Percent Above 200-Day Average Yesterday       	INDEX     
MUTW.IDX  	TSX Percent Above 20-Day Average Yesterday        	INDEX     
MUV.IDX   	Mdcp 400Bar Val                                   	INDEX     
MVFI.IDX  	TSX Percent Above 50-Day Average Last Week        	INDEX     
MVH.IDX   	Morgan Stanley High-Technology                    	INDEX     
MVOF.IDX  	TSX Percent Above 150-Day Average Last Week       	INDEX     
MVOH.IDX  	TSX Percent Above 100-Day Average Last Week       	INDEX     
MVTH.IDX  	TSX Percent Above 200-Day Average Last Week       	INDEX     
MVTW.IDX  	TSX Percent Above 20-Day Average Last Week        	INDEX     
MWFI.IDX  	TSX Percent Above 50-Day Average Last Month       	INDEX     
MWOF.IDX  	TSX Percent Above 150-Day Average Last Month      	INDEX     
MWOH.IDX  	TSX Percent Above 100-Day Average Last Month      	INDEX     
MWTH.IDX  	TSX Percent Above 200-Day Average Last Month      	INDEX     
MWTW.IDX  	TSX Percent Above 20-Day Average Last Month       	INDEX     
MXX.IDX   	Mexico IPC                                        	INDEX     
MXY.IDX   	AMEX Mexico Index                                 	INDEX     
MYHA.IDX  	YTD Highs AMEX                                    	INDEX     
MYHD.IDX  	YTD Highs Otcbb                                   	INDEX     
MYHE.IDX  	YTD Highs ETFS                                    	INDEX     
MYHH.IDX  	YTD Highs Price GT $10                            	INDEX     
MYHL.IDX  	YTD Highs Price Lt $10                            	INDEX     
MYHN.IDX  	YTD Highs NYSE                                    	INDEX     
MYHP.IDX  	YTD Highs Sp500                                   	INDEX     
MYHQ.IDX  	YTD Highs Nasdaq                                  	INDEX     
MYHU.IDX  	YTD Highs Volume Lt 100K                          	INDEX     
MYHV.IDX  	YTD Highs Volume GT 100K                          	INDEX     
MYHX.IDX  	YTD Highs Overall                                 	INDEX     
MYLA.IDX  	YTD Lows AMEX                                     	INDEX     
MYLD.IDX  	YTD Lows Otcbb                                    	INDEX     
MYLE.IDX  	YTD Lows ETFS                                     	INDEX     
MYLH.IDX  	YTD Lows Price GT $10                             	INDEX     
MYLL.IDX  	YTD Lows Price Lt $10                             	INDEX     
MYLN.IDX  	YTD Lows NYSE                                     	INDEX     
MYLP.IDX  	YTD Lows Sp500                                    	INDEX     
MYLQ.IDX  	YTD Lows Nasdaq                                   	INDEX     
MYLU.IDX  	YTD Lows Volume Lt 100K                           	INDEX     
MYLV.IDX  	YTD Lows Volume GT 100K                           	INDEX     
MYLX.IDX  	YTD Lows Overall                                  	INDEX     
NAST.IDX  	NASDAQ Transportation Index                       	INDEX     
NBI.IDX   	Nasdaq Biotechnology                              	INDEX     
NBZ.IDX   	Nasdaq Biotech Index Final Set                    	INDEX     
NDFI.IDX  	Nasdaq 100 Stocks Above 50-Day Average            	INDEX     
NDOF.IDX  	Nasdaq 100 Stocks Above 150-Day Average           	INDEX     
NDOH.IDX  	Nasdaq 100 Stocks Above 100-Day Average           	INDEX     
NDTH.IDX  	Nasdaq 100 Stocks Above 200-Day Average           	INDEX     
NDTW.IDX  	Nasdaq 100 Stocks Above 20-Day Average            	INDEX     
NDX.IDX   	NASDAQ 100 INDEX                                  	INDEX     
NDXT.IDX  	NASDAQ 100 TECHNOLOGY                             	INDEX     
NDXX.IDX  	NASDAQ-100 Ex-Tech Sector Index                   	INDEX     
NDY.IDX   	Nasdaq 100                                        	INDEX     
NEX.IDX   	Wilderhill New Energy Global In                   	INDEX     
NFA.IDX   	Cts Feed Fa                                       	INDEX     
NGV.IDX   	AMEX Natural Gas Index Final Se                   	INDEX     
NI225.IDX 	Nikkei 225                                        	INDEX     
NNY.IDX   	US 100                                            	INDEX     
NNYE.IDX  	ENERGY IDX                                        	INDEX     
NNYI.IDX  	INTERNATIONAL 100                                 	INDEX     
NNYK.IDX  	FINANCIAL                                         	INDEX     
NNYL.IDX  	WORLD LEADERS                                     	INDEX     
NNYP.IDX  	HEALTH CARE                                       	INDEX     
NNYY.IDX  	TMT IDX                                           	INDEX     
NQGM.IDX  	Ndaq Global Market Composite                      	INDEX     
NQGS.IDX  	NASDAQ Global Select Market Composite Index       	INDEX     
NSEI.IDX  	CNX Nifty                                         	INDEX     
NSHD.IDX  	NYSE Declining Stocks                             	INDEX     
NSHF.IDX  	NYSE Advances - Declines                          	INDEX     
NSHR.IDX  	NYSE Advance Decline Ratio                        	INDEX     
NSHU.IDX  	NYSE Advancing Stocks                             	INDEX     
NVLD.IDX  	NYSE Declining Volume                             	INDEX     
NVLF.IDX  	NYSE Advance Decline Volume Difference            	INDEX     
NVLR.IDX  	NYSE Advance Decline Vol Ratio                    	INDEX     
NVLU.IDX  	NYSE Advancing Volume                             	INDEX     
NVOT.IDX  	NYSE Total Volume                                 	INDEX     
NWV.IDX   	AMEX Networking Index Settlemen                   	INDEX     
NWX.IDX   	AMEX Networking Index                             	INDEX     
NXTQ.IDX  	NASDAQ Q-50 Index                                 	INDEX     
NYA.IDX   	NYSE Composite                                    	INDEX     
NYI.IDX   	NYSE International 100 Index                      	INDEX     
NYL.IDX   	NYSE World Leaders Index                          	INDEX     
NYXR.IDX  	S&P C.S. Ny-New York Home Price Index             	INDEX     
NZ50.IDX  	NZSX 50 Index                                     	INDEX     
OEX.IDX   	S&P 100 Index                                     	INDEX     
OFIN.IDX  	Nasdaq Other Financial Index                      	INDEX     
OILBR.IDX 	Crude Oil Brent NYMEX                             	INDEX     
OILSW.IDX 	Crude Oil Light Sweet NYMEX                       	INDEX     
OIV.IDX   	CBOE/NYMEX WTI Volatility Index                   	INDEX     
OMX.IDX   	OMX Stockholm 30 Index                            	INDEX     
ONE.IDX   	S&P 100 Index                                     	INDEX     
OOI.IDX   	S&P Gl 100 Id                                     	INDEX     
OSX.IDX   	Phlx Euro Style Oil Svc Index                     	INDEX     
OVX.IDX   	CBOE CRUDE OIL VOLATILITY INDEX                   	INDEX     
PHN.IDX   	AMEX Telecom Index                                	INDEX     
PHXR.IDX  	S&P C.S. Az-Phoenix Home Price Index              	INDEX     
PLD.IDX   	Palladium Index                                   	INDEX     
PLT.IDX   	Platinum Index                                    	INDEX     
POQ.IDX   	CBOE POWERPACKS TELCOM INDEX                      	INDEX     
POXR.IDX  	S&P C.S. Or-Portland Home Price Index             	INDEX     
PSEI.IDX  	Philippines Stock Exchange PSEi Index             	INDEX     
QSHD.IDX  	NASD Declining Stocks                             	INDEX     
QSHF.IDX  	NASD Advances - Declines                          	INDEX     
QSHR.IDX  	NASD Advance Decline Ratio                        	INDEX     
QSHU.IDX  	NASD Advancing Stocks                             	INDEX     
QVLD.IDX  	NASD Declining Volume                             	INDEX     
QVLF.IDX  	NASD Advance Decline Volume Difference            	INDEX     
QVLR.IDX  	NASD Advance Decline Vol Ratio                    	INDEX     
QVLU.IDX  	NASD Advancing Volume                             	INDEX     
R1FI.IDX  	Russell 1000 Stocks Above 50-Day Average          	INDEX     
R1OF.IDX  	Russell 1000 Stocks Above 150-Day Average         	INDEX     
R1OH.IDX  	Russell 1000 Stocks Above 100-Day Average         	INDEX     
R1TH.IDX  	Russell 1000 Stocks Above 200-Day Average         	INDEX     
R1TW.IDX  	Russell 1000 Stocks Above 20-Day Average          	INDEX     
R2FI.IDX  	Russell 2000 Stocks Above 50-Day Average          	INDEX     
R2OF.IDX  	Russell 2000 Stocks Above 150-Day Average         	INDEX     
R2OH.IDX  	Russell 2000 Stocks Above 100-Day Average         	INDEX     
R2TH.IDX  	Russell 2000 Stocks Above 200-Day Average         	INDEX     
R2TW.IDX  	Russell 2000 Stocks Above 20-Day Average          	INDEX     
R3FI.IDX  	Russell 3000 Stocks Above 50-Day Average          	INDEX     
R3OF.IDX  	Russell 3000 Stocks Above 150-Day Average         	INDEX     
R3OH.IDX  	Russell 3000 Stocks Above 100-Day Average         	INDEX     
R3TH.IDX  	Russell 3000 Stocks Above 200-Day Average         	INDEX     
R3TW.IDX  	Russell 3000 Stocks Above 20-Day Average          	INDEX     
RAG.IDX   	Cboe Russell 3000 Growth Index                    	INDEX     
RAV.IDX   	Cboe Russell 3000 Value Index                     	INDEX     
RDG.IDX   	Cboe Russell Midcap Growth Index                  	INDEX     
RJY.IDX   	S.V. FOR AMEX MINI-NATURAL GAS                    	INDEX     
RLG.IDX   	Cboe 1000 Growth Index                            	INDEX     
RLX.IDX   	S& P Retail Index                                 	INDEX     
RMC.IDX   	Cboe Russell Midcap Index                         	INDEX     
RMV.IDX   	Cboe Russell Midcap Value Index                   	INDEX     
RMZ.IDX   	THE MSCI REIT INDEX                               	INDEX     
RPE.IDX   	AMEX Elec Pwr&Nat Gas Infrastr                    	INDEX     
RSC.IDX   	Russell SmallCap Index                            	INDEX     
RSG.IDX   	Russell SmallCap Growth                           	INDEX     
RSV.IDX   	Russell SmallCap Value                            	INDEX     
RTCM.IDX  	Tsx Income Trust Index                            	INDEX     
RTF.IDX   	RUSSELL TOP 50 INDEX                              	INDEX     
RTG.IDX   	Russell 2500 Growth                               	INDEX     
RTI.IDX   	Russell 2500 Index                                	INDEX     
RTM.IDX   	Russell Microcap Index                            	INDEX     
RTRE.IDX  	Tsx Reit Capped Index                             	INDEX     
RTV.IDX   	Russell 2500 Value                                	INDEX     
RUA.IDX   	Russell 3000 Index                                	INDEX     
RUF.IDX   	ISE Homebuilders Index                            	INDEX     
RUI.IDX   	Russell 1000 Index                                	INDEX     
RUJ.IDX   	Cboe Russell Value Index                          	INDEX     
RUO.IDX   	Cboe Russell 2000 Growth Index                    	INDEX     
RUT.IDX   	Russell 2000 Index                                	INDEX     
RVX.IDX   	CBOE RUSSELL 2000 VOLATILITY IN                   	INDEX     
RWG.IDX   	Russell Top 200 Growth                            	INDEX     
RWI.IDX   	Russell Top 200 Index                             	INDEX     
RWV.IDX   	Russell Top 200 Value                             	INDEX     
S1FI.IDX  	S&P 100 Stocks Above 50-Day Average               	INDEX     
S1OF.IDX  	S&P 100 Stocks Above 150-Day Average              	INDEX     
S1OH.IDX  	S&P 100 Stocks Above 100-Day Average              	INDEX     
S1TH.IDX  	S&P 100 Stocks Above 200-Day Average              	INDEX     
S1TR.IDX  	S&P 500 Automobiles & Components [TR]             	INDEX     
S1TW.IDX  	S&P 100 Stocks Above 20-Day Average               	INDEX     
S2TR.IDX  	S&P 500 Banks [TR]                                	INDEX     
S3TR.IDX  	S&P 500 Capital Goods [TR]                        	INDEX     
S4FI.IDX  	S&P 400 Stocks Above 50-Day Average               	INDEX     
S4OF.IDX  	S&P 400 Stocks Above 150-Day Average              	INDEX     
S4OH.IDX  	S&P 400 Stocks Above 100-Day Average              	INDEX     
S4TH.IDX  	S&P 400 Stocks Above 200-Day Average              	INDEX     
S4TR.IDX  	S&P 500 -Commercial & Professional Services [TR]  	INDEX     
S4TW.IDX  	S&P 400 Stocks Above 20-Day Average               	INDEX     
S5FI.IDX  	S&P 500 Stocks Above 50-Day Average               	INDEX     
S5OF.IDX  	S&P 500 Stocks Above 150-Day Average              	INDEX     
S5OH.IDX  	S&P 500 Stocks Above 100-Day Average              	INDEX     
S5TH.IDX  	S&P 500 Stocks Above 200-Day Average              	INDEX     
S5TR.IDX  	S&P 500 Consumer Durables & Apparel [TR]          	INDEX     
S5TW.IDX  	S&P 500 Stocks Above 20-Day Average               	INDEX     
S6CD.IDX  	S&P SmallCap600 Capped Consumer Discretionary [s  	INDEX     
S6CS.IDX  	S&P SmallCap600 Capped Consumer Staples [sector]  	INDEX     
S6EP.IDX  	S&P SmallCap600 Capped Energy [sector]Index       	INDEX     
S6FI.IDX  	S&P 600 Stocks Above 50-Day Average               	INDEX     
S6FP.IDX  	S&P SmallCap600 Capped Financials [sector]Index   	INDEX     
S6HC.IDX  	S&P SmallCap600 Capped HealthCare [sector]Index   	INDEX     
S6IP.IDX  	S&P SmallCap600 Capped Industrials [sector]Index  	INDEX     
S6MP.IDX  	S&P SmallCap600 Capped Materials [sector]Index    	INDEX     
S6OF.IDX  	S&P 600 Stocks Above 150-Day Average              	INDEX     
S6OH.IDX  	S&P 600 Stocks Above 100-Day Average              	INDEX     
S6TH.IDX  	S&P 600 Stocks Above 200-Day Average              	INDEX     
S6TP.IDX  	S&P SmallCap600 Capped Information Technology [s  	INDEX     
S6TR.IDX  	S&P 500 Consumer Services [TR]                    	INDEX     
S6TW.IDX  	S&P 600 Stocks Above 20-Day Average               	INDEX     
S6UP.IDX  	S&P SmallCap600 Capped Utilities & Telecom Servi  	INDEX     
S7TR.IDX  	S&P 500 Diversified Financials [TR]               	INDEX     
S8TR.IDX  	S&P 500 Energy [TR]                               	INDEX     
S9TR.IDX  	S&P 500 Food & Staples Retailing [TR]             	INDEX     
SAAB.IDX  	S&P Asia Infrastructure Index                     	INDEX     
SACC.IDX  	Alpha Shares China Small Cap Index                	INDEX     
SACN.IDX  	Alpha Shares China Technology Index               	INDEX     
SAEI.IDX  	S&P Global Alternative Energy Index [EURO]        	INDEX     
SAER.IDX  	S&P GSCI Agriculture Capped Component 35/20 EUR   	INDEX     
SAEU.IDX  	S&P Global Alternative Energy Index               	INDEX     
SAIE.IDX  	S&P Africa 40 Index [EURO]                        	INDEX     
SAIU.IDX  	S&P Africa 40 Index                               	INDEX     
SAJR.IDX  	MSCI WISE ASIA Ex-Japan Top [Net TR]              	INDEX     
SAJT.IDX  	MSCI WISE ASIA Ex-Japan Top                       	INDEX     
SANA.IDX  	S&P Agribusiness North America                    	INDEX     
SANC.IDX  	S&P Agribusiness North America CAD                	INDEX     
SAPE.IDX  	S&P Asia Property 40 Index                        	INDEX     
SAPT.IDX  	S&P GSCI All Metals Capped Commodity 35/20 EUR I  	INDEX     
SAPU.IDX  	S&P Asia Property 40 Index [EURO]                 	INDEX     
SAQA.IDX  	S&P Global Water Index                            	INDEX     
SAQE.IDX  	S&P Global Water Index [EURO]                     	INDEX     
SAUE.IDX  	S&P GSCI Agriculture Capped Component 35/20 EUR   	INDEX     
SBAI.IDX  	S&P Brazil ADR Index                              	INDEX     
SBER.IDX  	S&P GSCI Biofuel Index Excess Return              	INDEX     
SBES.IDX  	BLO M Emerging Shariah Index [NetTR]              	INDEX     
SBFI.IDX  	S&P Materials Stocks Above 50-Day Average         	INDEX     
SBIX.IDX  	S&P 500 Banks non-TR                              	INDEX     
SBNP.IDX  	S&P Custom/BNP Paribas SPECTRUMUS Sect or Moment  	INDEX     
SBOF.IDX  	S&P Materials Stocks Above 150-Day Average        	INDEX     
SBOH.IDX  	S&P Materials Stocks Above 100-Day Average        	INDEX     
SBSE.IDX  	S&P BRIC Shariah Index [EURO]                     	INDEX     
SBSU.IDX  	S&P BRIC Shariah Index                            	INDEX     
SBTH.IDX  	S&P Materials Stocks Above 200-Day Average        	INDEX     
SBTR.IDX  	S&P GSCI Biofuel Index Total Return               	INDEX     
SBTW.IDX  	S&P Materials Stocks Above 20-Day Average         	INDEX     
SBUP.IDX  	S&P Food & Beverage Select Industry Index         	INDEX     
SCBR.IDX  	S&P BMI Russia [Capped] [USDollar]                	INDEX     
SCEI.IDX  	CS/RT Emerging Infrastructure Index [NetTR]       	INDEX     
SCGD.IDX  	Credit Suisse Germany Index                       	INDEX     
SCGT.IDX  	Beacon Global Timber Index                        	INDEX     
SCII.IDX  	CAT China Infrastructure [TR]                     	INDEX     
SCIR.IDX  	S&P GSCI North American Copper Index Excess Retu  	INDEX     
SCIS.IDX  	S&P GSCI North American Copper Index              	INDEX     
SCIT.IDX  	S&P GSCI North American Copper Index Total Retur  	INDEX     
SCPC.IDX  	S&P Custom/Polaris China Play Index [TWD]         	INDEX     
SCPX.IDX  	Credit Suisse Germany Price Return Index          	INDEX     
SCRC.IDX  	S&P /CITIC China 30 Index                         	INDEX     
SCRE.IDX  	Alpha Shares China Real Estate Index              	INDEX     
SCSC.IDX  	S&P /CITIC 300 Index                              	INDEX     
SCSE.IDX  	S&P /CITIC 50 Index                               	INDEX     
SCSR.IDX  	CS/RT Emerging Infrastructure Price Return Index  	INDEX     
SCUT.IDX  	S&P/CITIC 300 -  Utilities [Sector]               	INDEX     
SCWI.IDX  	CAT China Water [TR]                              	INDEX     
SCWP.IDX  	S&P Developed Ex-U.S.Property [USDollar]          	INDEX     
SCYE.IDX  	S&P Chinese Renminbi Price Return Index           	INDEX     
SCYI.IDX  	S&P Chinese Renminbi Total Return                 	INDEX     
SDCG.IDX  	Defined MultiCap Growth Index                     	INDEX     
SDCV.IDX  	Defined MultiCap Value Index                      	INDEX     
SDDE.IDX  	Wisdom Tree Domestic Dividends Index ex Financia  	INDEX     
SDEW.IDX  	S&P 400 Midcap Equal Weighted Index               	INDEX     
SDGO.IDX  	Defined Large Cap Growth Opportunities Index      	INDEX     
SDIP.IDX  	S&P DCFI Index Excess Return                      	INDEX     
SDIS.IDX  	S&P DCFIIndex                                     	INDEX     
SDIT.IDX  	S&P DCFI Index Total Return                       	INDEX     
SDLC.IDX  	Defined Large Cap Core Index                      	INDEX     
SDMC.IDX  	Defined Mid Cap Core Index                        	INDEX     
SDPI.IDX  	Goldman Sachs BRICs Nifty 50 Developed Markets I  	INDEX     
SDSC.IDX  	Defined Small Cap Core Index                      	INDEX     
SDTI.IDX  	Goldman Sachs BRICs Nifty 50 Developed Markets I  	INDEX     
SDTR.IDX  	S&P 500 Food Beverage & Tobacco [TR]              	INDEX     
SDTS.IDX  	S&P Diversified Trends Indicator                  	INDEX     
SDTT.IDX  	S&P Diversified Trends Total Return Indicator Le  	INDEX     
SDVO.IDX  	Defined Large Cap Value Opportunities Index       	INDEX     
SEAN.IDX  	S&P Southeast Asia 40 Index [NetTR]               	INDEX     
SEBI.IDX  	S-Network Emerging Infrastructure Builders Index  	INDEX     
SECA.IDX  	S&P GSCI Enhanced Commodity Index                 	INDEX     
SECB.IDX  	S&P GSCI Enhanced Commodity Index Excess Return   	INDEX     
SECC.IDX  	S&P GSCI Enhanced Commodity Index Total Return    	INDEX     
SEFI.IDX  	S&P Energies Stocks Above 50-Day Average          	INDEX     
SEIB.IDX  	S-Network Emerging Infrastructure Builders Index  	INDEX     
SEIE.IDX  	S&P Global Eco Index [EURO]                       	INDEX     
SEII.IDX  	CS/RT Emerging Infrastructure Index               	INDEX     
SEIT.IDX  	S&P Global REIT [AUD]                             	INDEX     
SEIU.IDX  	S&P Global Eco Index                              	INDEX     
SEMT.IDX  	Brics Nifty 50 Emerging Market Tradable Index Tr  	INDEX     
SENSEX.IDX	BSE SENSEX                                        	INDEX     
SEOF.IDX  	S&P Energies Stocks Above 150-Day Average         	INDEX     
SEOH.IDX  	S&P Energies Stocks Above 100-Day Average         	INDEX     
SETH.IDX  	S&P Energies Stocks Above 200-Day Average         	INDEX     
SETW.IDX  	S&P Energies Stocks Above 20-Day Average          	INDEX     
SEXR.IDX  	S&P C.S. Wa-Seattle Home Price Index              	INDEX     
SFFI.IDX  	S&P Financials Stocks Above 50-Day Average        	INDEX     
SFOF.IDX  	S&P Financials Stocks Above 150-Day Average       	INDEX     
SFOH.IDX  	S&P Financials Stocks Above 100-Day Average       	INDEX     
SFTH.IDX  	S&P Financials Stocks Above 200-Day Average       	INDEX     
SFTR.IDX  	S&P 500 - Pharmaceuticals Biotechnology & Life    	INDEX     
SFTW.IDX  	S&P Financials Stocks Above 20-Day Average        	INDEX     
SFXR.IDX  	S&P C.S. Ca-San Francisco Home Price Index        	INDEX     
SG0A.IDX  	S&P GSCI Agriculture & Live Stock Index           	INDEX     
SG0B.IDX  	S&P GSCI Agriculture & Live Stock Index Excess R  	INDEX     
SG0C.IDX  	S&P GSCI Agriculture & Live Stock Index Total Re  	INDEX     
SG0D.IDX  	S&P GSCI Agriculture Index Excess Return          	INDEX     
SG0E.IDX  	S&P GSCI Agriculture Index Total Return           	INDEX     
SG0F.IDX  	S&P GSCI All Cattle Index                         	INDEX     
SG0G.IDX  	S&P GSCI All Cattle Index Excess Return           	INDEX     
SG0H.IDX  	S&P GSCI All Cattle Index Total Return            	INDEX     
SG0I.IDX  	S&P GSCI All Crude Index                          	INDEX     
SG1A.IDX  	S&P GSCI All Crude Index Total Return             	INDEX     
SG1B.IDX  	S&P GSCI All Wheat Index                          	INDEX     
SG1C.IDX  	S&P GSCI All Wheat Index Excess Return            	INDEX     
SG1D.IDX  	S&P GSCI All Wheat Index Total Return             	INDEX     
SG1E.IDX  	S&P GSCI Aluminum Index                           	INDEX     
SG1F.IDX  	S&P GSCI Aluminum Index Excess Return             	INDEX     
SG1G.IDX  	S&P GSCI Aluminum Index Total Return              	INDEX     
SG1H.IDX  	S&P GSCI Soybean Oil Index                        	INDEX     
SG1I.IDX  	S&P GSCI Soybean Oil Index Excess Return          	INDEX     
SG1J.IDX  	S&P GSCI All Crude Index Excess Return            	INDEX     
SG2A.IDX  	S&P GSCI Brent Crude Index                        	INDEX     
SG2B.IDX  	S&P GSCI Brent Crude Index Excess Return          	INDEX     
SG2C.IDX  	S&P GSCI Brent Crude Index Total Return           	INDEX     
SG2D.IDX  	S&P GSCI Cocoa Index                              	INDEX     
SG2E.IDX  	S&P GSCI Cocoa Index Excess Return                	INDEX     
SG2F.IDX  	S&P GSCI Cocoa Index Total Return                 	INDEX     
SG2G.IDX  	S&P GSCI Coffee Index Co Index                    	INDEX     
SG2H.IDX  	S&P GSCI Coffee Index Excess Return               	INDEX     
SG2I.IDX  	S&P GSCI Coffee Index Total Return                	INDEX     
SG2J.IDX  	S&P GSCI Soybean Oil Index Total Return           	INDEX     
SG3A.IDX  	S&P GSCI Copper Index Excess Return               	INDEX     
SG3B.IDX  	S&P GSCI Copper Index Total Return                	INDEX     
SG3C.IDX  	S&P GSCI Corn Index                               	INDEX     
SG3D.IDX  	S&P GSCI Corn Index Excess Return                 	INDEX     
SG3E.IDX  	S&P GSCI Corn Index Total Return                  	INDEX     
SG3F.IDX  	S&P GSCI Cotton Index                             	INDEX     
SG3G.IDX  	S&P GSCI Cotton Index Excess Return               	INDEX     
SG3H.IDX  	S&P GSCI Cotton Index Total Return                	INDEX     
SG3I.IDX  	S&P GSCI Crude Oil Index                          	INDEX     
SG3J.IDX  	S&P GSCI Copper Index                             	INDEX     
SG4A.IDX  	S&P GSCI Crude Oil Index Total Return             	INDEX     
SG4B.IDX  	S&P GSCI Energy and Metals Index                  	INDEX     
SG4C.IDX  	S&P GSCI Energy and Metals Index Excess Return    	INDEX     
SG4D.IDX  	S&P GSCI Energy and Metals Index Total Return     	INDEX     
SG4E.IDX  	S&P GSCI Energy Index Excess Return               	INDEX     
SG4F.IDX  	S&P GSCI Energy Index Total Return                	INDEX     
SG4G.IDX  	S&P GSCI Feeder Cattle Index                      	INDEX     
SG4H.IDX  	S&P GSCI Feeder Cattle Index Excess Return        	INDEX     
SG4I.IDX  	S&P GSCI Feeder Cattle Index Total Return         	INDEX     
SG4J.IDX  	S&P GSCI Crude Oil Index Excess Return            	INDEX     
SG5A.IDX  	S&P GSCI Gas Oil Index Excess Return              	INDEX     
SG5B.IDX  	S&P GSCI Gas Oil Index Total Return               	INDEX     
SG5C.IDX  	S&P GSCI Gold Index                               	INDEX     
SG5D.IDX  	S&P GSCI Gold Index Excess Return                 	INDEX     
SG5E.IDX  	S&P GSCI Gold Index Total Return                  	INDEX     
SG5F.IDX  	S&P GSCI Grains Index                             	INDEX     
SG5G.IDX  	S&P GSCI Grains Index Excess Return               	INDEX     
SG5H.IDX  	S&P GSCI Grains Index Total Return                	INDEX     
SG5I.IDX  	S&P GSCI Heating Oil Index                        	INDEX     
SG5J.IDX  	S&P GSCI Gas Oil Index                            	INDEX     
SG6A.IDX  	S&P GSCI Heating Oil Index Total Return           	INDEX     
SG6B.IDX  	S&P GSCI Industrial Metals Index Excess Return    	INDEX     
SG6C.IDX  	S&P GSCI Industrial Metals Index Total Return     	INDEX     
SG6D.IDX  	S&P GSCI Kansas Wheat Index                       	INDEX     
SG6E.IDX  	S&P GSCI Kansas Wheat Index Excess Return         	INDEX     
SG6F.IDX  	S&P GSCI Kansas Wheat Index Total Return          	INDEX     
SG6G.IDX  	S&P GSCI Lead Index                               	INDEX     
SG6H.IDX  	S&P GSCI Lead Index Excess Return                 	INDEX     
SG6I.IDX  	S&P GSCI Lead Index Total Return                  	INDEX     
SG6J.IDX  	S&P GSCI Heating Oil Index Excess Return          	INDEX     
SG7A.IDX  	S&P GSCI Lean Hogs Index Excess Return            	INDEX     
SG7B.IDX  	S&P GSCI Lean Hogs Index Total Return             	INDEX     
SG7C.IDX  	S&P GSCI Light Energy Index [CPW4]                	INDEX     
SG7D.IDX  	S&P GSCI Light Energy Index [CPW4] Excess Return  	INDEX     
SG7E.IDX  	S&P GSCI Light Energy Index [CPW4] Total Return   	INDEX     
SG7F.IDX  	S&P GSCI Live Cattle Index                        	INDEX     
SG7G.IDX  	S&P GSCI Live Cattle Index Excess Return          	INDEX     
SG7H.IDX  	S&P GSCI Live Cattle Index Total Return           	INDEX     
SG7I.IDX  	S&P GSCI Livestock Index Excess Return            	INDEX     
SG7J.IDX  	S&P GSCI Lean Hogs Index                          	INDEX     
SG8A.IDX  	S&P GSCI Natural Gas Index                        	INDEX     
SG8B.IDX  	S&P GSCI Natural Gas Index Excess Return          	INDEX     
SG8C.IDX  	S&P GSCI Natural Gas Index Total Return           	INDEX     
SG8D.IDX  	S&P GSCI Nickel Index                             	INDEX     
SG8E.IDX  	S&P GSCI Nickel Index Excess Return               	INDEX     
SG8F.IDX  	S&P GSCI Nickel Index Total Return                	INDEX     
SG8G.IDX  	S&P GSCI Non-Energy Index Excess Return           	INDEX     
SG8H.IDX  	S&P GSCI Non-Energy Index                         	INDEX     
SG8I.IDX  	S&P GSCI Non-Energy Index Total Return            	INDEX     
SG8J.IDX  	S&P GSCI Livestock Index Total Return             	INDEX     
SG9A.IDX  	S&P GSCI Non-Livestock Index Excess Return        	INDEX     
SG9B.IDX  	S&P GSCI Non-Livestock Index Total Return         	INDEX     
SG9C.IDX  	S&P GSCI Non-Natural Gas Index                    	INDEX     
SG9D.IDX  	S&P GSCI Non-Natural Gas Index Excess Return      	INDEX     
SG9E.IDX  	S&P GSCI Non-Natural Gas Index Total Return       	INDEX     
SG9F.IDX  	S&P GSCI Non-Precious Index                       	INDEX     
SG9G.IDX  	S&P GSCI Non-Precious Index Excess Return         	INDEX     
SG9H.IDX  	S&P GSCI Non-Precious Index Total Return          	INDEX     
SG9I.IDX  	S&P GSCI Petroleumex-Gas Oil Index                	INDEX     
SG9J.IDX  	S&P GSCI Non-Livestock Index                      	INDEX     
SGAA.IDX  	S&P Global Agribusiness Composite Index USD       	INDEX     
SGAB.IDX  	S&P Global Agribusiness Composite Index EUR       	INDEX     
SGAC.IDX  	S&P Global Agribusiness Equity Index              	INDEX     
SGAD.IDX  	S&P Global Agribusiness Equity Index [EURO]       	INDEX     
SGCC.IDX  	S&P GSCI Capped Commodity 35/20 Index             	INDEX     
SGCR.IDX  	S&P GSCI All Metals Capped Index Excess Return    	INDEX     
SGDO.IDX  	S&P Global Dividend Opportunities Index           	INDEX     
SGIA.IDX  	S&P North American Natural Resources Sector Inde  	INDEX     
SGIB.IDX  	S&P North American Technology Sector Index        	INDEX     
SGID.IDX  	S&P North American Technology Software Index      	INDEX     
SGIF.IDX  	S&P North American Technology Multimedia Network  	INDEX     
SGIR.IDX  	S&P GSCI All Metals Index Excess Return           	INDEX     
SGJ.IDX   	S&P GSCI Energy                                   	INDEX     
SGK.IDX   	S&P GSCI Agriculture                              	INDEX     
SGLN.IDX  	SGI Global Security Index [EURO] [TR]             	INDEX     
SGLS.IDX  	SGI Global Security Index [EURO]                  	INDEX     
SGMA.IDX  	S&P GSCI All Metals Index                         	INDEX     
SGME.IDX  	SGI Global Momentum [NetTR] [EURO] [NetTR] [NEWV  	INDEX     
SGMU.IDX  	SGI Global Momentum [NetTR] [NEWVA]               	INDEX     
SGON.IDX  	S&P Global Dividend Opportunities Index [NetTR]   	INDEX     
SGP.IDX   	S&P GSCI Precious Metals                          	INDEX     
SGPA.IDX  	S&P GSCI All Metals Capped Index                  	INDEX     
SGPG.IDX  	S&P GSCI Agriculture Capped Index                 	INDEX     
SGPP.IDX  	S&P GSCI Capped Commodity 35/20 Index Excess Ret  	INDEX     
SGPR.IDX  	S&P GSCI Agriculture Capped Index Total Return    	INDEX     
SGPT.IDX  	S&P GSCI Capped Commodity 35/20 Index Total Retu  	INDEX     
SGQA.IDX  	S&P GSCI Petroleumex-Gas Oil Index Total Return   	INDEX     
SGQB.IDX  	S&P GSCI Petroleum Index                          	INDEX     
SGQC.IDX  	S&P GSCI Petroleum Index Excess Return            	INDEX     
SGQD.IDX  	S&P GSCI Petroleum Index Total Return             	INDEX     
SGQE.IDX  	S&P GSCI Precious Metals Index Excess Return      	INDEX     
SGQF.IDX  	S&P GSCI Precious Metals Index Total Return       	INDEX     
SGQG.IDX  	S&P GSCI Reduced Energy Index [CPW2]              	INDEX     
SGQH.IDX  	S&P GSCI Reduced Energy Index [CPW2] Excess Retu  	INDEX     
SGQI.IDX  	S&P GSCI Reduced Energy Index [CPW2] Total Retur  	INDEX     
SGQJ.IDX  	S&P GSCI Petroleumex GasOil Index Excess Return   	INDEX     
SGRC.IDX  	S&P GSCI All Metals Capped Commodity 35/20 EUR I  	INDEX     
SGRE.IDX  	S&P GSCI All Metals Capped Commodity 35/20 EUR I  	INDEX     
SGRG.IDX  	S&P GSCI Agriculture Capped Index Excess Return   	INDEX     
SGRM.IDX  	Cohen & Steers Global Realty Majors Portfolio [T  	INDEX     
SGRT.IDX  	S&P GSCI Agriculture Capped Component 35/20 EUR   	INDEX     
SGSA.IDX  	S&P GSCI Silver Index                             	INDEX     
SGSB.IDX  	S&P GSCI Silver Index Excess Return               	INDEX     
SGSC.IDX  	S&P GSCI Silver Index Total Return                	INDEX     
SGSD.IDX  	S&P GSCI Soybeans Index                           	INDEX     
SGSE.IDX  	S&P GSCI Excess Return                            	INDEX     
SGSF.IDX  	S&P GSCI Soybeans Index Excess Return             	INDEX     
SGSG.IDX  	S&P GSCI Soybeans Index Total Return              	INDEX     
SGSH.IDX  	S&P GSCI Sugar Index                              	INDEX     
SGSJ.IDX  	S&P GSCI Sugar Index Excess Return                	INDEX     
SGSK.IDX  	S&P GSCI Sugar Index Total Return                 	INDEX     
SGSM.IDX  	S&P GSCI Ultra-Light Energy Index [CPW8] Excess   	INDEX     
SGSN.IDX  	S&P GSCI Ultra-Light Energy Index [CPW8] Total R  	INDEX     
SGSO.IDX  	S&P GSCI Unleaded Gasoline Index                  	INDEX     
SGSP.IDX  	S&P GSCI Unleaded Gasoline Index Excess Return    	INDEX     
SGSQ.IDX  	S&P GSCI Unleaded Gasoline Index Total Return     	INDEX     
SGSR.IDX  	S&P GSCI Wheat Index                              	INDEX     
SGSS.IDX  	S&P GSCI Wheat Index Excess Return                	INDEX     
SGST.IDX  	S&P GSCI Wheat Index Total Return                 	INDEX     
SGSU.IDX  	S&P GSCI Zinc Index                               	INDEX     
SGSV.IDX  	S&P GSCI Zinc Index Excess Return                 	INDEX     
SGSW.IDX  	S&P GSCI Zinc Index Total Return                  	INDEX     
SGSX.IDX  	S&P GSCI Ultra-LightEnergyIndex [CPW8]            	INDEX     
SGT.IDX   	S&P GSCI Total Return                             	INDEX     
SGTR.IDX  	S&P GSCI All Metals Capped Index Total Return     	INDEX     
SGV.IDX   	CASINO GAMING                                     	INDEX     
SGWN.IDX  	SGI Global Wealth Effect [NetTR]                  	INDEX     
SGWP.IDX  	SGI Global Wealth Effect                          	INDEX     
SGWT.IDX  	S&P GSCI Select Equal Weight Index Tr             	INDEX     
SGX.IDX   	S&P GSCI FPI Index                                	INDEX     
SGY.IDX   	S&P GSCI Industrial Metals                        	INDEX     
SHEP.IDX  	Credit Suisse Hs60 Europe Index Powered By Holt   	INDEX     
SHEU.IDX  	HS60 Europe Index                                 	INDEX     
SHTR.IDX  	S&P 500 HealthCare Equipment & Services [TR]      	INDEX     
SHUS.IDX  	HS60 US Index                                     	INDEX     
SIDO.IDX  	S&P International Dividend Opportunities Index    	INDEX     
SIFI.IDX  	S&P Industrials Stocks Above 50-Day Average       	INDEX     
SIII.IDX  	Indus India Index                                 	INDEX     
SIIP.IDX  	S&P DFFI Index Excess Return                      	INDEX     
SIIS.IDX  	S&P DFFI Index                                    	INDEX     
SIIT.IDX  	S&P DFFI Index Total Return                       	INDEX     
SIN.IDX   	ISE Sindex Index                                  	INDEX     
SIOF.IDX  	S&P Industrials Stocks Above 150-Day Average      	INDEX     
SIOH.IDX  	S&P Industrials Stocks Above 100-Day Average      	INDEX     
SIPR.IDX  	Brics Nifty 50 Emerging Market Tradable Index Pr  	INDEX     
SIRI.IDX  	S&P Indian Rupee Total Return                     	INDEX     
SIRP.IDX  	Cohen & Steers International Realty Majors Portf  	INDEX     
SIS.IDX   	AMEX Semiconductor Index                          	INDEX     
SITH.IDX  	S&P Industrials Stocks Above 200-Day Average      	INDEX     
SITR.IDX  	S&P 500 Insurance [TR]                            	INDEX     
SITW.IDX  	S&P Industrials Stocks Above 20-Day Average       	INDEX     
SIUT.IDX  	S&P 500 2x Inverse Daily Index                    	INDEX     
SIV.IDX   	Cboe/Cbot Soybean Volatility Index                	INDEX     
SJPA.IDX  	S&P Japan 500                                     	INDEX     
SJPB.IDX  	S&P Japan Mid Cap 100                             	INDEX     
SJPC.IDX  	S&P Japan Small Cap 250 Index                     	INDEX     
SJPD.IDX  	S&P TOPIX YEN                                     	INDEX     
SJPE.IDX  	S&P JES100                                        	INDEX     
SJRI.IDX  	S&P Japan Regional Index-Tokai                    	INDEX     
SJTR.IDX  	S&P 500 Semiconductors & Semiconductor Equipment  	INDEX     
SKFI.IDX  	S&P Info Tech Stocks Above 50-Day Average         	INDEX     
SKOF.IDX  	S&P Info Tech Stocks Above 150-Day Average        	INDEX     
SKOH.IDX  	S&P Info Tech Stocks Above 100-Day Average        	INDEX     
SKTH.IDX  	S&P Info Tech Stocks Above 200-Day Average        	INDEX     
SKTR.IDX  	S&P 500 Materials [TR]                            	INDEX     
SKTW.IDX  	S&P Info Tech Stocks Above 20-Day Average         	INDEX     
SLAC.IDX  	S&P LAC40 [US$] [EURO] [NetTR]                    	INDEX     
SLCN.IDX  	S&P US Carbon Efficient Index U.S. Carbci Index   	INDEX     
SLCT.IDX  	S&P U.S. Carbon Efficient Index [TR]              	INDEX     
SLCU.IDX  	S&P U.S. Carbon Efficient Index [NetTR]           	INDEX     
SLEE.IDX  	S&P GSCI Light Energy EUR Index                   	INDEX     
SLER.IDX  	S&P GSCI Light Energy EUR Index ER                	INDEX     
SLEW.IDX  	S&P 600 Smallcap Equal Weighted Index             	INDEX     
SLFI.IDX  	S&P Telcomm Stocks Above 50-Day Average           	INDEX     
SLOF.IDX  	S&P Telcomm Stocks Above 150-Day Average          	INDEX     
SLOH.IDX  	S&P Telcomm Stocks Above 100-Day Average          	INDEX     
SLPE.IDX  	Global Listed Private Equity Index                	INDEX     
SLPX.IDX  	Cushing 30 MLP Index USD Price Return             	INDEX     
SLRT.IDX  	S&P GSCI Light Energy EUR Index TR                	INDEX     
SLTH.IDX  	S&P Telcomm Stocks Above 200-Day Average          	INDEX     
SLTW.IDX  	S&P Telcomm Stocks Above 20-Day Average           	INDEX     
SLUN.IDX  	S&P 500 2x Leverage Daily Index                   	INDEX     
SLUT.IDX  	S&P 500 Gold Hedged Index                         	INDEX     
SLV.IDX   	Silver Index                                      	INDEX     
SML.IDX   	S&P Small Caps 600 Index                          	INDEX     
SMPR.IDX  	Goldman Sachs BRICs Nifty 50 Emerging Markets In  	INDEX     
SMRW.IDX  	Revenue Shares MidCap Fund                        	INDEX     
SMSS.IDX  	Morgan Stanley Smart Money Equity Index [TR]      	INDEX     
SMTI.IDX  	Goldman Sachs BRICs Nifty 50 Emerging Markets In  	INDEX     
SMTR.IDX  	S&P GSCI All Metals Index Total Return            	INDEX     
SMXT.IDX  	DWS Mega Trends Index [NetTRw/fees]               	INDEX     
SNAC.IDX  	Alpha Shares China All Cap Index                  	INDEX     
SNCH.IDX  	Next 11 Core 8 Index                              	INDEX     
SNCT.IDX  	Next 11 Core 8 Index [TR]                         	INDEX     
SNER.IDX  	S&P GSCI Non-Energy EUR IndexER                   	INDEX     
SNNE.IDX  	S&P Global Infrastructure Index [EURO] [NetTR]    	INDEX     
SNNT.IDX  	S&P Global Infrastructure Index [NetTR]           	INDEX     
SNRE.IDX  	S&P Global Natural Resources Index [EURO]         	INDEX     
SNRT.IDX  	S&P GSCI Non-Energy EUR Index TR                  	INDEX     
SNRU.IDX  	S&P Global Natural Resources Index                	INDEX     
SNTE.IDX  	Next 11 Core 5 Index [TR]                         	INDEX     
SNUI.IDX  	S&P GSCI Non-Energy EUR Index                     	INDEX     
SNXR.IDX  	S&P C.S. Ca-San Diego Home Price Index            	INDEX     
SOBC.IDX  	SGI-Orbeo Carbon Credit Index [EUR-TotalReturn]   	INDEX     
SOCC.IDX  	SGI-Orbeo Carbon Credit Index [USD-TotalReturn]   	INDEX     
SOTR.IDX  	S&P 500 Media [TR]                                	INDEX     
SOX.IDX   	PHLX Semiconductor                                	INDEX     
SP500.IDX 	S&P 500                                           	INDEX     
SPAA.IDX  	SGI Pan Africa Index [NetTR] Panri Indexet        	INDEX     
SPAB.IDX  	SGI Pan Africa Index [EURO] [NetTR]               	INDEX     
SPAC.IDX  	SGI Pan Africa Index                              	INDEX     
SPAD.IDX  	S&P GSCI Palladium Index                          	INDEX     
SPEE.IDX  	S&P Listed Private Equity Index [EURO]            	INDEX     
SPER.IDX  	S&P GSCI Palladium Index Excess Return            	INDEX     
SPEY.IDX  	S&P Listed Private Equity Index                   	INDEX     
SPFI.IDX  	S&P Con Staples Stocks Above 50-Day Average       	INDEX     
SPIN.IDX  	S&P GSCI Platinum Index                           	INDEX     
SPIR.IDX  	S&P GSCI Platinum Index Excess Return             	INDEX     
SPLR.IDX  	S&P GSCI Platinum Index Total Return              	INDEX     
SPOF.IDX  	S&P Con Staples Stocks Above 150-Day Average      	INDEX     
SPOH.IDX  	S&P Con Staples Stocks Above 100-Day Average      	INDEX     
SPPR.IDX  	S&P International Preferred Stock Index           	INDEX     
SPRL.IDX  	SGI Premium List [NetTR]                          	INDEX     
SPRT.IDX  	S&P GSCI Palladium Index Total Return             	INDEX     
SPSU.IDX  	S&P COMPOSITE 1500 INDEX                          	INDEX     
SPTH.IDX  	S&P Con Staples Stocks Above 200-Day Average      	INDEX     
SPTW.IDX  	S&P Con Staples Stocks Above 20-Day Average       	INDEX     
SPUS.IDX  	S&P  Global Ex-U.S. Property [US Dollar]          	INDEX     
SPX.IDX   	S&P 500 INDEX                                     	INDEX     
SPXT.IDX  	S&P 500 [TR]                                      	INDEX     
SQTR.IDX  	S&P 500 Software & Services [TR]                  	INDEX     
SRER.IDX  	S&P Indian Rupee Price Return Index               	INDEX     
SRFF.IDX  	SGI Fed Funds Index                               	INDEX     
SRIC.IDX  	S&P BRIC 40 Index [NetTR]                         	INDEX     
SRIE.IDX  	S&P BRIC 40 Index [EURO] [NetTR]                  	INDEX     
SRMP.IDX  	Cohen & Steers US Realty Majors Portfolio [TR]    	INDEX     
SRPR.IDX  	S&P Global REIT [USD]                             	INDEX     
SRTR.IDX  	S&P 500 Real Estate [TR]                          	INDEX     
SRVA.IDX  	Rogers Energy Producers Index [EURO]              	INDEX     
SRVB.IDX  	Rogers Metals Producers Index [EURO]              	INDEX     
SRVC.IDX  	Rogers Agricultural Producers Index [EURO]        	INDEX     
SRVD.IDX  	Rogers Energy Producers Index                     	INDEX     
SRVE.IDX  	Rogers Metals Producers Index                     	INDEX     
SRVF.IDX  	Rogers Agricultural Producers Index               	INDEX     
SRVG.IDX  	Rogers Producers Index                            	INDEX     
SRVH.IDX  	Rogers Producers US Extra Liquid Index            	INDEX     
SRVI.IDX  	Rogers Producers Index [EURO]                     	INDEX     
SRVJ.IDX  	Rogers Producers US Extra Liquid Index [EURO]     	INDEX     
SRWI.IDX  	Revenue Shares Large Cap Fund                     	INDEX     
SS1E.IDX  	S&P 500 EQUAL WEIGHTED Materials [Sector]         	INDEX     
SS1J.IDX  	S&P 500 EQUAL WEIGHTED Energy [Sector]            	INDEX     
SS2E.IDX  	S&P 500 EQUAL WEIGHTED Consumer Discretionary [S  	INDEX     
SS2J.IDX  	S&P 500 EQUAL WEIGHTED Industrials [Sector]       	INDEX     
SS3E.IDX  	S&P 500 EQUAL WEIGHTED HealthCare [Sector]        	INDEX     
SS3J.IDX  	S&P 500 EQUAL WEIGHTED Consumer Staples [Sector]  	INDEX     
SS4E.IDX  	S&P 500 EQUAL WEIGHTED Information Technology [S  	INDEX     
SS4J.IDX  	S&P 500 EQUAL WEIGHTED Financials [Sector]        	INDEX     
SS5E.IDX  	S&P 500 EQUAL WEIGHTED Utilities [Sector]         	INDEX     
SS5J.IDX  	S&P 500 EQUAL WEIGHTED Telecommunication Service  	INDEX     
SSAE.IDX  	S&P Southeast Asia 40 Index [EURO]                	INDEX     
SSAI.IDX  	S&P Southeast Asia 40 Index [EURO] [NetTR]        	INDEX     
SSAU.IDX  	S&P Southeast Asia 40 Index                       	INDEX     
SSAX.IDX  	S&P Asia50                                        	INDEX     
SSBE.IDX  	S&P BRIC 40 Index [EURO]                          	INDEX     
SSBR.IDX  	S&P BRIC 40 Index                                 	INDEX     
SSCA.IDX  	S&P Asia Pacific Emerging BMI [USDollar]          	INDEX     
SSCB.IDX  	S&P Mid-East and Africa BMI [USDollar]            	INDEX     
SSCE.IDX  	S&P /Citigroup BMI EPAC Index                     	INDEX     
SSCH.IDX  	S&P China BMI [USDollar]                          	INDEX     
SSCK.IDX  	S&P EM BMI [USDollar]                             	INDEX     
SSCL.IDX  	S&P Latin America BMI [USDollar]                  	INDEX     
SSCM.IDX  	Schwab 1000 Index                                 	INDEX     
SSCP.IDX  	S&P /Citigroup BMI Asia Pacific Index             	INDEX     
SSCQ.IDX  	S&P European Emerging BMI [CAPPED] [USDollar]     	INDEX     
SSCS.IDX  	S&P Developed Ex US Under USD 2 Billion [USDolla  	INDEX     
SSCU.IDX  	S&P /Citigroup BMI Europe Index                   	INDEX     
SSCW.IDX  	S&P Developed Ex-U.S.BMI [USDollar]               	INDEX     
SSDI.IDX  	S&P 500 Dividend Index                            	INDEX     
SSEC.IDX  	Shanghai Composite                                	INDEX     
SSEN.IDX  	SGI Global Senior [NetTR]                         	INDEX     
SSER.IDX  	SPECTRUM-Long/Short 8% Index ER [NEWVA]           	INDEX     
SSEW.IDX  	S&P GSCI Select Equal Weight Index Spot           	INDEX     
SSFA.IDX  	Credit Suisse Family Index                        	INDEX     
SSFB.IDX  	SGI Double Short Bund Index                       	INDEX     
SSFE.IDX  	Credit Suisse Family Index [EUR] [Price Return]   	INDEX     
SSFI.IDX  	S&P Real Estate Stocks Above 50-Day Average       	INDEX     
SSFP.IDX  	Credit Suisse Family Index [USD] [Price Return]   	INDEX     
SSFT.IDX  	Credit Suisse Family Index [CHF] [Price Return]   	INDEX     
SSFU.IDX  	Credit Suisse Family Index EUR                    	INDEX     
SSGA.IDX  	SGI Global Agriculture                            	INDEX     
SSGC.IDX  	S&P GSCI Enhanced Capped Index                    	INDEX     
SSGD.IDX  	S&P GLOBAL1200-Consumer Discretionary [Sector]    	INDEX     
SSGE.IDX  	S&P GLOBAL1200-Energy [Sector]                    	INDEX     
SSGF.IDX  	S&P GLOBAL1200-Financials [Sector]                	INDEX     
SSGG.IDX  	SGI Global Generics Index [EURO] [NetTR]          	INDEX     
SSGH.IDX  	S&P GLOBAL1200-HealthCare [Sector]                	INDEX     
SSGI.IDX  	S&P GLOBAL1200-Information Technology [Sector]    	INDEX     
SSGL.IDX  	S&P GLOBAL1200                                    	INDEX     
SSGM.IDX  	S&P GLOBAL1200-Materials [Sector]                 	INDEX     
SSGN.IDX  	S&P GLOBAL1200-Industrials [Sector]               	INDEX     
SSGO.IDX  	S&P GSCI E27 WTI Index                            	INDEX     
SSGP.IDX  	S&P GSCI Enhanced Capped Index Excess Return      	INDEX     
SSGR.IDX  	S&P GSCI Enhanced Capped Index Total Return       	INDEX     
SSGS.IDX  	S&P GLOBAL1200-Consumer Staples [Sector]          	INDEX     
SSGT.IDX  	S&P GLOBAL1200-Telecommunication Services [Secto  	INDEX     
SSGU.IDX  	S&P GLOBAL1200-Utilities [Sector]                 	INDEX     
SSGX.IDX  	S&P GSCI E27WTI Index Excess Return               	INDEX     
SSGZ.IDX  	S&P GSCI E27WTI Index Total Return                	INDEX     
SSHE.IDX  	S&P Europe 350 Shariah Index                      	INDEX     
SSHF.IDX  	Credit Suisse Family Index CHF                    	INDEX     
SSHJ.IDX  	S&P Japan 500 Shariah Index                       	INDEX     
SSHX.IDX  	S&P 500 Shariah Index                             	INDEX     
SSIA.IDX  	Credit Suisse Social Awareness Index              	INDEX     
SSIB.IDX  	S&P GSCI Softs Index Excess Return                	INDEX     
SSIC.IDX  	S&P GSCI Softs Index Total Return                 	INDEX     
SSIP.IDX  	S&P DFI Index Excess Return                       	INDEX     
SSIS.IDX  	S&P DFI Index                                     	INDEX     
SSIT.IDX  	S&P DFI Index Total Return                        	INDEX     
SSLF.IDX  	S&P Select Frontier Index                         	INDEX     
SSLS.IDX  	S&P Custom/BNP Paribas-SPECTRUM [GRIPTEST]        	INDEX     
SSMI.IDX  	Swiss Market                                      	INDEX     
SSNI.IDX  	SGI Global Nanotechnology Index [NetTR]           	INDEX     
SSOF.IDX  	S&P Real Estate Stocks Above 150-Day Average      	INDEX     
SSOH.IDX  	S&P Real Estate Stocks Above 100-Day Average      	INDEX     
SSPA.IDX  	S&P ADR Index                                     	INDEX     
SSPE.IDX  	S&P EUROPE 350                                    	INDEX     
SSPF.IDX  	S&P EUROPE 350 - Financials [Sector]              	INDEX     
SSPI.IDX  	S&P EUROPE 350 - Information Technology [Sector]  	INDEX     
SSPL.IDX  	S&P 500Telecom&IT                                 	INDEX     
SSPN.IDX  	S&P 500Energy[Sector]                             	INDEX     
SSPT.IDX  	S&P EUROPE 350 - Telecommunication Services [Sec  	INDEX     
SSPU.IDX  	S&P EURO                                          	INDEX     
SSRF.IDX  	S&P Preferred Stock Index                         	INDEX     
SSRW.IDX  	Revenue Shares Small Cap Fund                     	INDEX     
SSTH.IDX  	S&P Real Estate Stocks Above 200-Day Average      	INDEX     
SSTR.IDX  	SPECTRUM-Long/Short 8% Index TR [NEWVA]           	INDEX     
SSTU.IDX  	S&P 500 EQUAL WEIGHTED Utilities & Telecommunica  	INDEX     
SSTW.IDX  	S&P Real Estate Stocks Above 20-Day Average       	INDEX     
SSUC.IDX  	S&P GSCI Capped Component 35/20 Index             	INDEX     
SSUP.IDX  	S&P GSCI Capped Component 35/20 Index Excess Ret  	INDEX     
SSUT.IDX  	S&P GSCI Capped Component 35/20 Index Total Retu  	INDEX     
SSWP.IDX  	S&P GSCI Select Equal Weight Index Er             	INDEX     
SSXT.IDX  	DWS Swi X Index [NetTRw/fees]                     	INDEX     
STCE.IDX  	S&P Global Clean Energy Index [EURO]              	INDEX     
STCL.IDX  	S&P Global Clean Energy Index                     	INDEX     
STDA.IDX  	S&P Target Date Retirement Income Index           	INDEX     
STDB.IDX  	S&P Target Date 2010 Index                        	INDEX     
STDC.IDX  	S&P Target Date 2015 Index                        	INDEX     
STDD.IDX  	S&P Target Date 2020 Index                        	INDEX     
STDE.IDX  	S&P Target Date 2025 Index                        	INDEX     
STDF.IDX  	S&P Target Date 2030 Index                        	INDEX     
STDG.IDX  	S&P Target Date 2035 Index                        	INDEX     
STDH.IDX  	S&P Target Date 2040 Index                        	INDEX     
STDI.IDX  	S&P Target Date 2045 Index                        	INDEX     
STFE.IDX  	S&P Global Timber and Forestry Index [EURO]       	INDEX     
STFU.IDX  	S&P Global Timber and Forestry Index              	INDEX     
STI.IDX   	STI Index                                         	INDEX     
STIC.IDX  	S&P CTI Total Return USD                          	INDEX     
STIF.IDX  	S&P Global Infrastructure Index [EURO]            	INDEX     
STIL.IDX  	SGI Smart WTI Long Invest Index [NEWVA]           	INDEX     
STIR.IDX  	S&P Global Infrastructure Index                   	INDEX     
STIS.IDX  	S&P Commodity Trends Indicator                    	INDEX     
STMP.IDX  	Tortoise MLP Index                                	INDEX     
STNC.IDX  	Tsx American Preferred Stock Index                	INDEX     
STNU.IDX  	S&P/Tsx North American Pref Stock Index           	INDEX     
STOXX.IDX 	DJ Stoxx 50 Index Euro                            	INDEX     
STRA.IDX  	S&P Target Risk Aggressive Index                  	INDEX     
STRB.IDX  	S&P Target Risk Moderate Index                    	INDEX     
STRC.IDX  	S&P Target Risk Growth Index                      	INDEX     
STRD.IDX  	S&P Target Risk Conservative Index                	INDEX     
STRL.IDX  	S&P LAC40 [US$] [NetTR]                           	INDEX     
STRN.IDX  	S&P 500 [NetTR]                                   	INDEX     
STRS.IDX  	S&P 500 TR Short                                  	INDEX     
STRT.IDX  	S&P 500 Telecommunication Services [TR]           	INDEX     
STRU.IDX  	S&P 500 Household & Personal Products [TR]        	INDEX     
STSI.IDX  	SGI Smart WTI Short Invest Index [NEWVA]          	INDEX     
STSU.IDX  	S&P TOP IX150 Shariah [USD]                       	INDEX     
STSY.IDX  	S&P TOP IX150 Shariah                             	INDEX     
STTR.IDX  	S&P 500 Technology Hardware & Equipment [TR]      	INDEX     
SUCD.IDX  	S&P Select Sector Capped 20% Consumer Discretion  	INDEX     
SUCS.IDX  	S&P Select Sector Capped 20% Consumer Staples In  	INDEX     
SUEP.IDX  	S&P Select Sector Capped 20% Energy Index Net TR  	INDEX     
SUFI.IDX  	S&P Utilities Stocks Above 50-Day Average         	INDEX     
SUFP.IDX  	S&P Select Sector Capped 20% Financials Index Ne  	INDEX     
SUHC.IDX  	S&P Select Sector Capped 20% HealthCare Index Ne  	INDEX     
SUIP.IDX  	S&P Select Sector Capped 20% Industrials Index N  	INDEX     
SUJP.IDX  	S&P Mitsubishi Corporate Group Index              	INDEX     
SUKP.IDX  	S&P United Kingdom [PDS]                          	INDEX     
SUKS.IDX  	S&P United Kingdom [USD]                          	INDEX     
SUMI.IDX  	S&P Select Sector Capped 20% Materials Index Net  	INDEX     
SUNI.IDX  	MAC GLOBAL SOLAR INDEX                            	INDEX     
SUOF.IDX  	S&P Utilities Stocks Above 150-Day Average        	INDEX     
SUOH.IDX  	S&P Utilities Stocks Above 100-Day Average        	INDEX     
SUPI.IDX  	S&P Select Sector Capped 20% Utilities Index Net  	INDEX     
SURI.IDX  	S&P /Citigroup BMI REIT SUS Index                 	INDEX     
SUTH.IDX  	S&P Utilities Stocks Above 200-Day Average        	INDEX     
SUTP.IDX  	S&P Select Sector Capped 20% Technology Index Ne  	INDEX     
SUTW.IDX  	S&P Utilities Stocks Above 20-Day Average         	INDEX     
SVFI.IDX  	S&P Health Care Stocks Above 50-Day Average       	INDEX     
SVOF.IDX  	S&P Health Care Stocks Above 150-Day Average      	INDEX     
SVOH.IDX  	S&P Health Care Stocks Above 100-Day Average      	INDEX     
SVTH.IDX  	S&P Health Care Stocks Above 200-Day Average      	INDEX     
SVTR.IDX  	Next 11 Vietnam [TotalReturn] Index               	INDEX     
SVTW.IDX  	S&P Health Care Stocks Above 20-Day Average       	INDEX     
SW0B.IDX  	S&P Developed Ex-U.S.BMI [Capped] Energy          	INDEX     
SW0C.IDX  	S&P Developed Ex-U.S.BMI [Capped] Materials       	INDEX     
SW0D.IDX  	S&P Developed Ex-U.S.BMI [Capped] Industrials     	INDEX     
SW0E.IDX  	S&P Developed Ex-U.S.BMI [Capped] Consumer Discr  	INDEX     
SW0F.IDX  	S&P Developed Ex-U.S.BMI [Capped] Consumer Stapl  	INDEX     
SW0G.IDX  	S&P Developed Ex-U.S.BMI [Capped] HealthCare      	INDEX     
SW0H.IDX  	S&P Developed Ex-U.S.BMI [Capped] Financials      	INDEX     
SW0I.IDX  	S&P Developed Ex-U.S.BMI [Capped] Information Te  	INDEX     
SW1A.IDX  	S&P Developed Ex-U.S.BMI [Capped] Utilities       	INDEX     
SW1B.IDX  	S&P Developed Ex-U.S.Cap Range Companies Between  	INDEX     
SW1C.IDX  	S&P Emerging Under USD 2 Billion                  	INDEX     
SW1J.IDX  	S&P Developed Ex-U.S.BMI [Capped] Telecommunicat  	INDEX     
SWDI.IDX  	VTL Navellier Revenue Weighted Index              	INDEX     
SWDR.IDX  	VTL Revenue Weighted ADR Index                    	INDEX     
SWFI.IDX  	Revenue Shares Large Cap Fund Financials [Sector  	INDEX     
SWIB.IDX  	SGI Wise Bottom                                   	INDEX     
SWIT.IDX  	SGI Wise Top                                      	INDEX     
SWML.IDX  	Wachovia MLP Index                                	INDEX     
SWSP.IDX  	S&P World Commodity Index                         	INDEX     
SWTE.IDX  	Wisdom Tree Earnings 500 Index                    	INDEX     
SWTM.IDX  	Wisdom Tree Mid Cap Earnings Index                	INDEX     
SWTS.IDX  	Wisdom Tree Small Cap Earnings Index              	INDEX     
SWTT.IDX  	Wisdom Tree Earnings Index                        	INDEX     
SWTV.IDX  	Wisdom Tree Large Cap Value Index                 	INDEX     
SWUB.IDX  	SGI Wise US Bottom                                	INDEX     
SWUL.IDX  	SGI Wise US Long/Short [NEWVA]                    	INDEX     
SWUT.IDX  	SGI WISE US Top                                   	INDEX     
SXTR.IDX  	S&P 500 Utilities [Industry Group] [TR]           	INDEX     
SYFI.IDX  	S&P Con Discret Stocks Above 50-Day Average       	INDEX     
SYOF.IDX  	S&P Con Discret Stocks Above 150-Day Average      	INDEX     
SYOH.IDX  	S&P Con Discret Stocks Above 100-Day Average      	INDEX     
SYTH.IDX  	S&P Con Discret Stocks Above 200-Day Average      	INDEX     
SYTR.IDX  	S&P 500 Transportation [Industry Group] [TR]      	INDEX     
SYTW.IDX  	S&P Con Discret Stocks Above 20-Day Average       	INDEX     
SZTR.IDX  	S&P 500 Retailing [Industry Group] [TR]           	INDEX     
TA25.IDX  	Tel Aviv 25 Index                                 	INDEX     
TACK.IDX  	AMEX Tick                                         	INDEX     
TACX.IDX  	AMEX Tick                                         	INDEX     
TASI.IDX  	Tadawul All Shares Index                          	INDEX     
TBO.IDX   	AMEX Tobacco Index Settlement                     	INDEX     
TCFI.IDX  	TSX Comp Stocks Above 50-Day Average              	INDEX     
TCOF.IDX  	TSX Comp Stocks Above 150-Day Average             	INDEX     
TCOH.IDX  	TSX Comp Stocks Above 100-Day Average             	INDEX     
TCTH.IDX  	TSX Comp Stocks Above 200-Day Average             	INDEX     
TCTW.IDX  	TSX Comp Stocks Above 20-Day Average              	INDEX     
TICK.IDX  	NYSE Tick                                         	INDEX     
TICX.IDX  	NYSE Tick                                         	INDEX     
TIKI.IDX  	DOW Tick                                          	INDEX     
TIKX.IDX  	DOW Tick                                          	INDEX     
TNX.IDX   	10-YEAR TREASURY NOTE                             	INDEX     
TOB.IDX   	AMEX Tobacco Index                                	INDEX     
TOOC.IDX  	Tsx Capped Composite Index                        	INDEX     
TPXR.IDX  	S&P C.S. Fl-Tampa Home Price Index                	INDEX     
TQCK.IDX  	NASD Tick                                         	INDEX     
TQCX.IDX  	NASD Tick                                         	INDEX     
TRA.IDX   	Nasdaq Transportation                             	INDEX     
TRCCI.IDX 	CRB Commodity Continuous Index                    	INDEX     
TRIA.IDX  	AMEX Trin                                         	INDEX     
TRIN.IDX  	NYSE Trin                                         	INDEX     
TRIQ.IDX  	NASD Trin                                         	INDEX     
TSFI.IDX  	TSX 60 Stocks Above 50-Day Average                	INDEX     
TSOF.IDX  	TSX 60 Stocks Above 150-Day Average               	INDEX     
TSOH.IDX  	TSX 60 Stocks Above 100-Day Average               	INDEX     
TSTH.IDX  	TSX 60 Stocks Above 200-Day Average               	INDEX     
TSTW.IDX  	TSX 60 Stocks Above 20-Day Average                	INDEX     
TSX.IDX   	TSX COMPOSITE INDEX                               	INDEX     
TTCD.IDX  	Tsx Consumer Discretionary Capped Index           	INDEX     
TTCS.IDX  	Tsx Consumer Staples Capped Index                 	INDEX     
TTEN.IDX  	Tsx Capped Energy Index                           	INDEX     
TTFS.IDX  	Tsx Financials Capped Index                       	INDEX     
TTGD.IDX  	Tsx Global Gold Index                             	INDEX     
TTHC.IDX  	Tsx Health Care Capped Index                      	INDEX     
TTIN.IDX  	Tsx Industrials Capped Index                      	INDEX     
TTMT.IDX  	Tsx Materials Capped Index                        	INDEX     
TTRE.IDX  	Tsx Real Estate Capped Index                      	INDEX     
TTTK.IDX  	Tsx Information Tech Capped Index                 	INDEX     
TTTS.IDX  	Tsx Telecom Services Capped Index                 	INDEX     
TTUT.IDX  	Tsx Utilities Capped Index                        	INDEX     
TVFI.IDX  	TSX Venture Stocks Above 50-Day Average           	INDEX     
TVOF.IDX  	TSX Venture Stocks Above 150-Day Average          	INDEX     
TVOH.IDX  	TSX Venture Stocks Above 100-Day Average          	INDEX     
TVTH.IDX  	TSX Venture Stocks Above 200-Day Average          	INDEX     
TVTW.IDX  	TSX Venture Stocks Above 20-Day Average           	INDEX     
TWII.IDX  	Taiwan Weighted Index                             	INDEX     
TXBE.IDX  	Tsx Global Base Metals Ew Index                   	INDEX     
TXBM.IDX  	Tsx Global Base Metals Index                      	INDEX     
TXCT.IDX  	Tsx Clean Technology Index                        	INDEX     
TXDC.IDX  	Tsx Composite Dividend Index                      	INDEX     
TXDE.IDX  	Tsx Diversified Banks Ew Index                    	INDEX     
TXDV.IDX  	Tsx Canadian Dividend Aristocrats Index           	INDEX     
TXEI.IDX  	Tsx Equity Income Index                           	INDEX     
TXEW.IDX  	Tsx 60 Equal Weight Index                         	INDEX     
TXFO.IDX  	Tsx Completion Index                              	INDEX     
TXGM.IDX  	Tsx Global Mining Index                           	INDEX     
TXOE.IDX  	Tsx Oil And Gas Ew Index                          	INDEX     
TXPR.IDX  	Tsx Preferred Share Index                         	INDEX     
TXSC.IDX  	Tsx 60 Capped Index                               	INDEX     
TXSI.IDX  	Tsx 60 Shariah Index                              	INDEX     
TXSX.IDX  	Tsx 60 Index                                      	INDEX     
TXTW.IDX  	Tsx Smallcap Index                                	INDEX     
TYX.IDX   	30-YEAR TREASURY BOND                             	INDEX     
UNCA.IDX  	AMEX Unchanged Stocks                             	INDEX     
UNCD.IDX  	OTC Unchanged Stocks                              	INDEX     
UNCE.IDX  	ETFS  Unchanged Stocks                            	INDEX     
UNCN.IDX  	NYSE Unchanged Stocks                             	INDEX     
UNCQ.IDX  	NASD Unchanged Stocks                             	INDEX     
UNCS.IDX  	TSX Unchanged Stocks                              	INDEX     
UNCT.IDX  	Total Unchanged Stocks                            	INDEX     
UNCV.IDX  	Tsxv Unchanged Stocks                             	INDEX     
UNCX.IDX  	CAD Total Unchanged Stocks                        	INDEX     
UOI.IDX   	US Oil Iopv                                       	INDEX     
UTY.IDX   	Phlx Utility Index                                	INDEX     
UVCA.IDX  	AMEX Unchanged Volume                             	INDEX     
UVCD.IDX  	OTC Unchanged Volume                              	INDEX     
UVCE.IDX  	ETFS  Unchanged Volume                            	INDEX     
UVCN.IDX  	NYSE Unchanged Volume                             	INDEX     
UVCQ.IDX  	NASD Unchanged Volume                             	INDEX     
UVCS.IDX  	TSX Unchanged Volume                              	INDEX     
UVCT.IDX  	Total Unchanged Volume                            	INDEX     
UVCV.IDX  	Tsxv Unchanged Volume                             	INDEX     
UVCX.IDX  	CAD Total Unchanged Volume                        	INDEX     
VFTSE.IDX 	FTSE Volatility Index                             	INDEX     
VFWA.IDX  	VOL Index First Forward Implied Volatility        	INDEX     
VFWB.IDX  	VOL Index Second Forward Implied Volatility       	INDEX     
VFY.IDX   	Mini Biotechnology Index                          	INDEX     
VGH.IDX   	Mini Pharmaceutical Index                         	INDEX     
VIO.IDX   	CBOE OIL INDEX REDUCED LEAP 199                   	INDEX     
VIX.IDX   	CBOE Volatility Index                             	INDEX     
VJW.IDX   	Mini Securities Broker Dealer In                  	INDEX     
VLA.IDX   	Value Line Index                                  	INDEX     
VLG.IDX   	Value Line Geometric                              	INDEX     
VVOL.IDX  	VOL Index Average Forward Implied Volatility      	INDEX     
VWA.IDX   	CBOE MARKET VOLATILITY -SPX ASK                   	INDEX     
VWB.IDX   	CBOE MARKET VOLATILITY -SPX BID                   	INDEX     
VXB.IDX   	JUMBO CBOE VOLATILITY INDEX                       	INDEX     
VXD.IDX   	CBOE DJIA VOLATILITY INDEX                        	INDEX     
VXDE.IDX  	DEC CBOE VOLATILITY INDEX                         	INDEX     
VXJU.IDX  	JUN CBOE VOLATILITY INDEX                         	INDEX     
VXMA.IDX  	MAR CBOE VOLATILITY INDEX                         	INDEX     
VXN.IDX   	CBOE NASDAQ Volatility Index                      	INDEX     
VXO.IDX   	CBOE OEX VOLATILITY INDEX                         	INDEX     
VXSE.IDX  	SEP CBOE VOLATILITY INDEX                         	INDEX     
VXV.IDX   	CBOE S&P 500 3M VOLATILITY INDEX                  	INDEX     
WDXR.IDX  	S&P C.S. Dc-Washington Home Price Index           	INDEX     
WIV.IDX   	Cboe/Cbot Wheat Volatility Index                  	INDEX     
WIX.IDX   	Cboe/Cbot Wheat Volatility Index                  	INDEX     
WMX.IDX   	ISE Walmart Suplr Index                           	INDEX     
XAL.IDX   	AMEX Airline Index                                	INDEX     
XAO.IDX   	XAO All Ordinaries                                	INDEX     
XAU.IDX   	Phlx Gold Silver Index                            	INDEX     
XAX.IDX   	AMEX Composite Index                              	INDEX     
XBD.IDX   	AMEX Securities Broker Dealer                     	INDEX     
XBEL.IDX  	Brussels BEL 20                                   	INDEX     
XBS.IDX   	AMEX Securities Broker/Dealer I                   	INDEX     
XCI.IDX   	AMEX Computers Index                              	INDEX     
XEO.IDX   	S& P 100 INDEX[EUROPEAN    STYLE                  	INDEX     
XFI.IDX   	Financial Ndx                                     	INDEX     
XHL.IDX   	Healthcare Ndx                                    	INDEX     
XIBX.IDX  	IBEX 35                                           	INDEX     
XID.IDX   	Industrial Ndx                                    	INDEX     
XII.IDX   	AMEX Institutional Index                          	INDEX     
XIT.IDX   	Info Tech Ndx                                     	INDEX     
XJO.IDX   	S&P/ASX 200                                       	INDEX     
XMI.IDX   	Major Market Index                                	INDEX     
XNA.IDX   	Nat Resource Ndx                                  	INDEX     
XNG.IDX   	AMEX Natural Gas Index                            	INDEX     
XOI.IDX   	AMEX Oil Index                                    	INDEX     
XSP.IDX   	S& P 500 MINI-SPX OPTIO    IND                    	INDEX     
XSV.IDX   	AMEX Institutional Index Open S                   	INDEX     
XTC.IDX   	AMEX North Ameican Telecom Index                  	INDEX     
XTV.IDX   	North American Telecommunicatio                   	INDEX     
XU100.IDX 	Borsa Istanbul 100 Index                          	INDEX     
ZAX.IDX   	ZACKS MICRO CAP INDEX                             	INDEX     
ZOC.IDX   	CBOE TECHNOLOGY INDEX REDUCED L                   	INDEX     
