AAL       	American Airlines Group Inc                       
AAME      	Atlantic American Corp                            
AAOI      	Applied Optoelectronics Inc                       
AAON      	Aaon Inc                                          
AAPC      	Atlantic Alliance Partnership Corp                
AAPL      	Apple Inc                                         
AAVL      	Avalanche Biotechnologies Inc                     
AAWW      	Atlas Air Worldwide Holdings                      
AAXJ      	All Country Asia Ex Jpn Idx MSCI Ishares          
ABAC      	Aoxin Tianli Group Inc                            
ABAX      	Abaxis Inc                                        
ABCB      	Ameris Bancorp                                    
ABCD      	Cambium Learning Group                            
ABCO      	The Advisory Board Company                        
ABCW      	Anchor Bancorp Wisconsin Inc                      
ABDC      	Alcentra Capital Corp                             
ABEO      	Abeona Therapeutics Inc                           
ABEOW     	Abeona Therapeutics Inc                           
ABGB      	Abengoa S.A.                                      
ABIO      	Arca Biopharma                                    
ABMD      	Abiomed                                           
ABTL      	Autobytel Inc                                     
ABTX      	Allegiance Bancshares Inc.                        
ABUS      	Arbutus Biopharma Corporation                     
ABY       	Abengoa Yield Plc                                 
ACAD      	Acadia Pharmaceuticals Inc                        
ACAS      	American Capital                                  
ACAT      	Arctic Cat Inc                                    
ACET      	Aceto Corp                                        
ACFC      	Atlantic Coast Federal Corp                       
ACGL      	Arch Capital Group Ltd                            
ACHC      	Acadia Healthcare Company Inc                     
ACHN      	Achillion Pharmaceuticals                         
ACIW      	Aci Worldwide                                     
ACLS      	Axcelis Technologies                              
ACNB      	Acnb Corp                                         
ACOR      	Acorda Therapeutics                               
ACPW      	Active Power                                      
ACRS      	Aclaris Therapeutics Inc.                         
ACRX      	Acelrx Pharmaceuticals                            
ACSF      	American Capital Senior Floatin                   
ACST      	Acasti Pharma Inc                                 
ACTA      	Actua Corporation                                 
ACTG      	Acacia Research Corp                              
ACTS      	Actions Semiconductor Co                          
ACTX      	Global X Guru Activist Index ETF                  
ACUR      	Acura Pharmaceuticals                             
ACWI      	ACWI Index MSCI Ishares                           
ACWX      	ACWI Ex-US Index MSCI Ishares                     
ACXM      	Acxiom Corp                                       
ADAP      	Adaptimmune Ltd                                   
ADAT      	Authentidate Holding                              
ADBE      	Adobe Systems Incorporated                        
ADEP      	Adept Technology                                  
ADHD      	Alcobra Ltd                                       
ADI       	Analog Devices                                    
ADMA      	Adma Biologics                                    
ADMP      	Adamis Pharmaceuticl                              
ADMS      	Adamas Pharmaceuticals Inc                        
ADP       	Automatic Data Processing                         
ADRA      	Asia 50 ADR Index Bldrs                           
ADRD      	Dev Mkts 100 ADR Index Bldrs                      
ADRE      	Emrg Mkts 50 ADR Index Bldrs                      
ADRO      	Aduro Biotech Inc                                 
ADRU      	Europe 100 ADR Index Bldrs                        
ADSK      	Autodesk Inc                                      
ADTN      	Adtran Inc                                        
ADUS      	Addus Homecare Corp                               
ADXS      	Advaxis Inc                                       
ADXSW     	Advaxis Inc                                       
AEGN      	Aegoin Corp                                       
AEGR      	Aegerion Pharmaceuticals                          
AEHR      	Aehr Test Systems                                 
AEIS      	Advanced Energy Industries                        
AEMD      	Aethlon Medical Inc                               
AEPI      	AEP Industries Inc                                
AERI      	Aerie Pharmaceuticals Inc                         
AETI      	American Electric Technologies                    
AEY       	Addvantage Technologies Group                     
AEZS      	Aeterna Zentaris                                  
AFAM      	Almost Family Inc                                 
AFCB      	Athens Bancshares Corp                            
AFFX      	Affymetrix                                        
AFH       	Atlas Financial Holdings Inc                      
AFMD      	Affimed Therapeutics B.V                          
AFOP      	Alliance Fiber Optic Products                     
AFSI      	Amtrust Financial Services                        
AGEN      	Agenus Inc                                        
AGFS      	Agrofresh Solutions Inc                           
AGFSW     	Agrofresh Solutions Inc                           
AGII      	Argo Group International Holdings Ltd             
AGIIL     	Argo Group International Holdin                   
AGIO      	Agios Pharmaceuticals Inc                         
AGNC      	American Capital Agency                           
AGNCB     	American Capital Agency Corp                      
AGNCP     	American Capital                                  
AGND      	Wisdomtree Barclays U.S. Aggreg                   
AGRX      	Agile Therapeutics Inc                            
AGTC      	Applied Genetic Technologies Co                   
AGYS      	Agilysys Inc                                      
AGZD      	Wisdomtree Barclays U.S. Aggreg                   
AHGP      	Alliance Holdings Gp L.P.                         
AHPI      	Allied Healthcare Products                        
AIMC      	Altra Holdings                                    
AIMT      	Aimmune Therapeutics Inc                          
AINV      	Apollo Investment Corp                            
AIQ       	Alliance Healthcare Services                      
AIRM      	Air Methods Corp                                  
AIRR      	First Trust Rba American Indust                   
AIRT      	Air T Inc                                         
AIXG      	Aixtron Se                                        
AKAM      	Akamai Technologies                               
AKAO      	Achaogen Inc                                      
AKBA      	Akebia Therapeutics Inc                           
AKER      	Akers Biosciences                                 
AKRX      	Akorn Inc                                         
AKTX      	Akari Therapeutics Plc                            
ALCO      	Alico Inc                                         
ALDR      	Alder Biopharmaceuticals Inc                      
ALDX      	Aldeyra Therapeutics Inc                          
ALGN      	Align Technology                                  
ALGT      	Allegiant Travel Company                          
ALIM      	Alimera Sciences                                  
ALKS      	Alkermes Plc                                      
ALLB      	Alliance Bank                                     
ALLT      	Allot Communications Ltd                          
ALNY      	Alnylam Pharmaceuticals                           
ALOG      	Analogic Corp                                     
ALOT      	Astro-Med                                         
ALQA      	Alliqua Inc                                       
ALRM      	Alarm.Com Holdings Inc                            
ALSK      	Alaska Communications Systems                     
ALTR      	Altera Corp                                       
ALTY      	Global X Superdividend Alternatives ETF           
ALXA      	Alexza Pharmaceuticals                            
ALXN      	Alexion Pharmaceuticals                           
AMAG      	Amag Pharmaceuticals                              
AMAT      	Applied Materials                                 
AMBA      	Ambarella Inc                                     
AMBC      	Ambac Financial Group Inc                         
AMBCW     	Ambac Financial Group Inc                         
AMCC      	Applied Micro Circuits Corp                       
AMCN      	Airmedia Group Inc                                
AMCX      	Amc Networks Inc                                  
AMD       	Advanced Micro Devices                            
AMDA      	Amedica Corp                                      
AMED      	Amedisys Inc                                      
AMGN      	Amgen Inc                                         
AMIC      	American Independence                             
AMKR      	Amkor Technology                                  
AMNB      	American National Bankshares                      
AMOT      	Allied Motion Technologies                        
AMOV      	America Movil S.A.B. De C.V                       
AMPH      	Amphastar Pharmaceuticals Inc                     
AMRB      	American River Bankshares                         
AMRI      	Albany Molecular Research                         
AMRK      	A-Mark Precious Metals Inc                        
AMRN      	Amarin Corporation Plc                            
AMRS      	Amyris Inc                                        
AMSC      	American Superconductor Corp                      
AMSF      	Amerisafe Inc                                     
AMSG      	Amsurg Corp                                       
AMSGP     	Amsurg Corp                                       
AMSWA     	American Software                                 
AMTX      	Aemetis Inc                                       
AMWD      	American Woodmark Corp                            
AMZN      	Amazon.Com Inc                                    
ANAC      	Anacor Pharmaceuticals                            
ANAD      	Anadigics Inc                                     
ANAT      	American National Insurance                       
ANCB      	Anchor Bancorp                                    
ANCX      	Access National Corp                              
ANDE      	The Andersons                                     
ANGI      	Angie's List Inc                                  
ANGO      	Angiodynamics                                     
ANIK      	Anika Therapeutics Inc                            
ANIP      	ANI Pharmaceuticals Inc                           
ANSS      	Ansys Inc                                         
ANTH      	Anthera Pharmaceuticals                           
ANY       	Sphere 3D Corp                                    
AOSL      	Alpha and Omega Semiconductor                     
APDN      	Applied Dna Sciences                              
APDNW     	Applied Dna Sciences Inc                          
APEI      	American Public Education                         
APIC      	Apigee Corp                                       
APOG      	Apogee Enterprises                                
APOL      	Apollo Group                                      
APPF      	Appfolio Inc                                      
APPS      	Digital Turbine Inc                               
APPY      	Aspenbio Pharma                                   
APRI      	Apricus Biosciences Inc                           
APTO      	Aptose Biosciences Inc                            
APWC      	Asia Pac Wire &Cable                              
AQMS      	Aqua Metals Inc                                   
AQXP      	Aquinox Pharmaceuticals Inc                       
ARAY      	Accuray Incorporated                              
ARCB      	Arcbest Corp                                      
ARCC      	Ares Capital Corp                                 
ARCI      	Appliance Recycling Centers                       
ARCW      	Arc Group Worldwide Inc                           
ARDM      	Aradigm Corp                                      
ARDX      	Ardelyx Inc                                       
AREX      	Approach Resources Inc                            
ARGS      	Argos Therapeutics Inc                            
ARIA      	Ariad Pharmaceuticals                             
ARII      	American Railcar Industries                       
ARIS      	Ari Network Svcs                                  
ARKR      	Ark Restaurants                                   
ARLP      	Alliance Resource Partners L.P.                   
ARMH      	Arm Holdings Plc                                  
ARNA      	Arena Pharmaceuticals                             
AROW      	Arrow Financial Corp                              
ARQL      	Arqule Inc                                        
ARRS      	Arris Group Inc                                   
ARRY      	Array Biopharma Inc                               
ARTNA     	Artesian Resources Corp                           
ARTW      	Art's Way Manufacturing Co                        
ARTX      	Arotech Corp                                      
ARWA      	Arowana Inc                                       
ARWAU     	Arowana Inc                                       
ARWR      	Arrowhead Research Corp                           
ASBB      	Asb Bancorp Inc                                   
ASBI      	Ameriana Bancorp                                  
ASCMA     	Ascent Media Corp                                 
ASEI      	American Science and Engineering                  
ASFI      	Asta Funding                                      
ASMB      	Assembly Biosciences Inc                          
ASML      	Asml Holding N.V.                                 
ASNA      	Ascena Retail Group                               
ASND      	Ascendis Pharma A/S                               
ASPS      	Altisource Portfolio Solutions S.A.               
ASRV      	Ameriserv Financial Inc                           
ASRVP     	Ameriserv Financial Inc                           
ASTC      	Astrotech Corp                                    
ASTE      	Astec Industries                                  
ASTI      	Ascent Solar Technologies                         
ASUR      	Asure Software Inc                                
ASYS      	Amtech Systems                                    
ATAI      	Ata Inc                                           
ATAX      	America First Tax Exempt L.P.                     
ATEC      	Alphatec Holdings                                 
ATHN      	Athenahealth                                      
ATHX      	Athersys                                          
ATLC      	Atlanticus Holdings Corp                          
ATLO      	Ames National Corp                                
ATML      	Atmel Corp                                        
ATNI      	Atlantic Tele-Network                             
ATNY      	Api Technologies                                  
ATOS      	Atossa Genetics Inc                               
ATRA      	Atara Biotherapeutics Inc                         
ATRC      	Atricure                                          
ATRI      	Atrion Corp                                       
ATRM      	Aetrium Inc                                       
ATRO      	Astronics Corp                                    
ATRS      	Antares Pharma                                    
ATSG      	Air Transport Services Group Inc                  
ATTU      	Attunity Ltd                                      
ATVI      	Activision Blizzard Inc                           
AUBN      	Auburn National Bancorporation                    
AUDC      	Audiocodes Ltd                                    
AUMA      	Ar Capital Acquisition Corp                       
AUMAU     	Ar Capital Acquisition                            
AUMAW     	Ar Capital Acquisition Corp                       
AUPH      	Aurinia Pharmaceuticals Inc                       
AVAV      	Aerovironment                                     
AVEO      	Aveo Pharmaceuticals                              
AVGO      	Avago Technologies                                
AVGR      	Avinger Inc                                       
AVHI      	Av Homes Inc                                      
AVID      	Avid Technology                                   
AVNU      	Avenue Financial Holdings Inc                     
AVNW      	Aviat Networks                                    
AVXL      	Anavex Life Sciences                              
AWAY      	Homeaway Inc                                      
AWRE      	Aware Inc                                         
AXAS      	Abraxas Petroleum Corp                            
AXDX      	Accelerate Diagnostics Inc                        
AXGN      	Axogen Inc                                        
AXPW      	Axion Power Intl Inc                              
AXPWW     	Axion Power International Inc                     
AXTI      	Axt Inc                                           
AYA       	Amaya Inc                                         
AZPN      	Aspen Technology                                  
BABY      	Natus Medical Inc                                 
BAGR      	Diversified Restaurant Holdings Inc               
BAMM      	Books-A-Million                                   
BANF      	Bancfirst Corp                                    
BANFP     	Bancfirst Corp                                    
BANR      	Banner Corp                                       
BANX      	Stonecastle Financial Corporati                   
BASI      	Bioanalytical Systems                             
BBBY      	Bed Bath & Beyond Inc                             
BBC       	Bioshares Biotechnology Clinica                   
BBCN      	Bbcn Bancorp Inc                                  
BBEP      	Breitburn Energy Partners L.P.                    
BBEPP     	Breitburn Energy Partners L.P.                    
BBGI      	Beasley Broadcast Group                           
BBLU      	Blue Earth Incorporated                           
BBOX      	Black Box Corp                                    
BBP       	Bioshares Biotechnology Product                   
BBRG      	Bravo Brio Restaurant Group                       
BBRY      	Blackberry Ltd                                    
BBSI      	Barrett Business Services                         
BCBP      	Bcb Bancorp Inc. [Nj]                             
BCLI      	Brainstorm Cell Ther                              
BCOM      	B Communications Ltd                              
BCOR      	Blucora Inc                                       
BCOV      	Brightcove Inc                                    
BCPC      	Balchem Corp                                      
BCRX      	Biocryst Pharmaceuticals                          
BDBD      	Boulder Brands Inc                                
BDCV      	Bdca Venture Inc                                  
BDE       	Black Diamond                                     
BDGE      	Bridge Bancorp                                    
BDMS      	Birner Dental Management Services                 
BDSI      	Biodelivery Sciences International                
BEAT      	Cardionet                                         
BEAV      	BE Aerospace                                      
BEBE      	Bebe Stores                                       
BECN      	Beacon Roofing Supply                             
BELFA     	Bel Fuse Inc                                      
BELFB     	Bel Fuse Inc                                      
BFIN      	Bankfinancial Corp                                
BGCP      	Bgc Partners                                      
BGFV      	Big 5 Sporting Goods Corp                         
BHAC      	Barington/Hilco Acquisition Corp                  
BHACU     	Barington/Hilco Acquisition Cor                   
BHBK      	Blue Hills Bancorp Inc                            
BIB       	Ultra Nasdaq Biotechnology Proshares              
BICK      	BICK Index First Trust                            
BIDU      	Baidu Inc                                         
BIIB      	Biogen Idec Inc                                   
BIND      	Bind Therapeutics Inc                             
BIOC      	Biocept Inc                                       
BIOD      	Biodel Inc                                        
BIOL      	Biolase Technology                                
BIOS      	Bioscrip Inc                                      
BIS       	Ultrashort Nasdaq Biotech Proshares               
BITI      	Biotie Therapies Corp                             
BJRI      	Bj's Restaurants                                  
BKCC      	Blackrock Kelso Capital Corp                      
BKEP      	Blueknight Energy                                 
BKEPP     	Blueknight Energy Partners L.P.                   
BKMU      	Bank Mutual Corp                                  
BKSC      	Bank of South Carolina                            
BLBD      	Blue Bird Corp                                    
BLCM      	Bellicum Pharmaceuticals Inc                      
BLDP      	Ballard Power Systems                             
BLDR      	Builders Firstsource                              
BLFS      	Biolife Solutions                                 
BLIN      	Bridgeline Digital                                
BLKB      	Blackbaud Inc                                     
BLMN      	Bloomin' Brands Inc                               
BLMT      	Bsb Bancorp Inc                                   
BLPH      	Bellerophon Therapeutics Llc                      
BLRX      	Biolinerx Ltd                                     
BLUE      	Bluebird Bio Inc                                  
BLVDU     	Boulevard Acquisition Corp                        
BMRC      	Bank of Marin Bancorp                             
BMRN      	Biomarin Pharmaceutical Inc                       
BMTC      	Bryn Mawr Bank Corp                               
BNCL      	Beneficial Mutual Bancorp                         
BNCN      	BNC Bancorp                                       
BNDX      	Vanguard Total International Bo                   
BNFT      	Benefitfocus Inc                                  
BNSO      	Bonso Electronics International                   
BNTC      	Benitec Biopharma Ltd.                            
BNTCW     	Benitec Biopharma Limited                         
BOBE      	Bob Evans Farms                                   
BOCH      	Bank of Commerce Holdings [Ca]                    
BOFI      	Bofi Holding                                      
BOJA      	Bojangles' Inc                                    
BOKF      	Bok Financial Corp                                
BONA      	Bona Film Group Ltd                               
BONT      	The Bon-Ton Stores                                
BOOM      	Dynamic Materials Corp                            
BOSC      	B.O.S. Better Online Solutions                    
BOTA      	Biota Pharmaceuticals Inc                         
BOTJ      	Bank of The Jame Fnl                              
BPFH      	Boston Private Financial Holdings                 
BPFHP     	Boston Private Financial Holdings Inc. Dep        
BPFHW     	Boston Private Financial Holdings                 
BPMC      	Blueprint Medicines Corp                          
BPOP      	Popular Inc                                       
BPOPM     	Popular Inc                                       
BPOPN     	Popular Inc                                       
BPTH      	Bio-Path Holdings                                 
BRCD      	Brocade Communications Systems                    
BRCM      	Broadcom Corp                                     
BREW      	Craft Brewers Alliance Inc                        
BRID      	Bridgford Foods Corp                              
BRKL      	Brookline Bancorp                                 
BRKR      	Bruker Corp                                       
BRKS      	Brooks Automation                                 
BSET      	Bassett Furniture Industries Inc                  
BSF       	Bear State Financial Inc                          
BSFT      	Broadsoft Inc                                     
BSPM      	Biostar Pharmaceuticals                           
BSQR      	Bsquare Corp                                      
BSRR      	Sierra Bancorp                                    
BSTC      	Biospecifics Technologies Corp                    
BUFF      	Blue Buffalo Pet Products                         
BUR       	Burcon Nutrascience                               
BUSE      	First Busey Corp                                  
BV        	Bazaarvoice Inc                                   
BVA       	Cordia Bancorp Inc                                
BVSN      	Broadvision                                       
BVXV      	Biondvax Pharmaceuticals Ltd                      
BWEN      	Broadwind Energy                                  
BWFG      	Bankwell Financial Group Inc                      
BWINA     	Baldwin & Lyons                                   
BWINB     	Baldwin & Lyons                                   
BWLD      	Buffalo Wild Wings                                
BYBK      	Bay Bancorp Inc                                   
BYFC      	Broadway Financial Corp                           
BYLK      	Baylake Corp                                      
BZUN      	Baozun Inc                                        
CA        	CA Inc                                            
CAAS      	China Automotive Systems                          
CAC       	Camden National Corp                              
CACB      	Cascade Bancorp                                   
CACC      	Credit Acceptance Corp                            
CACQ      	Caesars Acquisition Company                       
CADC      	China Advanced Construction                       
CADT      	Dt Asia Investments Ltd                           
CADTR     	Dt Asia Investments Ltd                           
CADTU     	Dt Asia Investments Ltd                           
CADTW     	Dt Asia Investments Ltd                           
CAFD      	8Point3 Energy Partners LP                        
CAKE      	The Cheesecake Factory Inc                        
CALA      	Calithera Biosciences Inc                         
CALD      	Callidus Software                                 
CALI      	China Auto Logistics Inc                          
CALL      	Vocaltec Communications Ltd                       
CALM      	Cal-Maine Foods                                   
CAMB      	Cambridge Capital Acquisition C                   
CAMBU     	Cambridge Capital Acquisition                     
CAMBW     	Cambridge Capital Acquisition C                   
CAMP      	Calamp Corp                                       
CAMT      	Camtek Ltd                                        
CAPN      	Capnia Inc                                        
CAPNW     	Capnia Inc                                        
CAPR      	Capricor Therapeutics Inc                         
CAPX      	Elkhorn S&P 500 Capital Expendi                   
CAR       	Avis Budget Group                                 
CARA      	Cara Therapeutics Inc                             
CARB      	Carbonite Inc                                     
CARO      	Carolina Financial                                
CART      	Carolina Trust Bank                               
CARV      	Carver Bancorp                                    
CARZ      	Nasdaq Global Auto Index First Trust              
CASH      	Meta Financial Group                              
CASI      	Casi Pharmaceuticals Inc                          
CASM      	Cas Medical Systems                               
CASS      	Cass Information Systems Inc                      
CASY      	Caseys General Stores                             
CATB      	Catabasis Pharmaceuticals Inc                     
CATM      	Cardtronics Inc                                   
CATY      	Cathay General Bancorp                            
CATYW     	Cathay General Bancorp                            
CAVM      	Cavium Inc                                        
CBAK      	China Bak Battery                                 
CBAN      	Colony Bankcorp                                   
CBAY      	Cymabay Therapeutics                              
CBF       	Capital Bank Financial Corp                       
CBFV      	Cb Financial Services Inc                         
CBIO      	Catalyst Biosciences Inc.                         
CBLI      	Cleveland Biolabs                                 
CBMG      	Cellular Biomedicine Group Inc                    
CBMX      	Combimatrix Corp                                  
CBNJ      	Cape Bancorp                                      
CBNK      	Chicopee Bancorp                                  
CBOE      	CBOE Holdings                                     
CBPO      	China Biologic Products                           
CBRL      	Cracker Barrel Old Country Store                  
CBSH      	Commerce Bancshares                               
CBSHP     	Commerce Bancshares Inc                           
CBYL      	Carbylan Therapeutics Inc                         
CCBG      	Capital City Bank Group                           
CCCL      	China Ceramics Co. Ltd                            
CCCR      	China Commercial Credit Inc                       
CCD       	Calamos Dynamic Convertible and Income Fund       
CCIH      	Chinacache International                          
CCLP      	Csi Compressco LP                                 
CCMP      	Cabot Microelectronics Corp                       
CCNE      	Cnb Financial Corp                                
CCOI      	Cogent Communications Group                       
CCRN      	Cross Country Healthcare                          
CCUR      	Concurrent Computer Corp                          
CCXI      	Chemocentryx Inc                                  
CDC       	Compass Emp US Eqincome 100 Enh                   
CDK       	Cdk Global Inc                                    
CDL       	Compass Emp US Large Cap High D                   
CDNA      	Caredx Inc                                        
CDNS      	Cadence Design Systems                            
CDOR      	Condor Hospitality Trust Inc                      
CDORO     	Condor Hospitality Trust Inc                      
CDORP     	Condor Hospitality Trust Inc                      
CDRB      	Code Rebel Corp                                   
CDTI      	Clean Diesel Technologies                         
CDTX      	Cidara Therapeutics Inc                           
CDW       	CDW Corp                                          
CDXS      	Codexis Inc                                       
CDZI      	Cadiz Inc                                         
CECE      	Ceco Environmental                                
CECO      	Career Education Corp                             
CELG      	Celgene Corp                                      
CELGZ     	Celgene Corp                                      
CEMI      	Chembio Diagnostics                               
CEMP      	Cempra Inc                                        
CENT      	Central Garden & Pet Company                      
CENTA     	Central Garden & Pet Company                      
CENX      	Century Aluminum Company                          
CERE      	Ceres Inc                                         
CERN      	Cerner Corp                                       
CERS      	Cerus Corp                                        
CERU      	Cerulean Pharma Inc                               
CETC      	Hongli Clean Energy Technologies Corp             
CETV      	Central European Media Enterprises                
CETX      	Cemtrex Inc                                       
CEVA      	Ceva Inc                                          
CFA       	Compass Emp U.S. 500 Volatility                   
CFBK      	Central Federal Corp                              
CFFI      	C&F Financial Corp                                
CFFN      	Capitol Federal Financial                         
CFGE      	Calamos Focus Growth ETF                          
CFMS      	Conformis Inc                                     
CFNB      	California First National Bancorp                 
CFNL      	Cardinal Financial Corp                           
CFO       	Compass Emp U.S. 500 Enhanced V                   
CFRX      	Contrafect Corporation                            
CFRXW     	Contrafect Corporation                            
CFRXZ     	Contrafect Corporation                            
CG        	The Carlyle Group L.P.                            
CGEN      	Compugen Ltd                                      
CGIX      	Cancer Genetics Inc                               
CGNT      	Cogentix Medical Inc                              
CGNX      	Cognex Corp                                       
CGO       	Calamos Global Total Return Fund                  
CHCI      	Comstock Homebuilding Companies                   
CHCO      	City Holding Company                              
CHDN      	Churchill Downs Inc                               
CHEF      	The Chefs' Warehouse Inc                          
CHEK      	Check-Cap Ltd                                     
CHEV      	Cheviot Financial Corp                            
CHFC      	Chemical Financial Corp                           
CHFN      	Charter Financial                                 
CHI       	Calamos Convertible Opportunities                 
CHKE      	Cherokee Inc                                      
CHKP      	Check Point Software Technologies Ltd             
CHLN      	China Housing & Land Development                  
CHMA      	Chiasma Inc                                       
CHMG      	Chemung Financial Corp                            
CHNR      	China Natural Resources                           
CHOP      	China Gerui Advanced Materials                    
CHRS      	Coherus Biosciences Inc                           
CHRW      	C.H. Robinson Worldwide                           
CHSCL     	CHS Inc                                           
CHSCM     	CHS Inc                                           
CHSCN     	CHS Inc                                           
CHSCO     	CHS Inc Cl B Pfd                                  
CHSCP     	CHS Inc                                           
CHTR      	Charter Communications                            
CHUY      	Chuy's Holding Inc                                
CHW       	Calamos Global Dynamic                            
CHY       	Calamos Convertible and High                      
CIBR      	First Trust Nasdaq Cea Cyberseccibr Summary For   
CID       	Compass Emp International High                    
CIDM      	Cinedigm Digital Cinema Corp                      
CIFC      	Cifc Corp                                         
CIGI      	Colliers International Group Inc                  
CIL       	Compass Emp International 500 V                   
CINF      	Cincinnati Financial Corp                         
CISG      	Cninsure Inc                                      
CIVB      	Civista Bancshares Inc                            
CIVBP     	Civista Bancshares Inc                            
CIZ       	Compass Emp International 500 E                   
CIZN      	Citizens Holding Company                          
CJJD      	China Jo-Jo Drugstores                            
CKEC      	Carmike Cinemas                                   
CLACU     	Capitol Acquisition Corp. III                     
CLBH      	Carolina Bank Holdings Inc                        
CLBS      	Caladrius Biosciences Inc                         
CLCD      	Colucid Pharmaceuticals Inc                       
CLCT      	Collectors Universe                               
CLDN      	Celladon Corp                                     
CLDX      	Celldex Therapeutics Inc                          
CLFD      	Clearfield                                        
CLIR      	Clearsign Combustion Corporatio                   
CLLS      	Cellectis S.A.                                    
CLMS      	Calamos Asset Management                          
CLMT      	Calumet Specialty Products                        
CLNE      	Clean Energy Fuels                                
CLNT      	Cleantech Solutions International Inc             
CLRB      	Cellectar Biosciences Inc                         
CLRBW     	Cellectar Biosciences Inc                         
CLRO      	Clearone Communications Inc                       
CLRX      	Collabrx Inc                                      
CLSN      	Celsion Corp                                      
CLUB      	Town Sports International Holdings                
CLVS      	Clovis Oncology Inc                               
CLWT      	Euro Tech Holdings Company                        
CMCO      	Columbus Mckinnon Corp                            
CMCSA     	Comcast Corp                                      
CMCSK     	Comcast Corp                                      
CMCT      	Cim Commercial Trust Corp                         
CME       	CME Group Inc                                     
CMFN      	Cm Finance Inc                                    
CMLS      	Cumulus Media Inc                                 
CMPR      	Cimpress N.V.                                     
CMRX      	Chimerix Inc                                      
CMTL      	Comtech Telecommunications                        
CNAT      	Conatus Pharmaceuticals Inc                       
CNBKA     	Century Bancorp                                   
CNCE      	Concert Pharmaceuticals Inc                       
CNCR      	ETF Series Solutions - Loncar Cancer Immunothera  
CNET      	Chinanet Online Holdings                          
CNFR      	Conifer Holdings Inc.                             
CNIT      	China Information Technology                      
CNLM      	Cb Pharma Acquisition Corp                        
CNLMR     	Cb Pharma Acquisition Corp. - R                   
CNLMU     	Cb Pharma Acquisition Corp                        
CNMD      	Conmed Corp                                       
CNOB      	Connectone Bancorp Inc                            
CNSL      	Consolidated Communications Holdings              
CNTF      	China Techfaith Wireless                          
CNTY      	Century Casinos                                   
CNV       	Cnova N.V.                                        
CNXR      	Connecture Inc                                    
CNYD      	China Yida Holding Co                             
COB       	Community One Bancorp                             
COBZ      	Cobiz Financial Inc                               
COHR      	Coherent Inc                                      
COHU      	Cohu Inc                                          
COKE      	Coca-Cola Bottling Co. Consolidated               
COLB      	Columbia Banking System                           
COLL      	Collegium Pharmaceutical Inc                      
COLM      	Columbia Sportswear Company                       
COMM      	Commscope Holding Company Inc                     
COMT      	Ishares Commodities Select Stra                   
CONE      	Cyrusone Inc                                      
CONN      	Conn's Inc                                        
COOL      	Majesco Entertainment Company                     
CORE      	Core-Mark Holding Company                         
CORI      	Corium International Inc                          
CORT      	Corcept Therapeutics Inc                          
COSI      	Cosi Inc                                          
COST      	Costco Wholesale Corp                             
COVS      	Covisint Corp                                     
COWN      	Cowen Group                                       
COWNL     	Cowen Group Inc                                   
CPAH      	Counterpath Corp                                  
CPHC      	Canterbury Park Holding Corp                      
CPHD      	Cepheid                                           
CPHR      	Cipher Pharmaceuticals Inc                        
CPIX      	Cumberland Pharmaceuticals Inc                    
CPLA      	Capella Education Company                         
CPLP      	Capital Product Partners L.P.                     
CPRT      	Copart Inc                                        
CPRX      	Catalyst Pharmaceutical Partners                  
CPSH      	Cps Technologies Cp                               
CPSI      	Computer Programs and Systems                     
CPSS      	Consumer Portfolio Services                       
CPST      	Capstone Turbine Corp                             
CPTA      	Capitala Finance Corp                             
CPXX      	Celator Pharma                                    
CRAI      	Cra Internationalinc                              
CRAY      	Cray Inc                                          
CRBP      	Corbus Pharmaceutica                              
CRDC      	Cardica Inc                                       
CRDS      	Crossroads Systems                                
CRDT      	Wisdomtree Trust                                  
CREE      	Cree Inc                                          
CREG      	China Recycling Energy Corp                       
CRESY     	Cresud S.A.C.I.F. Y A                             
CRIS      	Curis Inc                                         
CRME      	Cardiome Pharma Corp                              
CRMT      	America's Car-Mart                                
CRNT      	Ceragon Networks Ltd                              
CROX      	Crocs Inc                                         
CRTN      	Cartesian Inc                                     
CRTO      	Criteo S.A.                                       
CRUS      	Cirrus Logic                                      
CRVL      	Corvel Corp                                       
CRWN      	Crown Media Holdings                              
CRWS      	Crown Crafts                                      
CRZO      	Carrizo Oil & Gas                                 
CSA       	Compass Emp US Small Cap 500 Vo                   
CSAL      	Communications Sales and Leasing Inc              
CSB       	Compass Emp US Small Cap High D                   
CSBK      	Clifton Savings Bancorp                           
CSBR      	Champions Biotechnlg                              
CSCD      	Cascade Microtech                                 
CSCO      	Cisco Systems                                     
CSF       	Compass Emp U.S. Discovery 500                    
CSFL      	Centerstate Banks                                 
CSGP      	Costar Group                                      
CSGS      	Csg Systems International                         
CSII      	Cardiovascular Systems                            
CSIQ      	Canadian Solar Inc                                
CSOD      	Cornerstone Ondemand Inc                          
CSPI      	Csp Inc                                           
CSQ       	Calamos Strategic Total Return Fund               
CSTE      	Caesarstone Sdot-Yam Ltd                          
CSUN      	China Sunergy Co                                  
CSWC      	Capital Southwest Corp                            
CSWI      	Csw Industrials Inc.                              
CTAS      	Cintas Corp                                       
CTBI      	Community Trust Bancorp                           
CTCM      	Ctc Media                                         
CTCT      	Constant Contact                                  
CTG       	Computer Task Group Inc                           
CTHR      	Charles & Colvard Ltd                             
CTIB      	Cti Industries Corp                               
CTIC      	Cell Therapeutics                                 
CTMX      	Cytomx Therapeutics Inc.                          
CTRE      	Caretrust REIT Inc                                
CTRL      	Control4 Corp                                     
CTRN      	Citi Trends                                       
CTRP      	Ctrip.Com International                           
CTRV      	Contravir Pharmaceut                              
CTSH      	Cognizant Technology Solutions                    
CTSO      	Cytosorbents Cor                                  
CTWS      	Connecticut Water Service                         
CTXS      	Citrix Systems                                    
CU        	ISE Global Copper Index First Trust               
CUBA      	The Herzfeld Caribbean Basin Fund                 
CUBN      	Commerce Union Bk Tn                              
CUI       	Cui Global Inc                                    
CUNB      	California United Bk                              
CUR       	Neuralstem                                        
CUTR      	Cutera Inc                                        
CVBF      	Cvb Financial Corp                                
CVCO      	Cavco Industries                                  
CVCY      	Central Valley Community Bancorp                  
CVGI      	Commercial Vehicle Group                          
CVGW      	Calavo Growers                                    
CVLT      	Commvault Systems                                 
CVLY      	Codorus Valley Bancorp Inc                        
CVTI      	Covenant Transportation Group                     
CVV       	CVD Equipment Corp                                
CWAY      	Coastway Bancorp Inc                              
CWBC      	Community West Bancshares                         
CWCO      	Consolidated Water Co. Ltd                        
CWST      	Casella Waste Systems                             
CXDC      	China Xd Plastics Company                         
CXRX      	Concordia Healthcare                              
CXSE      	Wisdomtree Trust                                  
CY        	Cypress Semiconductor Corp                        
CYAD      	Celyad Sa                                         
CYAN      	Cyanotech Corp                                    
CYBE      	Cyberoptics Corp                                  
CYBR      	Cyberark Software Ltd                             
CYBX      	Cyberonics Inc                                    
CYCC      	Cyclacel Pharmaceuticals                          
CYCCP     	Cyclacel Pharmaceuticals                          
CYHHZ     	Community Health Systems Inc                      
CYNA      	Cynapsus Therapeutic                              
CYNO      	Cynosure Inc                                      
CYOU      	Changyou.Com Ltd                                  
CYRN      	Cyren Ltd                                         
CYRX      	Cryoport Inc                                      
CYRXW     	Cryoport Inc. Warrants                            
CYTK      	Cytokinetics Inc                                  
CYTR      	Cytrx Corp                                        
CYTX      	Cytori Therapeutics Inc                           
CZFC      	Citizens First Corp                               
CZNC      	Citizens & Northern Corp                          
CZR       	Caesars Entertainment Corporati                   
CZWI      	Citizens Community Bancorp                        
DAEG      	Unify Corp                                        
DAIO      	Data I/O Corp                                     
DAKT      	Daktronics                                        
DARA      	Dara Biosciences                                  
DATE      	Jiayuan.Com International Ltd                     
DAVE      	Famous Dave's of America                          
DAX       	Recon Capital DAX Germany ETF                     
DBVT      	Dbv Technologies S.A.                             
DCIX      	Diana Containerships Inc                          
DCOM      	Dime Community Bancshares                         
DCTH      	Delcath Systems                                   
DELT      	Delta Technology Holdings Ltd                     
DELTW     	Delta Technology Holdings Ltd                     
DENN      	Denny's Corp                                      
DEPO      	Depomed Inc                                       
DERM      	Dermira Inc                                       
DEST      	Destination Maternity Corp                        
DFRG      	Del Frisco's Restaurant Group Llc                 
DFVL      	Ipath US Treasury 5 Year Bull E                   
DFVS      	US Trsy 5-Year Bear ETN Ipath                     
DGAS      	Delta Natural Gas Company                         
DGICA     	Donegal Group                                     
DGICB     	Donegal Group                                     
DGII      	Digi International Inc                            
DGLD      	3X Inverse Gold ETN Velocityshares                
DGLY      	Digital Ally                                      
DGRE      	Wisdomtree Emerging Markets Dividend              
DGRS      	Wisdomtree U.S. Smallcap Dividend                 
DGRW      	Wisdomtree U.S. Dividend Growth                   
DHIL      	Diamond Hill Investment Group                     
DHRM      	Dehaier Medical Systems                           
DHXM      	Dhx Media Ltd                                     
DIOD      	Diodes Inc                                        
DISCA     	Discovery Communications Inc                      
DISCB     	Discovery Communications Inc                      
DISCK     	Discovery Communications Inc                      
DISH      	Dish Network Corp                                 
DJCO      	Daily Journal Corp. [S.C.]                        
DLBL      	US Trsy Long Bond Bull ETN Ipath                  
DLBS      	US Trsy Long Bond Bear ETN Ipath                  
DLHC      	Dlh Holdings Corp                                 
DLTR      	Dollar Tree                                       
DMLP      	Dorchester Minerals L.P.                          
DMND      	Diamond Foods                                     
DMRC      	Digimarc Corp                                     
DMTX      	Dimension Therapeutics                            
DNAI      	Pronai Therapeutics Inc                           
DNBF      	Dnb Financial Corp                                
DNKN      	Dunkin' Brands Group Inc                          
DORM      	Dorman Products                                   
DOX       	Amdocs Ltd                                        
DPRX      	Dipexium Pharmaceuticals Llc                      
DRAD      	Digirad Corp                                      
DRAM      	Dataram Corp                                      
DRNA      	Dicerna Pharmaceuticals Inc                       
DRRX      	Durect Corp                                       
DRWI      	Dragonwave Inc                                    
DRWIW     	Dragonwave Inc                                    
DRYS      	Dryships Inc                                      
DSCI      	Derma Sciences                                    
DSCO      	Discovery Laboratories                            
DSGX      	The Descartes Systems Group Inc                   
DSKX      	Ds Healthcare Group Inc                           
DSKY      	Idreamsky Technology Ltd                          
DSLV      	3X Inverse Silver ETN Velocityshares              
DSPG      	DSP Group                                         
DSWL      	Deswell Industries                                
DTEA      	Davidstea Inc                                     
DTLK      	Datalink Corp                                     
DTRM      	Determine Inc.                                    
DTSI      	DTS Inc                                           
DTUL      	Ipath US Treasury 2 Yr Bull ETN                   
DTUS      	US Trsy 2-Year Bear ETN Ipath                     
DTYL      	US Trsy 10-Year Bull ETN Ipath                    
DTYS      	US Trsy 10-Year Bear ETN Ipath                    
DVAX      	Dynavax Technologies Corp                         
DVCR      	Diversicare Healthcare Services Inc               
DWA       	Dreamworks Animation Skg                          
DWAT      	Arrow DWA Tactical ETF                            
DWCH      	Datawatch Corp                                    
DWSN      	Dawson Geophysical Company                        
DWTR      	Powershares DWA Tactical Sectio                   
DXCM      	Dexcom Inc                                        
DXGE      	Wisdomtree Germany Hedged Equity                  
DXJS      	Wisdomtree Japan Hedged Smallcap                  
DXKW      	Wisdomtree Korea Hedged Equity                    
DXLG      	Destination XL Inc.                               
DXM       	Dex Media Inc                                     
DXPE      	Dxp Enterprises                                   
DXPS      	Wisdomtree United Kingdom Hedge                   
DXYN      	The Dixie Group                                   
DYAX      	Dyax Corp                                         
DYNT      	Dynatronics Corp                                  
DYSL      	Dynasil Corporation of America                    
EA        	Electronic Arts Inc                               
EAC       	Erickson Air-Crane Incorporated                   
EACQU     	Easterly Acquisition Corp                         
EAGLU     	Double Eagle Acquisition Corp.                    
EARS      	Auris Medical Holding Ag                          
EBAY      	Ebay Inc                                          
EBIO      	Eleven Biotherapeutics Inc                        
EBIX      	Ebix Inc                                          
EBMT      	Eagle Bancorp Montana                             
EBSB      	Meridian Interstate Bancorp                       
EBTC      	Enterprise Bancorp Inc                            
ECACU     	E-Compass Acquisition Corp.                       
ECHO      	Echo Global Logistics                             
ECOL      	US Ecology                                        
ECPG      	Encore Capital Group Inc                          
ECTE      	Echo Therapeutics                                 
ECYT      	Endocyte Inc                                      
EDAP      	Edap Tms S.A.                                     
EDGE      	Edge Therapeutics Inc.                            
EDGW      	Edgewater Technology                              
EDUC      	Educational Development Corp                      
EEFT      	Euronet Worldwide                                 
EEI       	Ecology and Environment                           
EEMA      	Emrg Mkts Asia MSCI Ishares                       
EEML      	Emrg Mkts Latin Amer MSCI Ishares                 
EFII      	Electronics For Imaging                           
EFOI      	Energy Focus                                      
EFSC      	Enterprise Financial Services Corp                
EFUT      	Efuture Information Technology Inc                
EGAN      	Egain Comm Corp                                   
EGBN      	Eagle Bancorp                                     
EGHT      	8X8 Inc                                           
EGLE      	Eagle Bulk Shipping Inc                           
EGLT      	Egalet Corp                                       
EGOV      	Nic Inc                                           
EGRX      	Eagle Pharmaceuticals Inc                         
EGT       	Entertainment Gaming Asia Inc                     
EHTH      	Ehealth Inc                                       
EIGI      	Endurance International Group H                   
ELEC      	Electrum Special Acquisition Corporation          
ELECU     	Electrum Special Acquisition Corporation          
ELGX      	Endologix Inc                                     
ELNK      	Earthlink Inc                                     
ELON      	Echelon Corp                                      
ELOS      	Syneron Medical Ltd                               
ELRC      	Electro Rent Corp                                 
ELSE      	Electro-Sensors                                   
ELTK      	Eltek Ltd                                         
EMCB      	Emrg Mkts Corporate Bond ETF Wisdomtree           
EMCF      	Emclaire Financial Corp                           
EMCG      	Wisdomtree Emerging Markets Con                   
EMCI      	EMC Insurance Group                               
EMIF      	S&P Emrg Mkts Infrastructure Ishares              
EMITF     	Elbit Imaging Ltd                                 
EMKR      	Emcore Corp                                       
EML       	Eastern Company                                   
EMMS      	Emmis Communications Corp                         
EMMSP     	Emmis Communications Corp                         
ENDP      	Endo Pharmaceuticals Holdings Inc                 
ENFC      	Entegra Financial Corp                            
ENG       	Englobal Corp                                     
ENOC      	Enernoc Inc                                       
ENPH      	Enphase Energy Inc                                
ENSG      	The Ensign Group                                  
ENT       	Global Eagle Entertainment Inc                    
ENTA      	Enanta Pharmaceuticals Inc                        
ENTG      	Entegris Inc                                      
ENTL      	Entellus Medical Inc                              
ENVI      	Envivio Inc                                       
ENZN      	Enzon Pharmaceuticals                             
ENZY      	Enzymotec Ltd                                     
EPAX      	Ambassadors Group                                 
EPAY      	Bottomline Technologies                           
EPIQ      	Epiq Systems                                      
EPIX      	Essa Pharma Inc                                   
EPRS      	Epirus Biopharmaceuticals Inc                     
EPZM      	Epizyme Inc                                       
EQFN      	Equitable Financial Corp                          
EQIX      	Equinix Inc                                       
ERI       	Eldorado Resorts Inc                              
ERIC      	Lm Ericsson Telephone Company                     
ERIE      	Erie Indemnity Company                            
ERII      	Energy Recovery                                   
EROC      	Eagle Rock Energy Partners L.P.                   
ERS       	Empire Res Inc                                    
ESBK      	Elmira Savings Bank Fsb                           
ESCA      	Escalade Inc                                      
ESCR      	Escalera Resources Co                             
ESCRP     	Escalera Resources Co                             
ESEA      	Euroseas Ltd                                      
ESES      	Eco-Stim Energy Solutions Inc                     
ESGR      	Enstar Group Ltd                                  
ESIO      	Electro Scientific Industries                     
ESLT      	Elbit Systems Ltd                                 
ESMC      	Escalon Medical                                   
ESND      	Essendant Inc                                     
ESPR      	Esperion Therapeutics Inc                         
ESRX      	Express Scripts                                   
ESSA      	Essa Bancorp                                      
ESSX      	Essex Rental Corp                                 
ESXB      	Community Bankers Trust Corp                      
ETFC      	E*Trade Financial Corp                            
ETRM      	Enteromedics Inc                                  
ETSY      	Etsy Inc                                          
EUFN      	Europe Financials Index MSCI Ishares              
EVAR      	Lombard Medical Inc                               
EVBS      	Eastern Virginia Bankshares                       
EVEP      	Ev Energy Partners L.P.                           
EVK       	Ever-Glory International Group                    
EVLV      	Evine Live Inc                                    
EVOK      	Evoke Pharma Inc                                  
EVOL      	Evolving Systems                                  
EWBC      	East West Bancorp                                 
EXA       	Exa Corp                                          
EXAC      	Exactech Inc                                      
EXAS      	Exact Sciences Corp                               
EXEL      	Exelixis Inc                                      
EXFO      	Exfo Inc                                          
EXLP      	Exterran Partners L.P.                            
EXLS      	Exlservice Holdings                               
EXPD      	Expeditors International of Washington            
EXPE      	Expedia Inc                                       
EXPO      	Exponent Inc                                      
EXTR      	Extreme Networks                                  
EXXI      	Energy Xxi [Bermuda] Ltd                          
EYEG      	Eyegate Pharmaceuticals Inc                       
EYEGW     	Eyegate Pharmaceuticals Inc. W                    
EYES      	Second Sight Medical Products                     
EZCH      	Ezchip Semiconductor Ltd                          
EZPW      	Ezcorp Inc                                        
FALC      	Falconstor Software                               
FANG      	Diamondback Energy Inc                            
FARM      	Farmer Brothers Company                           
FARO      	Faro Technologies                                 
FAST      	Fastenal Company                                  
FATE      	Fate Therapeutics Inc                             
FB        	Facebook Inc                                      
FBIO      	Fortress Biotech Inc                              
FBIZ      	First Business Financial Services                 
FBMS      	The First Bancshares                              
FBNC      	First Bancorp                                     
FBNK      	First Connecticut Bancorp Inc                     
FBRC      	Fbr & Co                                          
FBSS      	Fauquier Bankshares                               
FBZ       	Brazil Alphadex First Trust                       
FCA       	China Alphadex First Trust                        
FCAN      	Canada Alphadex First Trust                       
FCAP      	First Capital                                     
FCBC      	First Community Bancshares                        
FCCO      	First Community Corp                              
FCCY      	1St Constitution Bancorp [Nj]                     
FCEL      	Fuelcell Energy                                   
FCFP      	First Community Financial Partners Inc            
FCFS      	First Cash Financial Services                     
FCLF      	First Clover Leaf Financial                       
FCNCA     	First Citizens Bancshares                         
FCS       	Fairchild Semiconductor International             
FCSC      	Fibrocell Science                                 
FCTY      	1St Century Bancshares Inc                        
FCVA      	First Capital Bancorp Inc. [Va]                   
FDEF      	First Defiance Financial                          
FDIV      	First Trust Strategic Income Et                   
FDML      	Federal-Mogul Corp                                
FDT       	Dev Mkts Ex-US Alphadex First Trust               
FDTS      	Dev Mkts Ex-US SC Alphadex First Trust            
FDUS      	Fidus Investment Corp                             
FEIC      	Fei Company                                       
FEIM      	Frequency Electronics                             
FELE      	Franklin Electric Co                              
FEM       	Emrg Mkts Alphadex First Trust                    
FEMB      	First Trust Emerging Markets Lo                   
FEMS      	Emrg Mkts SC Alphadex First Trust                 
FENX      	Fenix Parts Inc                                   
FEP       	Europe Alphadex First Trust                       
FES       	Forbes Energy Svcs                                
FEUZ      	First Trust Eurozone Alphadex E                   
FEYE      	Fireeye Inc                                       
FFBC      	First Financial Bancorp                           
FFBCW     	First Financial Bancorp                           
FFHL      	Fuwei Films Co                                    
FFIC      	Flushing Financial Corp                           
FFIN      	First Financial Bankshares                        
FFIV      	F5 Networks                                       
FFKT      	Farmers Capital Bank Corp                         
FFNM      	First Federal of Northern Michigan Bancorp        
FFNW      	First Financial Northwest                         
FFWM      	First Foundation Inc                              
FGEN      	Fibrogen Inc                                      
FGM       	Germany Alphadex First Trust                      
FHCO      	Female Health Company                             
FHK       	Hong Kong Alphadex First Trust                    
FIBK      	First Interstate Bancsystem                       
FINL      	The Finish Line                                   
FISI      	Financial Institutions                            
FISV      	Fiserv Inc                                        
FITB      	Fifth Third Bancorp                               
FITBI     	Fifth Third Bancorp                               
FIVE      	Five Below Inc                                    
FIVN      	Five9 Inc                                         
FIZZ      	National Beverage                                 
FJP       	Japan Alphadex First Trust                        
FKO       	South Korea Alphadex First Trust                  
FKU       	United Kingdom Alphadex First Trust               
FLAG      	Forensic Accounting Exchange TR                   
FLAT      	US Trsy Flattener ETN Ipath                       
FLDM      	Fluidigm Corp                                     
FLEX      	Flextronics International Ltd                     
FLIC      	The First of Long Island Corp                     
FLIR      	Flir Systems                                      
FLKS      	Flex Pharma Inc                                   
FLL       	Full House Resorts                                
FLML      	Flamel Technologies S.A.                          
FLN       	Latin America Alphadex First Trust                
FLWS      	1-800 Flowers.Com                                 
FLXN      	Flexion Therapeutics Inc                          
FLXS      	Flexsteel Industries                              
FMB       	First Trust Managed Municipal E                   
FMBH      	First Mid Ill Bancshares Inc                      
FMBI      	First Midwest Bancorp                             
FMER      	Firstmerit Corp                                   
FMI       	Foundation Medicine Inc                           
FMNB      	Farmers Natl Banc Corp Oh                         
FNBC      	First Nbc Bank Holding Company                    
FNFG      	First Niagara Financial Group Inc                 
FNGN      	Financial Engines                                 
FNHC      	Federated National Holding Company                
FNJN      	Finjan Holdings Inc                               
FNLC      	First Bancorp Inc [Me]                            
FNSR      	Finisar Corp                                      
FNTC      	Fintech Acquisition Corp                          
FNWB      	First Northwest Bancorp                           
FOGO      	Fogo De Chao Inc                                  
FOLD      	Amicus Therapeutics                               
FOMX      	Foamix Pharmaceuticals Ltd                        
FONE      	Nasdaq Cea Smartphone First Trust                 
FONR      	Fonar Corp                                        
FORD      	Forward Industries                                
FORM      	Formfactor                                        
FORR      	Forrester Research                                
FORTY     	Formula Systems Ltd                               
FOSL      	Fossil Inc                                        
FOX       	21St Century Fox Class B                          
FOXA      	21St Century Fox Class A                          
FOXF      	Fox Factory Holding Corp                          
FPA       	Asia Pacific Ex-Jap Alphadex First Trust          
FPRX      	Five Prime Therapeutics Inc                       
FPXI      	First Trust International Ipo E                   
FRAN      	Francesca's Holdings Corporatio                   
FRBA      	First Bank [Nj]                                   
FRBK      	Republic First Bancorp                            
FRED      	Fred's Inc                                        
FREE      	Freeseas Inc                                      
FRGI      	Fiesta Restaurant Group Inc                       
FRME      	First Merchants Corp                              
FRP       	Fairpoint Communications                          
FRPH      	Frp Holdings Inc                                  
FRPT      	Freshpet Inc                                      
FRSH      	Papa Murphys Holdings Inc                         
FSAM      	Fifth Street Asset Management I                   
FSBK      	First South Bancorp Inc                           
FSBW      	FS Bancorp Inc                                    
FSC       	Fifth Street Finance Corp                         
FSCFL     	Fifth Street Finance Corp                         
FSFG      	First Savings Financial Group                     
FSFR      	Fifth Street Senior Floating Ra                   
FSGI      	First Security Group                              
FSLR      	First Solar                                       
FSNN      	Fusion Telecom Intl                               
FSTR      	L.B. Foster Company                               
FSV       	Firstservice Corporation                          
FSYS      	Fuel Systems Solutions                            
FSZ       	Switzerland Alphadex First Trust                  
FTCS      	Strategic Value Index First Trust                 
FTD       	Ftd Companies Inc                                 
FTEK      	Fuel Tech                                         
FTGC      	First Trust Global Tact Commodity Strategy        
FTHI      	First Trust High Income ETF                       
FTLB      	First Trust Low Beta Income ETF                   
FTNT      	Fortinet Inc                                      
FTR       	Frontier Communications Corp                      
FTRPR     	Frontier Communications Corporation               
FTSL      	First Trust Senior Loan Fund Et                   
FTSM      	First Trust Enhanced Short Matu                   
FTW       	Taiwan Alphadex First Trust                       
FUEL      	Rocket Fuel Inc                                   
FULL      	Full Circle Capital Corp                          
FULLL     	Full Circle Capital Corp                          
FULT      	Fulton Financial Corp                             
FUNC      	First United Corp                                 
FUND      	Royce Focus Trust                                 
FV        	First Trust Dorsey Wright Focus                   
FWM       	Fairway Group Holdings Corp                       
FWP       	Forward Pharma A/S                                
FWRD      	Forward Air Corp                                  
FXCB      	Fox Chase Bancorp                                 
FXEN      	FX Energy                                         
FXENP     	FX Energy Inc                                     
GABC      	German American Bancorp                           
GAI       	Global-Tech Advanced Innovations Inc              
GAIA      	Gaiam Inc                                         
GAIN      	Gladstone Investment Corp                         
GAINN     	Gladstone Investment Corp                         
GAINO     	Gladstone Invt Corp                               
GAINP     	Gladstone Investment Corporatio                   
GALE      	Galena Biopharma                                  
GALT      	Galectin Therapeutics Inc                         
GALTU     	Galectin Therapeutics Inc                         
GALTW     	Galectin Therapeutics Inc                         
GAME      	Shanda Games Ltd                                  
GARS      	Garrison Capital Inc                              
GASS      	Stealthgas                                        
GBCI      	Glacier Bancorp                                   
GBDC      	Golub Capital Bdc                                 
GBIM      	Globeimmune Inc                                   
GBLI      	Global Indemnity Plc                              
GBNK      	Guaranty Bancorp                                  
GBSN      	Great Basin Scientific Inc                        
GBT       	Global Blood Therapeutics Inc.                    
GCBC      	Greene County Bancorp                             
GCVRZ     	Sanofi-Aventis Cvr                                
GDEF      	Global Defense & National Secur                   
GDEN      	Golden Entertainment Inc                          
GENC      	Gencor Industries Inc                             
GENE      	Genetic Technologies Ltd                          
GEOS      	Oyo Geospace Corp                                 
GERN      	Geron Corp                                        
GEVO      	Gevo Inc                                          
GFED      	Guaranty Federal Bancshares                       
GFN       	General Finance Corp                              
GFNCP     	General Financial                                 
GFNSL     	General Finance Corporation                       
GGAC      	Garnero Group Acquisition Compa                   
GGACR     	Garnero Group Acquisition Compa                   
GGACU     	Garnero Group Acquisition Compa                   
GGACW     	Garnero Group Acquisition Compa                   
GGAL      	Grupo Financiero Galicia S.A.                     
GHDX      	Genomic Health                                    
GIFI      	Gulf Island Fabrication                           
GIGA      	Giga-Tronics Inc                                  
GIGM      	Gigamedia Ltd                                     
GIII      	G-III Apparel Group                               
GILD      	Gilead Sciences                                   
GILT      	Gilat Satellite Networks Ltd                      
GK        	G&K Services                                      
GLAD      	Gladstone Capital Corp                            
GLADO     	Gladstone Capital Corporation                     
GLBL      	Terraform Global Inc                              
GLBS      	Globus Maritime Ltd                               
GLBZ      	Glen Burnie Bancorp                               
GLDC      	Golden Enterprises                                
GLDD      	Great Lakes Dredge & Dock Corp                    
GLDI      	Credit Suisse Ag                                  
GLMD      	Galmed Pharmaceuticals Ltd                        
GLNG      	Golar Lng Ltd                                     
GLPG      	Galapagos Nv SP ADR                               
GLPI      	Gaming and Leisure Properties                     
GLRE      	Greenlight Capital Re                             
GLRI      	Glori Energy Inc                                  
GLUU      	Glu Mobile Inc                                    
GLYC      	Glycomimetics Inc                                 
GMAN      	Gordmans Stores                                   
GMCR      	Keurig Green Mountain Inc                         
GMLP      	Golar Lng Partners LP                             
GNBC      	Green Bancorp Inc                                 
GNCA      	Genocea Biosciences Inc                           
GNCMA     	General Communication                             
GNMA      	GNMA Bond Ishares                                 
GNMK      	Genmark Diagnostics                               
GNOW      	American Caresource Holdings                      
GNTX      	Gentex Corp                                       
GNVC      	Genvec Inc                                        
GOGL      	Golden Ocean Group Ltd                            
GOGO      	Gogo Inc                                          
GOLD      	Randgold Resources Ltd                            
GOMO      	Sungy Mobile Ltd                                  
GOOD      	Gladstone Commercial Corp                         
GOODN     	Gladstone Commercial Corporatio                   
GOODO     	Gladstone Commercial Corp                         
GOODP     	Gladstone Commercial Corp                         
GOOG      	Alphabet Inc Class C                              
GOOGL     	Alphabet Inc                                      
GPACU     	Global Partner Acquisition Corp                   
GPIA      	Gp Investments Acquisition Corp.                  
GPIAU     	Gp Investments Acquisition Corp                   
GPIAW     	Gp Investments Acquisition Co                     
GPIC      	Gaming Partners International Corp                
GPOR      	Gulfport Energy Corp                              
GPP       	Green Plains Partners LP                          
GPRE      	Green Plains Renewable Energy                     
GPRO      	Gopro Inc                                         
GRBK      	Green Brick Partners Inc                          
GRFS      	Grifols S.A.                                      
GRID      	Nasdaq Clean Edge Smart Grid First Trust          
GRIF      	Griffin Land & Nurseries                          
GRMN      	Garmin Ltd                                        
GROW      	U.S. Global Investors                             
GRPN      	Groupon Inc                                       
GRSHU     	Gores Holdings Inc.                               
GRVY      	Gravity Co                                        
GSBC      	Great Southern Bancorp                            
GSIG      	Gsi Group Inc                                     
GSIT      	Gsi Technology                                    
GSM       	Globe Specialty Metals Inc                        
GSOL      	Global Sources Ltd                                
GSVC      	Next Innovation Corp                              
GT        	Goodyear Tire & Rubber Company                    
GTIM      	Good Times Restaurants Inc                        
GTLS      	Chart Industries                                  
GTWN      	Georgetown Bancp Ma                               
GTXI      	GTX Inc                                           
GUID      	Guidance Software                                 
GULF      	Middle East Dividend Wisdomtree                   
GULTU     	Gulf Coast Ultra                                  
GURE      	Gulf Resources                                    
GWGH      	Gwg Holdings Inc                                  
GWPH      	Gw Pharmaceuticals Plc Ads                        
GYRO      	Gyrodyne Company of America                       
HA        	Hawaiian Holdings                                 
HABT      	The Habit Restaurants Inc                         
HAFC      	Hanmi Financial Corp                              
HAIN      	Hain Celestial Group                              
HALL      	Hallmark Financial Services                       
HALO      	Halozyme Therapeutics                             
HART      	Harvard Apparatus Regenerative                    
HAS       	Hasbro Inc                                        
HAWK      	Blackhawk Network Holdings Inc                    
HAYN      	Haynes International                              
HBAN      	Huntington Bancshares Inc                         
HBANP     	Huntington Bancshares Inc                         
HBCP      	Home Bancorp                                      
HBHC      	Hancock Holding Company                           
HBIO      	Harvard Bioscience                                
HBK       	Hamilton Bancorp Inc                              
HBMD      	Howard Bancorp MD                                 
HBNC      	Horizon Bancorp [In]                              
HBP       	Huttig Bldg Products                              
HCAC      	Hennessy Capital Acquisition Corp. II             
HCACU     	Hennessy Capital Acquisition Co                   
HCACW     	Hennessy Capital Acquisition Co                   
HCAP      	Harvest Capital Credit Corporat                   
HCBK      	Hudson City Bancorp                               
HCCI      	Heritage-Crystal Clean                            
HCKT      	The Hackett Group                                 
HCOM      	Hawaiian Telcom Hold                              
HCSG      	Healthcare Services Group                         
HDNG      	Hardinge Inc                                      
HDP       	Hortonworks Inc                                   
HDRA      	Hydra Industries Acquisition Co                   
HDRAR     	Hydra Industries Acquisition Co                   
HDRAU     	Hydra Industries Acquisition Co                   
HDRAW     	Hydra Industries Acquisition Co                   
HDS       	HD Supply Holdings Inc                            
HDSN      	Hudson Technologies                               
HEAR      	Parametric Sound Corp                             
HEES      	H&E Equipment Services                            
HELE      	Helen of Troy Ltd                                 
HEOP      	Heritage Oaks Bancorp                             
HFBC      	Hopfed Bancorp                                    
HFBL      	Home Federal Bancorp Inc. of Louisiana            
HFFC      	HF Financial                                      
HFWA      	Heritage Financial Corp                           
HGSH      	China Hgs Real Estate                             
HIBB      	Hibbett Sports                                    
HIFS      	Hingham Institution For Savings                   
HIHO      	Highway Holdings                                  
HIIQ      	Health Insurance Innovations I                    
HILL      	Dot Hill Systems Corp                             
HIMX      	Himax Technologies                                
HKTV      	Hong Kong Television Network Ltd. Ads             
HLG       	Hailiang Education Group Inc                      
HLIT      	Harmonic Inc                                      
HMHC      	Houghton Mifflin Harcourt C                       
HMIN      	Homeinns Hotel Group                              
HMNF      	Hmn Financial                                     
HMNY      	Helios & Matheson North America Inc               
HMPR      	Hampton Roads Bankshares Inc                      
HMST      	Homestreet Inc                                    
HMSY      	Hms Holdings Corp                                 
HMTV      	Hemisphere Media                                  
HNH       	Handy & Harman Ltd                                
HNNA      	Hennessy Advisors                                 
HNRG      	Hallador Energy Company                           
HNSN      	Hansen Medical                                    
HOFT      	Hooker Furniture Corp                             
HOLI      	Hollysys Automation Technologies                  
HOLX      	Hologic Inc                                       
HOMB      	Home Bancshares                                   
HOTR      	Chanticleer Holdings Inc                          
HOTRW     	Chanticleer Holdings Inc                          
HOVNP     	Hovnanian Enterprises Inc                         
HPJ       	Hong Kong Highpower Technology                    
HQCL      	Hanwha Q Cells Co. Ltd                            
HQY       	Healthequity Inc                                  
HRMN      	Harmony Merger Corp                               
HRMNU     	Harmony Merger Corp                               
HRTX      	Heron Therapeutics Inc                            
HRZN      	Horizon Technology Finance Corp                   
HSGX      	Histogenics Corporation                           
HSIC      	Henry Schein                                      
HSII      	Heidrick & Struggles International                
HSKA      	Heska Corp                                        
HSNI      	HSN Inc                                           
HSON      	Hudson Global Inc                                 
HSTM      	Healthstream Inc                                  
HTBI      	Hometrust Bancshares Inc                          
HTBK      	Heritage Commerce Corp                            
HTBX      	Heat Biologics Inc                                
HTCH      	Hutchinson Technology Inc                         
HTGM      	Htg Molecular Diagnostics Inc                     
HTHT      	China Lodging Group Ltd                           
HTLD      	Heartland Express                                 
HTLF      	Heartland Financial USA                           
HTWR      	Heartware International                           
HUBG      	Hub Group                                         
HURC      	Hurco Companies                                   
HURN      	Huron Consulting Group Inc                        
HWAY      	Healthways Inc                                    
HWBK      	Hawthorn Bancshares                               
HWCC      	Houston Wire & Cable Company                      
HWKN      	Hawkins Inc                                       
HYGS      	Hydrogenics Corp                                  
HYLS      	First Trust High Yield Long/Sho                   
HYND      	Wisdomtree Bofa Merrill Lynch H                   
HYZD      	Wisdomtree Bofa Merrill Lynch H                   
HZNP      	Horizon Pharma Inc                                
IACI      	Iac/Interactivecorp                               
IART      	Integra Lifesciences Holdings Corp                
IBB       	Nasdaq Biotechnology Ishares                      
IBCP      	Independent Bank Corp                             
IBKC      	Iberiabank Corp                                   
IBKCP     	Iberiabank Corp.                                  
IBKR      	Interactive Brokers Group                         
IBOC      	International Bancshares Corp                     
IBTX      	Independent Bank Group Inc                        
ICAD      	Icad Inc                                          
ICBK      	County Bancorp Inc                                
ICCC      	Immucell Corp                                     
ICFI      	Icf International                                 
ICLD      	Intercloud Systems Inc                            
ICLDW     	Intercloud Systems Inc                            
ICLN      	S&P Global Clean Energy Index Ishares             
ICLR      	Icon Plc                                          
ICON      	Iconix Brand Group                                
ICPT      	Intercept Pharmaceuticals Inc                     
ICUI      	Icu Medical                                       
IDCC      	Interdigital                                      
IDRA      	Idera Pharmaceuticals                             
IDSA      	Industrial Services of America                    
IDSY      	I.D. Systems                                      
IDTI      	Integrated Device Technology                      
IDXX      	Idexx Laboratories                                
IEP       	Icahn Enterprises L.P.                            
IESC      	Integrated Electrical Services                    
IEUS      	Ishares Trust                                     
IFEU      	FTSE Epra/Nareit Dev EU Idx Ishares               
IFGL      	FTSE Epra/Nareit Dev Re Ex-US Ishares             
IFON      	Infosonics Corp                                   
IFV       	First Trust Dorsey Wright Inter                   
IGLD      	Internet Gold Golden Lines Ltd                    
IGOV      	S&P/Citi Intl Treasury Bond Ishares               
III       	Information Services Group                        
IIIN      	Insteel Industries                                
IIJI      	Internet Initiative Japan                         
IILG      	Interval Leisure Group                            
IIN       	Intricon Corp                                     
IIVI      	Ii-Vi Inc                                         
IKGH      	Iao Kun Group Holding Co                          
IKNX      	Ikonics Corp                                      
ILMN      	Illumina Inc                                      
IMDZ      	Immune Design Corp                                
IMGN      	Immunogen                                         
IMI       	Intermolecular Inc                                
IMKTA     	Ingles Markets Inc                                
IMMR      	Immersion Corp                                    
IMMU      	Immunomedics                                      
IMMY      	Imprimis Pharmaceuticals Inc                      
IMNP      	Immune Pharmaceuticals Inc                        
IMOS      	Chipmos Technologies [Bermuda] Ltd                
INAP      	Internap Network Services Corp                    
INBK      	First Internet Bancorp                            
INCR      	Inc Research Holdings Inc                         
INCY      	Incyte Corp                                       
INDB      	Independent Bank                                  
INDY      	S&P India Nifty 50 Index Ishares                  
INFI      	Infinity Pharmaceuticals                          
INFN      	Infinera Corp                                     
INGN      	Inogen Inc                                        
ININ      	Interactive Intelligence                          
INNL      	Innocoll Ag                                       
INO       	Inovio Pharmaceuticals                            
INOD      	Innodata Isogen Inc                               
INOV      	Inovalon Holdings Inc                             
INPH      	Interphase Corp                                   
INSM      	Insmed Inc                                        
INSY      	Insys Therapeutics Inc                            
INTC      	Intel Corp                                        
INTG      	The Intergroup Corp                               
INTL      	Intl Fcstone Inc                                  
INTLL     	Intl Fcstone Inc                                  
INTU      	Intuit Inc                                        
INTX      	Intersections                                     
INVE      	Identive Group                                    
INVT      	Inventergy Global Inc                             
INWK      	Innerworkings                                     
IOSP      	Innospec Inc                                      
IOTS      	Adesto Technologies Corporation                   
IPAR      	Inter Parfums                                     
IPAS      	Ipass Inc                                         
IPCC      	Infinity Property and Casualty Corp               
IPCI      	Intellipharmaceutics International Inc            
IPCM      	IPC The Hospitalist Company                       
IPDN      	Professional Diversity Network                    
IPGP      	Ipg Photonics Corp                                
IPHS      	Innophos Holdings                                 
IPKW      	Powershares International Buyba                   
IPWR      	Ideal Power Inc                                   
IPXL      	Impax Laboratories                                
IQNT      	Inteliquent Inc                                   
IRBT      	Irobot Corp                                       
IRCP      	Irsa Propiedades Comerciales S.A.                 
IRDM      	Iridium Communications Inc                        
IRDMB     	Iridium Communications Inc                        
IRG       	Ignite Restaurant Group Inc                       
IRIX      	Iridex Corp                                       
IRMD      	Iradimed Corporation                              
IROQ      	If Bancorp Inc                                    
IRWD      	Ironwood Pharmaceuticals                          
ISBC      	Investors Bancorp                                 
ISCA      	International Speedway Corp                       
ISHG      	S&P/Citi 1-3 Yr Intl Treasury Bd Ishares          
ISIG      	Insignia Systems                                  
ISIL      	Intersil Corp                                     
ISIS      	Isis Pharmaceuticals                              
ISLE      	Isle of Capri Casinos                             
ISM       	SLM Corp                                          
ISNS      	Image Sensing Systems                             
ISRG      	Intuitive Surgical                                
ISRL      	Isramco Inc                                       
ISSC      	Innovative Solutions and Support                  
ISSI      	Integrated Silicon Solution                       
ISTR      	Investar Holding Corp                             
ITCI      	Intra-Cellular Ther                               
ITEK      	Inotek Pharmaceuticals Corporation                
ITIC      	Investors Title Company                           
ITRI      	Itron Inc                                         
ITRN      	Ituran Location and Control Ltd                   
ITUS      	Itus Corp                                         
IVAC      	Intevac Inc                                       
IVTY      	Invuity Inc                                       
IXYS      	Ixys Corp                                         
JACK      	Jack In The Box Inc                               
JAGX      	Jaguar Animal Health Inc                          
JAKK      	Jakks Pacific                                     
JASN      	Jason Industries Inc                              
JASNW     	Jason Industries Inc                              
JASO      	JA Solar Holdings Co                              
JAXB      	Jacksonville Bancorp                              
JAZZ      	Jazz Pharmaceuticals                              
JBHT      	J.B. Hunt Transport Services                      
JBLU      	Jetblue Airways Corp                              
JBSS      	John B. Sanfilippo & Son                          
JCOM      	J2 Global Communications Inc                      
JCS       	Communications Systems                            
JCTCF     	Jewett-Cameron Trading Company                    
JD        	Jd.Com Inc                                        
JGBB      	Wisdomtree Japan Interest Rate                    
JIVE      	Jive Software Inc                                 
JJSF      	J & J Snack Foods                                 
JKHY      	Jack Henry & Associates                           
JMBA      	Jamba Inc                                         
JNP       	Juniper Pharmaceuticals Inc                       
JOBS      	51Job Inc                                         
JOEZ      	Joe's Jeans Inc                                   
JOUT      	Johnson Outdoors Inc                              
JRJC      	China Finance Online Co. Ltd                      
JRVR      	James River Group Holdings Ltd                    
JSM       	SLM Corp                                          
JST       	Jinpan International Ltd                          
JTPY      	Jetpay Corp                                       
JUNO      	Juno Therapeutics Inc                             
JVA       	Coffee Holding Co                                 
JXSB      	Jacksonville Bancorp Inc                          
JYNT      	The Joint Corp                                    
KALU      	Kaiser Aluminum Corp                              
KANG      	Ikang Healthcare Group Inc                        
KBAL      	Kimball International Inc                         
KBIO      	Kalobios Pharmaceuticals Inc                      
KBSF      	Kbs Fashion Group Ltd                             
KCAP      	Kohlberg Capital Corp                             
KCLI      	Kansas City Life Insurance Company                
KE        	Kimball Electronics Inc                           
KELYA     	Kelly Services                                    
KELYB     	Kelly Services Inc                                
KEQU      	Kewaunee Scientific Corp                          
KERX      	Keryx Biopharmaceuticals                          
KEYW      	The Keyw Holding Corp                             
KFFB      	Kentucky First Federal Bancorp                    
KFRC      	Kforce Inc                                        
KGJI      	Kingold Jewelry Inc                               
KHC       	Kraft Heinz Company                               
KIN       	Kindred Biosciences Inc                           
KINS      	Kingstone Companies Inc                           
KIRK      	Kirkland's Inc                                    
KITE      	Kite Pharma Inc                                   
KLAC      	Kla-Tencor Corp                                   
KLIC      	Kulicke and Soffa Industries                      
KLXI      	Klx Inc                                           
KMDA      	Kamada Ltd                                        
KMPH      	Kempharm Inc                                      
KNDI      	Kandi Technolgies                                 
KONA      	Kona Grill                                        
KONE      	Kingtone Wirelessinfo Solution                    
KOOL      	Thermogenesis                                     
KOPN      	Kopin Corp                                        
KOSS      	Koss Corp                                         
KPTI      	Karyopharm Therapeutics Inc                       
KRNT      	Kornit Digital Ltd                                
KRNY      	Kearny Financial                                  
KTCC      	Key Tronic Corp                                   
KTEC      	Key Technology                                    
KTOS      	Kratos Defense & Security Solutions               
KTWO      	K2M Group Holdings Inc                            
KUTV      	Ku6 Media Co                                      
KVHI      	Kvh Industries                                    
KWEB      	Kraneshares Csi China Internet                    
KYTH      	Kythera Biopharmaceuticals Inc                    
KZ        	Kongzhong Corporation                             
LABL      	Multi-Color Corp                                  
LAKE      	Lakeland Industries                               
LALT      	Powershares Actively Managed Ex                   
LAMR      	Lamar Advertising Company                         
LANC      	Lancaster Colony Corp                             
LAND      	Gladstone Land Corp                               
LARK      	Landmark Bancorp Inc                              
LAWS      	Lawson Products                                   
LAYN      	Layne Christensen Company                         
LBAI      	Lakeland Bancorp                                  
LBIO      	Lion Biotechnologies Inc                          
LBIX      	Leading Brands Inc                                
LBRDA     	Liberty Broadband Corporation                     
LBRDK     	Liberty Broadband Corporation                     
LBTYA     	Liberty Global                                    
LBTYB     	Liberty Global                                    
LBTYK     	Liberty Global                                    
LCNB      	Lcnb Corp                                         
LCUT      	Lifetime Brands                                   
LDRH      	Ldr Holding Corp                                  
LDRI      	Powershares Ladderrite 0-5 Year                   
LE        	Lands' End Inc                                    
LECO      	Lincoln Electric Holdings                         
LEDS      	Semileds Corp                                     
LENS      	Presbia Plc                                       
LFUS      	Littelfuse                                        
LFVN      	Lifevantage Corp                                  
LGCY      	Legacy Reserves LP                                
LGCYO     	Legacy Resvs LP                                   
LGCYP     	Legacy Reserves LP                                
LGIH      	LGI Homes Inc                                     
LGND      	Ligand Pharmaceuticals Inc                        
LHCG      	LHC Group                                         
LIFE      	Atyr Pharma Inc                                   
LILA      	Liberty Global Plc                                
LILAK     	Liberty Global Plc                                
LIME      	Lime Energy Co                                    
LINC      	Lincoln Educational Services Corp                 
LIND      	Lindblad Expeditions Holdings Inc                 
LINDW     	Lindblad Expeditions Holdings Inc                 
LINE      	Linn Energy Llc                                   
LION      	Fidelity Southern Corp                            
LIOX      	Lionbridge Technologies                           
LIQD      	Liquid Holdings Group Inc                         
LITE      	Lumentum Holdings Inc.                            
LIVE      	Livedeal Inc                                      
LIVN      	Sand Holdco Plc                                   
LJPC      	La Jolla Pharma                                   
LKFN      	Lakeland Financial Corp                           
LKOR      	Flexshares Credit-Scored US Lon                   
LKQ       	LKQ Corp                                          
LLEX      	Lilis Energy Inc                                  
LLNW      	Limelight Networks                                
LLTC      	Linear Technology Corp                            
LMAT      	Lemaitre Vascular                                 
LMBS      	First Trust Low Duration Mortga                   
LMCA      	Liberty Media Corp. Series A                      
LMCB      	Liberty Media Corp                                
LMCK      	Liberty Media Corporation                         
LMIA      	LMI Aerospace                                     
LMNR      	Limoneira Co                                      
LMNS      	Lumenis Ltd                                       
LMNX      	Luminex Cor                                       
LMOS      	Lumos Networks Corp                               
LMRK      	Landmark Infrastructure Partner                   
LNCE      	Snyder's Lance Inc                                
LNCO      	Linn Co Llc                                       
LNDC      	Landec Corp                                       
LNTH      	Lantheus Holdings                                 
LOAN      	Manhattan Bridge Capital Inc                      
LOB       	Live Oak Bancshares Inc                           
LOCO      	El Pollo Loco Holdings Inc                        
LOGI      	Logitech International S.A.                       
LOGM      	Logmein Inc                                       
LOJN      	Lojack Corp                                       
LONG      	Elong Inc                                         
LOOK      	Looksmart Ltd                                     
LOPE      	Grand Canyon Education                            
LORL      	Loral Space and Communications                    
LOXO      	Loxo Oncology Inc                                 
LPCN      	Lipocine Inc                                      
LPLA      	Lpl Investment Holdings Inc                       
LPNT      	Lifepoint Hospitals                               
LPSB      	Laporte Bancorp                                   
LPSN      	Liveperson Inc                                    
LPTH      	Lightpath Technologies                            
LPTN      	Lpath Inc                                         
LQDT      	Liquidity Services                                
LRAD      	Lrad Corp                                         
LRCX      	Lam Research Corp                                 
LSBG      	Lake Sunapee Bank Group                           
LSBK      	Lake Shore Bancorp                                
LSCC      	Lattice Semiconductor Corp                        
LSTR      	Landstar System                                   
LTBR      	Lightbridge Corp                                  
LTRPA     	Liberty Tripadvisor Holdings I                    
LTRPB     	Liberty Tripadvisor Holdings I                    
LTRX      	Lantronix Inc                                     
LTXB      	Legacytexas Financial Group Inc                   
LULU      	Lululemon Athletica Inc                           
LUNA      	Luna Innovations Inc                              
LVNTA     	Liberty Interactive Corp                          
LVNTB     	Liberty Interactive Corp                          
LWAY      	Lifeway Foods                                     
LXRX      	Lexicon Pharmaceuticals                           
LYTS      	Lsi Industries Inc                                
MACK      	Merrimack Pharmaceuticals Inc                     
MAGS      	Magal Security Systems Ltd                        
MAMS      	Mam Software Group Inc                            
MANH      	Manhattan Associates                              
MANT      	Mantech International Corp                        
MAR       	Marriot International                             
MARA      	Marathon Patent Group Inc                         
MARK      	Remark Media Inc                                  
MARPS     	Marine Petroleum Trust                            
MASI      	Masimo Corp                                       
MAT       	Mattel Inc                                        
MATR      	Mattersight Corp                                  
MATW      	Matthews International Corp                       
MAYS      	J. W. Mays                                        
MB        	Mindbody Inc                                      
MBCN      	Middlefield Banc Cor                              
MBFI      	MB Financial Inc                                  
MBFIP     	MB Financial Inc                                  
MBII      	Marrone Bio Innovations Inc                       
MBLX      	Metabolix                                         
MBRG      	Middleburg Financial Corp                         
MBSD      	Flexshares Disciplined Duration                   
MBTF      	M B T Financial Corp                              
MBUU      	Malibu Boats Inc                                  
MBVT      	Merchants Bancshares                              
MBWM      	Mercantile Bank Corp                              
MCBC      	Macatawa Bank Corp                                
MCBK      	Madison County Financial Inc                      
MCEP      	Mid-Con Energy Partners LP                        
MCFT      	Mcbc Holdings Inc                                 
MCHP      	Microchip Technology Inc                          
MCHX      	Marchex Inc                                       
MCOX      	Mecox Lane Ltd                                    
MCRB      	Seres Therapeutics Inc                            
MCRI      	Monarch Casino & Resort                           
MCUR      	Macrocure Ltd                                     
MDAS      	Medassets Inc                                     
MDCA      	M.D.C. Partners Inc                               
MDCO      	The Medicines Company                             
MDGS      	Medigus Ltd                                       
MDIV      	First Trust Exchange-Traded Fun                   
MDLZ      	Mondelez International Inc. Cl A                  
MDM       	Mountain Province Diamonds Inc                    
MDRX      	Allscripts Healthcare Solutions                   
MDSO      	Medidata Solutions                                
MDSY      	Bluephoenix Solutions                             
MDVN      	Medivation Inc                                    
MDVX      	Medovex Corp                                      
MDWD      	Mediwound Ltd                                     
MDXG      	Mimedx Group Inc                                  
MEET      	Meetme Inc                                        
MEIL      	Methes Energies International L                   
MEILW     	Methes Energies International L                   
MEILZ     	Methes Energies International L                   
MEIP      	Mei Pharma Inc                                    
MELA      	Mela Sciences Inc                                 
MELI      	Mercadolibre Inc                                  
MELR      	Melrose Bancorp Inc                               
MEMP      	Memorial Production Partners LP                   
MENT      	Mentor Graphics Corp                              
MEOH      	Methanex Corp                                     
MERC      	Mercer International Inc                          
MESG      	Xura Inc.                                         
METR      	Metro Bancorp Inc                                 
MFLX      	Multi-Fineline Electronix                         
MFNC      	Mackinac Financial Corp                           
MFRI      	MFRI Inc                                          
MFRM      	Mattress Firm Holding Corp                        
MFSF      	Mutualfirst Financial Inc                         
MGCD      	Mgc Diagnostics Corp                              
MGEE      	Mge Energy Inc                                    
MGI       	Moneygram International                           
MGIC      	Magic Software Enterprises Ltd                    
MGLN      	Magellan Health Services                          
MGNX      	Macrogenics Inc                                   
MGPI      	MGP Ingredients                                   
MGRC      	Mcgrath Rentcorp                                  
MGYR      	Magyar Bancorp                                    
MHGC      	Morgans Hotel Group Co                            
MHLD      	Maiden Hldgs Ltd                                  
MHLDO     	Maiden Holdings                                   
MICT      	Micronet Enertec Technologies Inc                 
MICTW     	Micronet Enertec Technologies                     
MIDD      	The Middleby Corp                                 
MIFI      	Novatel Wireless                                  
MIK       	Michaels Companies Inc                            
MIND      	Mitcham Industries                                
MINI      	Mobile Mini                                       
MIRN      	Mirna Therapeutics Inc.                           
MITK      	Mitek Systems Inc                                 
MITL      	Mitel Networks Corp                               
MKSI      	Mks Instruments                                   
MKTO      	Marketo Inc                                       
MKTX      	Marketaxess Holdings                              
MLAB      	Mesa Laboratories                                 
MLHR      	Herman Miller                                     
MLNK      	Moduslink Global Solutions Inc                    
MLNX      	Mellanox Technologies                             
MLVF      	Malvern Federal Bancorp                           
MMAC      	Mma Capital Management Llc                        
MMLP      	Martin Midstream Partners L.P.                    
MMSI      	Merit Medical Systems                             
MMYT      	Makemytrip Ltd                                    
MNDO      	Mind C.T.I. Ltd                                   
MNGA      	Magnegas Corp                                     
MNKD      	Mannkind Corp                                     
MNOV      	Medicinova                                        
MNRK      	Monarch Financial Holdings                        
MNRO      	Monro Muffler Brake                               
MNST      	Monster Beverage Corp                             
MNTA      	Momenta Pharmaceuticals                           
MNTX      	Manitex International                             
MOBI      	Sky-Mobi Ltd                                      
MOBL      	Mobileiron Inc                                    
MOCO      	Mocon Inc                                         
MOFG      	Midwestone Financial Group                        
MOKO      	Moko Social Media Ltd                             
MOLG      	Mol Global Inc                                    
MOMO      	Momo Inc                                          
MORN      	Morningstar Inc                                   
MOSY      	Mosys Inc                                         
MPAA      	Motorcar Parts of America                         
MPB       	Mid Penn Bancorp                                  
MPEL      	Melco Crown Entertainment Ltd                     
MPET      	Magellan Petroleum Corp                           
MPWR      	Monolithic Power Systems                          
MRCC      	Monroe Capital Corp                               
MRCY      	Mercury Computer Systems                          
MRD       	Memorial Resource Development C                   
MRGE      	Merge Healthcare Incorporated                     
MRKT      	Markit Ltd                                        
MRLN      	Marlin Business Services                          
MRNS      	Marinus Pharmaceuticals Inc                       
MRTN      	Marten Transport                                  
MRTX      	Mirati Therapeutics Inc                           
MRVC      	M R V Commun Inc                                  
MRVL      	Marvell Technology Group                          
MSBF      	MSB Financial                                     
MSCC      	Microsemi Corp                                    
MSEX      	Middlesex Water Company                           
MSFG      	Mainsource Financial Group                        
MSFT      	Microsoft Corp                                    
MSLI      	Merus Labs International Inc. Co                  
MSON      	Misonix Inc                                       
MSTR      	Microstrategy Inc                                 
MTBC      	Medical Transcription Billing                     
MTEX      	Mannatech Inc                                     
MTGE      	American Capital Mortgage Inves                   
MTGEP     	American Capital Mortgage Inves                   
MTLS      	Materialise Nv                                    
MTRX      	Matrix Service Company                            
MTSC      	MTS Systems Corp                                  
MTSI      	M/A-Com Technology Solutions Ho                   
MTSL      	Mer Telemanagement Solutions Ltd                  
MTSN      	Mattson Technology                                
MU        	Micron Technology                                 
MULT      	Advisorshares Sunrise Global Mu                   
MVIS      	Microvision                                       
MXIM      	Maxim Integrated Products                         
MXWL      	Maxwell Technologies                              
MYGN      	Myriad Genetics                                   
MYL       	Mylan Inc                                         
MYOS      	Myos Corp                                         
MYRG      	Myr Group                                         
MZOR      	Mazor Robotics Ltd                                
NAII      	Natural Alternatives International                
NAME      	Rightside Group Ltd                               
NANO      	Nanometrics Inc                                   
NATH      	Nathan's Famous                                   
NATI      	National Instruments Corp                         
NATL      	National Interstate Corp                          
NATR      	Nature's Sunshine Products                        
NAUH      	National American University Holdings             
NAVG      	The Navigators Group                              
NAVI      	Navient Corporation                               
NBBC      	Newbridge Bancorp                                 
NBIX      	Neurocrine Biosciences                            
NBN       	Northeast Bancorp                                 
NBRV      	Nabriva Therapeutics Ag                           
NBTB      	NBT Bancorp Inc                                   
NCIT      	NCI Inc                                           
NCLH      	Norwegian Cruise Line Holdings                    
NCMI      	National Cinemedia                                
NCOM      	National Commerce Corp                            
NCTY      	The9 Ltd                                          
NDAQ      	The Nasdaq Omx Group                              
NDLS      	Noodles & Company                                 
NDRM      	Neuroderm Ltd                                     
NDSN      	Nordson Corp                                      
NECB      	Northeast Community Bancorp                       
NEO       	Neogenomics Inc                                   
NEOG      	Neogen Corp                                       
NEON      	Neonode Inc                                       
NEOS      	Neos Therapeutics Inc                             
NEOT      	Neothetics Inc                                    
NEPT      	Neptune Technologies & Bioresources Inc           
NERV      	Minerva Neurosciences Inc                         
NETE      	Net Element Inc                                   
NEWP      	Newport Corp                                      
NEWS      	Newstar Financial                                 
NEWT      	Newtek Business Services Inc                      
NEWTZ     	Newtek Business Services Corp.                    
NFBK      	Northfield Bancorp                                
NFEC      	NF Energy Saving Corp                             
NFLX      	Netflix Inc                                       
NGHC      	National General Holdings Corp                    
NGHCO     	National Gen Hldgs Corp                           
NGHCP     	National General Holdings Corp                    
NGHCZ     	National General Holdings Corp.                   
NHLD      	National Holdings                                 
NHTC      	Natural Health Trends Corp                        
NICE      	Nice-Systems Ltd                                  
NICK      	Nicholas Financial                                
NIHD      	NII Holdings Inc                                  
NILE      	Blue Nile Inc                                     
NK        	Nantkwest                                         
NKSH      	National Bankshares                               
NKTR      	Nektar Therapeutics                               
NLNK      	Newlink Genetics Corp                             
NLST      	Netlist Inc                                       
NMIH      	Nmi Holdings Inc                                  
NMRX      	Numerex Corp                                      
NNBR      	NN Inc                                            
NPBC      	National Penn Bancshares                          
NRCIA     	National Research Corp                            
NRCIB     	National Research Corp                            
NRIM      	Northrim Bancorp Inc                              
NRX       	Nephrogenex Inc                                   
NSEC      	National Security Group                           
NSIT      	Insight Enterprises                               
NSPH      	Nanosphere Inc                                    
NSSC      	Napco Security Technologies                       
NSTG      	Nanostring Technologies Inc                       
NSYS      	Nortech Systems Inc                               
NTAP      	Netapp Inc                                        
NTCT      	Netscout Systems                                  
NTEC      	Intec Pharma Ltd                                  
NTES      	Netease Inc                                       
NTGR      	Netgear Inc                                       
NTIC      	Northern Technologies International Corp          
NTK       	Nortek Inc                                        
NTLS      	Ntelos Holdings                                   
NTRA      	Natera Inc                                        
NTRI      	Nutrisystem Inc                                   
NTRS      	Northern Trust Corp                               
NTRSP     	Northern Trust Corporation                        
NTWK      	Netsol Technologies Inc                           
NUAN      	Nuance Communications                             
NURO      	Neurometrix Inc                                   
NUTR      	Nutraceutical International Corp                  
NUVA      	Nuvasive Inc                                      
NVAX      	Novavax Inc                                       
NVCN      	Neovasc Inc                                       
NVCR      	Novocure Ltd                                      
NVDA      	Nvidia Corp                                       
NVDQ      	Novadaq Technologies                              
NVEC      	Nve Corp                                          
NVEE      	Nv5 Holdings Inc                                  
NVET      	Nexvet Biopharma Plc                              
NVFY      	Nova Lifestyle Inc                                
NVGN      	Novogen Ltd                                       
NVIV      	Invivo Therapeutics Holdings                      
NVLS      	Nivalis Therapeutics Inc                          
NVMI      	Nova Measuring Instruments Ltd                    
NVSL      	Naugatuck Valley Financial Corp                   
NWBI      	Northwest Bancshares                              
NWBO      	Northwest Biotherapeutics                         
NWBOW     	Northwest Biotherapeutics Wt                      
NWFL      	Norwood Financial                                 
NWLI      	National Western Life Insurance                   
NWPX      	Northwest Pipe Company                            
NWS       	News Corp Class B                                 
NWSA      	News Corp Class A                                 
NXPI      	Nxp Semiconductors N.V.                           
NXST      	Nexstar Broadcasting Group                        
NXTD      	Nxt-Id                                            
NXTDW     	Nxt-Id Inc                                        
NXTM      	Nxstage Medical                                   
NYMT      	New York Mortgage Trust                           
NYMTO     	New York Mortgage Trust Inc                       
NYMTP     	New York Mortgage Trust Inc                       
NYMX      	Nymox Pharmaceutical Corp                         
NYNY      	Empire Resorts                                    
OASM      	Oasmia Pharmaceutical Ab                          
OBAS      	Optibase Ltd                                      
OBCI      	Ocean Bio-Chem                                    
OCAT      	Ocata Therapeutics Inc                            
OCC       	Optical Cable Corp                                
OCFC      	Oceanfirst Financial                              
OCLR      	Oclaro Inc                                        
OCLS      	Oculus Innovative Sciences                        
OCRX      	Ocera Therapeutics Inc                            
OCUL      	Ocular Therapeutix Inc                            
ODFL      	Old Dominion Freight Line                         
ODP       	Office Depot                                      
OESX      	Orion Energy Systems                              
OFED      	Oconee Federal Financial                          
OFIX      	Orthofix International N.V.                       
OFLX      	Omega Flex                                        
OFS       	Ofs Capital Corp                                  
OGXI      	Oncogenex Pharmaceuticals Inc                     
OHAI      	Ngp Capital Resources Company                     
OHGI      	Intelligent Communication Enterprise Corp         
OHRP      	Ohr Pharmaceutical Inc                            
OIIM      	O2Micro International Ltd                         
OKSB      	Southwest Bancorp                                 
OLBK      	Old Line Bancshares                               
OLED      	Universal Display Corp                            
OLLI      	Ollie's Bargain Outlet Holdings                   
OMAB      	Grupo Aeroportuario Del Centro                    
OMCL      	Omnicell Inc                                      
OMED      	Oncomed Pharmaceuticals Inc                       
OMER      	Omeros Corp                                       
OMEX      	Odyssey Marine Exploration                        
ON        	On Semiconductor Corp                             
ONB       	Old National Bancorp Capital                      
ONCE      	Spark Therapeutics Inc                            
ONCS      	Oncosec Medical Inc                               
ONCY      	Oncolytics Biotech                                
ONEQ      	Nasdaq Composite Tracking Fidelity                
ONFC      	Oneida Financial                                  
ONTX      	Onconova Therapeutics Inc                         
ONTY      	Oncothyreon Inc                                   
ONVI      	Onvia Inc                                         
OPB       	Opus Bank                                         
OPGN      	Opgen Inc                                         
OPHC      	Optimumbank Holdings                              
OPHT      	Ophthotech Corp                                   
OPOF      	Old Point Financial Corp                          
OPTT      	Ocean Power Technologies                          
OPXA      	Opexa Therapeutics                                
OPXAW     	Opexa Therapeutics                                
ORBC      	Orbcomm Inc                                       
ORBK      	Orbotech Ltd                                      
OREX      	Orexigen Therapeutics                             
ORIG      	Ocean Rig Udw Inc                                 
ORIT      	Oritani Financial                                 
ORLY      	O'Reilly Automotive                               
ORMP      	Oramed Pharmaceuticl                              
ORPN      	Bio Blast Pharma Ltd                              
ORRF      	Orrstown Financial Services Inc                   
OSBC      	Old Second Bancorp                                
OSBCP     	Old Second Bancorp                                
OSHC      	Ocean Shore Holding Co                            
OSIR      	Osiris Therapeutics                               
OSIS      	Osi Systems                                       
OSM       	SLM Corp                                          
OSN       	Ossen Innovation Co                               
OSTK      	Overstock.Com                                     
OSUR      	Orasure Technologies                              
OTEL      	Otelco Inc. Class A                               
OTEX      	Open Text Corp                                    
OTIC      	Otonomy Inc                                       
OTIV      	On Track Innovations Ltd                          
OTTR      	Otter Tail Corp                                   
OUTR      	Outerwall Inc                                     
OVAS      	Ovascience Inc                                    
OVBC      	Ohio Valley Banc                                  
OVLY      	Oak Valley Bancorp [Ca]                           
OVTI      	Omnivision Technologies                           
OXBR      	Oxbridge Re Holdings Ltd                          
OXBRW     	Oxbridge Re Holdings Ltd                          
OXFD      	Oxford Immunotec Global Plc                       
OXGN      	Oxigene Inc                                       
OXLC      	Oxford Lane Capital                               
OXLCN     	Oxford Lane Capital Corp                          
OXLCO     	Oxford Lane Capital Corp                          
OZRK      	Bank of The Ozarks                                
PAACU     	Pacific Special Acquisition Cor                   
PAAS      	Pan American Silver                               
PACB      	Pacific Biosciences of California                 
PACEU     	Pace Holdings Corp.                               
PACW      	Pacwest Bancorp                                   
PAGG      	Global Agriculture Powershares                    
PAHC      	Phibro Animal Health Corp                         
PANL      	Pangaea Logistics Solutions Ltd                   
PARN      	Parnell Pharmaceuticals Holding                   
PATI      	New Patriot Transportation Holding Inc            
PATK      	Patrick Industries                                
PAYX      	Paychex Inc                                       
PBCP      	Polonia Bancorp [Pa]                              
PBCT      	People's United Financial                         
PBHC      	Pathfinder Bancorp                                
PBIB      	Porter Bancorp                                    
PBIP      	Prudential Bancorp of Pennsylvania                
PBMD      	Prima Biomed Ltd                                  
PBPB      	Potbelly Corp                                     
PBSK      	Poage Bankshares Inc                              
PCAR      	Paccar Inc                                        
PCBK      	Pacific Continental Corporation [Ore]             
PCCC      	PC Connection                                     
PCH       	Potlatch Corp                                     
PCLN      	Priceline.Com Inc                                 
PCMI      	PCM Inc                                           
PCO       	Pendrell Corp                                     
PCOM      	Points International                              
PCRX      	Pacira Pharmaceuticals                            
PCTI      	Pc-Tel Inc                                        
PCTY      	Paylocity Holding Corp                            
PCYG      	Park City Group                                   
PCYO      	Pure Cycle Corp                                   
PDBC      	Powershares DB Optimum Yield Di                   
PDCE      	Pdc Energy Inc                                    
PDCO      	Patterson Companies Inc                           
PDEX      	Pro-Dex Inc                                       
PDFS      	Pdf Solutions Inc                                 
PDII      	Pdi Inc                                           
PDLI      	Pdl Biopharma                                     
PDVW      	Pacific Datavision Inc                            
PEBK      	Peoples Bancorp of North Carolina                 
PEBO      	Peoples Bancorp Inc                               
PEGA      	Pegasystems Inc                                   
PEGI      	Pattern Energy Group Inc                          
PEIX      	Pacific Ethanol                                   
PENN      	Penn National Gaming                              
PERF      	Perfumania Holdings Inc                           
PERI      	Perion Network Ltd                                
PERY      	Perry Ellis International Inc                     
PESI      	Perma-Fix Environmental Services                  
PETS      	Petmed Express                                    
PETX      	Aratana Therapeutics Inc                          
PFBC      	Preferred Bank                                    
PFBI      	Premier Financial Bancorp                         
PFBX      	Peoples Financial Corp                            
PFIE      	Profire Energy Inc                                
PFIN      	P & F Industries                                  
PFIS      	Peoples Finl Svcs Co                              
PFLT      	Pennantpark Floating Rate Capit                   
PFMT      	Performant Financial Corp                         
PFPT      	Proofpoint Inc                                    
PFSW      	Pfsweb Inc                                        
PGC       	Peapack-Gladstone Financial Corp                  
PGLC      	Pershing Gold Corporation                         
PGNX      	Progenics Pharmaceuticals Inc                     
PGTI      	Pgt Industries                                    
PHII      	PHI Inc                                           
PHIIK     	PHI Inc                                           
PHMD      	Photomedex                                        
PICO      	Pico Holdings Inc                                 
PIH       	1347 Property Insurance Holding                   
PINC      	Premier Inc                                       
PIRS      	Pieris Pharmaceuticals Inc                        
PKBK      	Parke Bancorp                                     
PKOH      	Park-Ohio Holdings                                
PLAB      	Photronics                                        
PLAY      	Dave and Buster's Entertainment                   
PLBC      	Plumas Bancorp                                    
PLCE      	The Children's Place Retail Stores                
PLCM      	Polycom Inc                                       
PLKI      	Popeyes Louisiana Kitchen Inc                     
PLNR      	Planar Systems                                    
PLPC      	Preformed Line Products Company                   
PLPM      	Planet Payment                                    
PLTM      	ISE Global Platinum Index First Trust             
PLUG      	Plug Power Inc                                    
PLUS      	Eplus Inc                                         
PLXS      	Plexus Corp                                       
PMBC      	Pacific Mercantile Bancorp                        
PMCS      	Pmc - Sierra                                      
PMD       	Psychemedics Corp                                 
PME       	Pingtan Marine Enterprise Ltd                     
PMTS      	CPI Card Group Inc.                               
PNBK      	Patriot National Bancorp Inc                      
PNFP      	Pinnacle Financial Partners                       
PNNT      	Pennantpark Investment Corp                       
PNQI      	Nasdaq Internet Powershares                       
PNRA      	Panera Bread Company                              
PNRG      	Primeenergy Corp                                  
PNTR      	Pointer Telocation Ltd                            
PODD      	Insulet Corp                                      
POOL      	Pool Corp                                         
POPE      	Pope Resources                                    
POWI      	Power Integrations                                
POWL      	Powell Industries                                 
POZN      	Pozen Inc                                         
PPBI      	Pacific Premier Bancorp Inc                       
PPC       	Pilgrim's Pride Corp                              
PPHM      	Peregrine Pharmaceuticals Inc                     
PPHMP     	Peregrine Pharmaceuticals Inc                     
PPSI      	Pioneer Pwr Solution                              
PRAA      	Portfolio Recovery Associates                     
PRAH      	Pra Health Sciences Inc                           
PRAN      	Prana Biotechnology Ltd                           
PRCP      	Perceptron Inc                                    
PRFT      	Perficient Inc                                    
PRFZ      	FTSE Rafi US 1500 Small-Mid Powershares           
PRGN      	Paragon Shipping Inc                              
PRGNL     	Paragon Shipping Inc                              
PRGS      	Progress Software Corp                            
PRGX      	Prgx Global                                       
PRIM      	Primoris Services Corp                            
PRKR      	Parkervision                                      
PRMW      	Primo Water Corp                                  
PROV      	Provident Financial Holdings                      
PRPH      	Prophase Labs                                     
PRQR      	Proqr Therapeutics N.V.                           
PRSC      	The Providence Service Corp                       
PRSN      	Perseon Corp                                      
PRSNW     	Perseon Corporation Warrants                      
PRSS      	Cafepress Inc                                     
PRTA      	Prothena Corporation Plc                          
PRTK      	Paratek Pharmaceuticals Inc                       
PRTO      	Proteon Therapeutics Inc                          
PRTS      	U.S. Auto Parts Network                           
PRXI      	Premier Exhibitions                               
PRXL      	Parexel International Corp                        
PRZM      	Prism Technologies Group Inc.                     
PSAU      	Global Gold & Prec Metals Powershares             
PSBH      	Psb Holdings                                      
PSCC      	S&P Smallcap Cnsmr Staples Powershares            
PSCD      	S&P Smallcap Cnsmr Discret Powershares            
PSCE      	S&P Smallcap Energy Powershares                   
PSCF      	S&P Smallcap Financials Powershares               
PSCH      	S&P Smallcap Health Care Powershares              
PSCI      	S&P Smallcap Industrials Powershares              
PSCM      	S&P Smallcap Materials Powershares                
PSCT      	S&P Smallcap Info Tech Powershares                
PSCU      	S&P Smallcap Utilities Powershares                
PSDV      	Psivida Corp                                      
PSEC      	Prospect Capital Corp                             
PSEM      	Pericom Semiconductor Corp                        
PSIX      	Power Solutions Inte                              
PSMT      	Pricesmart Inc                                    
PSTB      	Park Sterling Bank                                
PSTI      	Pluristem Therapeutics                            
PSUN      	Pacific Sunwear of California                     
PTC       	Ptc Inc                                           
PTCT      	Ptc Therapeutics Inc                              
PTEN      	Patterson-Uti Energy                              
PTIE      	Pain Therapeutics                                 
PTLA      	Portola Pharmaceuticals Inc                       
PTNR      	Partner Communications Company Ltd                
PTSI      	P.A.M. Transportation Services                    
PTX       	Pernix Therapeutics Holdings Inc                  
PTXP      	Penntex Midstream Partners LP                     
PUB       	People's Utah Bancorp                             
PULB      	Pulaski Financial                                 
PULM      	Pulmatrix Inc                                     
PVBC      	Provident Bancorp Inc                             
PVTB      	Privatebancorp                                    
PVTBP     	Privatebancorp                                    
PWOD      	Penns Woods Bancorp                               
PWX       	Providence and Worcester Railroad                 
PXLW      	Pixelworks                                        
PYDS      	Payment Data Systems                              
PYPL      	Paypal Holdings Inc                               
PZZA      	Papa John's International                         
QABA      	Nasdaq Aba Community Bank First Trust             
QADA      	Qad Inc                                           
QADB      	Qad Inc                                           
QAT       	MSCI Qatar Capped Ishares                         
QBAK      	Qualstar Corp                                     
QCCO      	QC Holdings                                       
QCLN      	Nasdaq Clean Edge Green First Trust               
QCOM      	Qualcomm Inc                                      
QCRH      	Qcr Holdings                                      
QDEL      	Quidel Corp                                       
QGEN      	Qiagen N.V.                                       
QINC      	First Trust Rba Quality Income                    
QIWI      	Qiwi Plc                                          
QKLS      	Qkl Stores                                        
QLC       	Flexshares US Quality Large Cap                   
QLGC      	Qlogic Corp                                       
QLIK      	Qlik Technologies Inc                             
QLTI      	Qlt Inc                                           
QLYS      	Qualys Inc                                        
QNST      	Quinstreet Inc                                    
QPAC      	Quinpario Acquisiton Corp                         
QPACU     	Quinpario Acquisiton Corp                         
QPACW     	Quinpario Acquisiton Corp                         
QQEW      	Nasdaq-100 Equal Weight First Trust               
QQQ       	Powershares QQQ                                   
QQQC      	G-X Nasdaq China Technology ETF                   
QQQX      	Nasdaq 100 Dynamic Over                           
QQXT      	Nasdaq-100 Ex-Tech Sec First Trust                
QRHC      	Quest Resource Holding Corp                       
QRVO      	Qorvo Inc                                         
QSII      	Quality Systems                                   
QTEC      	Nasdaq-100 Tech Index First Trust                 
QTNT      	Quotient Ltd                                      
QTNTW     	Quotient Ltd                                      
QTWW      	Quantum Fuel Systems Technologies                 
QUIK      	Quicklogic Corp                                   
QUMU      	Qumu Corp                                         
QUNR      	Qunar Cayman Islands Ltd                          
QURE      	Uniqure B.V                                       
QVCA      	Liberty Media Corp                                
QVCB      	Liberty Media Corp                                
QYLD      	Recon Capital Nasdaq-100 Covere                   
RADA      	Rada Electronics Industries Ltd                   
RAIL      	Freightcar America                                
RAND      	Rand Capital Corp                                 
RARE      	Ultragenyx Pharmaceutical Inc                     
RAVE      	Rave Restaurant Group Inc                         
RAVN      	Raven Industries                                  
RBCAA     	Republic Bancorp                                  
RBCN      	Rubicon Technology                                
RBPAA     	Royal Bancshares of Pennsylvania                  
RCII      	Rent-A-Center Inc                                 
RCKY      	Rocky Brands                                      
RCMT      	Rcm Technologies                                  
RCON      	Recon Technology                                  
RCPI      	Rock Creek Pharmaceuticals Inc                    
RDCM      	Radcom Ltd                                        
RDEN      	Elizabeth Arden                                   
RDHL      	Redhill Biopharma Ltd                             
RDI       	Reading International Inc                         
RDIB      	Reading International Inc                         
RDNT      	Radnet Inc                                        
RDUS      	Radius Health Inc                                 
RDVY      	First Trust Nasdaq Rising Divid                   
RDWR      	Radware Ltd                                       
RECN      	Resources Connection                              
REDF      	Rediff.Com India Ltd                              
REFR      	Research Frontiers Inc                            
REGI      	Renewable Energy Group Inc                        
REGN      	Regeneron Pharmaceuticals                         
REIS      	Reis Inc                                          
RELL      	Richardson Electronics                            
RELV      	Reliv International Inc                           
RELY      	Signature Group                                   
REMY      	Remy Intl Inc                                     
RENT      	Rentrak Corp                                      
REPH      	Recro Pharma Inc                                  
RESN      	Resonant Inc                                      
REXI      	Resource America                                  
REXX      	Rex Energy Corp                                   
RFIL      	RF Industries                                     
RGCO      	Rgc Resources Inc                                 
RGEN      	Repligen Corp                                     
RGLD      	Royal Gold                                        
RGLS      	Regulus Therapeutics Inc                          
RGNX      	Regenxbio Inc.                                    
RGSE      	Real Goods Solar Inc                              
RIBT      	Ricebran Technologies                             
RIBTW     	Ricebran Technologies                             
RICK      	RCI Hospitality Holdings                          
RIGL      	Rigel Pharmaceuticals                             
RILY      	B. Riley Financial Inc                            
RITT      	Rit Technologies Ltd                              
RITTW     	Rit Technologies Ltd                              
RIVR      	River Valley Bancorp                              
RJET      	Republic Airways Holdings                         
RKDA      	Arcadia Biosciences Inc                           
RLJE      	Rlj Entertainment Inc                             
RLOC      	Reachlocal                                        
RLOG      	Rand Logistics                                    
RLYP      	Relypsa Inc                                       
RMBS      	Rambus Inc                                        
RMCF      	Rocky Mountain Chocolate Factory                  
RMGN      	Scg Financial Acquisition Corp                    
RMTI      	Rockwell Medical Technologies                     
RNET      	Rignet Inc                                        
RNST      	Renasant Corp                                     
RNWK      	Realnetworks                                      
ROBO      	Robo-Stox Global Robotics and A                   
ROCK      	Gibraltar Industries                              
ROIA      	Radio One Inc                                     
ROIAK     	Radio One Inc                                     
ROIC      	Retail Opportunity Investments                    
ROIQ      	Roi Acquisition Corp. II                          
ROIQW     	Everyware Glb Wts                                 
ROKA      	Roka Bioscience Inc                               
ROLL      	RBC Bearings Inc                                  
ROSG      	Rosetta Genomics Ltd                              
ROST      	Ross Stores                                       
ROVI      	Rovi Corp                                         
ROYL      	Royale Energy                                     
RP        	Realpage Inc                                      
RPD       	Rapid7 Inc                                        
RPRX      	Repros Therapeutics Inc                           
RPRXZ     	Repros Therapeutics Inc. - Seri                   
RPTP      	Raptor Pharmaceutical                             
RPXC      	Rpx Corp                                          
RRD       	R.R. Donnelley & Sons Company                     
RRGB      	Red Robin Gourmet Burgers                         
RRM       	Rr Media Ltd                                      
RSTI      	Rofin-Sinar Technologies                          
RSYS      	Radisys Corp                                      
RTIX      	Rti Biologics                                     
RTK       	Rentech Inc                                       
RTRX      	Retrophin Inc                                     
RTTR      	Ritter Pharmaceuticals                            
RUN       	Sunrun Inc                                        
RUSHA     	Rush Enterprises                                  
RUSHB     	Rush Enterprises                                  
RUTH      	Ruth's Hospitality Group                          
RVLT      	Nexxus Lighting                                   
RVNC      	Revance Therapeutics Inc                          
RVSB      	Riverview Bancorp Inc                             
RWLK      	Rewalk Robotics Ltd                               
RXDX      	Ignyta Inc                                        
RXII      	Rxi Pharmaceuticals                               
RYAAY     	Ryanair Holdings Plc                              
SAAS      	Incontact                                         
SABR      	Sabre Corp                                        
SAEX      	Saexploration Holdings Inc                        
SAFM      	Sanderson Farms                                   
SAFT      	Safety Insurance Group                            
SAGE      	Sage Therapeutics Inc                             
SAIA      	Saia Inc                                          
SAJA      	Sajan Inc                                         
SAL       	Salisbury Bancorp                                 
SALE      	Retailmenot Inc                                   
SALM      	Salem Communications Corp                         
SAMG      	Silvercrest Asset Management Gr                   
SANM      	Sanmina-Sci Corp                                  
SANW      	S&W Seed Company                                  
SASR      	Sandy Spring Bancorp                              
SATS      	Echostar Corp                                     
SAVE      	Spirit Airlines Inc                               
SBAC      	SBA Communications Corp                           
SBBP      	Strongbridge Biopharma Plc                        
SBBX      	Sussex Bancorp                                    
SBCF      	Seacoast Banking Corporation of Florida           
SBCP      	Sunshine Bancorp Inc                              
SBFG      	Sb Financial Group Inc                            
SBFGP     	Sb Financial Group Inc                            
SBGI      	Sinclair Broadcast Group                          
SBLK      	Star Bulk Carriers                                
SBLKL     	Star Bulk Carriers Corp                           
SBNY      	Signature Bank                                    
SBNYW     	Signature Bank                                    
SBRA      	Sabra Healthcare REIT Inc                         
SBRAP     	Sabra Healthcare REIT Inc                         
SBSA      	Spanish Broadcasting System                       
SBSI      	Southside Bancshares                              
SBUX      	Starbucks Corp                                    
SCAI      	Surgical Care Affiliates Inc                      
SCHL      	Scholastic Corp                                   
SCHN      	Schnitzer Steel Industries                        
SCLN      	Sciclone Pharmaceuticals                          
SCMP      	Sucampo Pharmaceuticals                           
SCON      	Superconductor Technologies Inc                   
SCOR      	Comscore Inc                                      
SCSC      	Scansource Inc                                    
SCSS      	Select Comfort Corp                               
SCTY      	Solarcity Corp                                    
SCVL      	Shoe Carnival                                     
SCYX      	Scynexis Inc                                      
SEAC      	Seachange International                           
SEDG      	Solaredge Technologies Inc                        
SEED      	Origin Agritech Ltd                               
SEIC      	Sei Investments Company                           
SEMI      	Sunedison Semiconductor Ltd                       
SENEA     	Seneca Foods                                      
SENEB     	Seneca Foods                                      
SEV       	Sevcon Inc                                        
SFBC      	Sound Financial Inc                               
SFBS      	Servisfirst Bancshares Inc                        
SFLY      	Shutterfly                                        
SFM       	Sprouts Farmers Market Inc                        
SFNC      	Simmons First National Corp                       
SFST      	Southern First Bancshares                         
SFXE      	Sfx Entertainment Inc                             
SGBK      	Stonegate Bank [Fl]                               
SGC       	Superior Uniform Group                            
SGEN      	Seattle Genetics                                  
SGI       	Silicon Graphics International Corp               
SGMA      	Sigmatron International                           
SGMO      	Sangamo Biosciences                               
SGMS      	Scientific Games Corp                             
SGNL      	Signal Genetics Llc                               
SGNT      	Sagent Pharmaceuticals Inc                        
SGOC      	Sgoco Group Ltd                                   
SGRP      	Spar Group                                        
SGRY      	Surgery Partners Inc.                             
SGYP      	Synergy Pharmaceuticals Inc                       
SGYPU     	Synergy Pharmaceuticals Inc                       
SGYPW     	Synergy Pharmaceuticals Inc                       
SHBI      	Shore Bancshares Inc                              
SHEN      	Shenandoah Telecommunications Co                  
SHIP      	Seanergy Maritime Holdings Corp                   
SHLD      	Sears Holdings Corp                               
SHLDW     	Sears Holdings Corporation                        
SHLM      	A. Schulman                                       
SHLO      	Shiloh Industries                                 
SHOO      	Steven Madden                                     
SHOR      	Shoretel Inc                                      
SHOS      	Sears Hometown and Outlet Store                   
SHPG      	Shire Plc American Depositary Shares              
SIAL      	Sigma-Aldrich Corp                                
SIBC      	State Investors Bancorp Inc                       
SIEB      	Siebert Financial                                 
SIEN      	Sientra Inc                                       
SIFI      	Si Financial Group                                
SIFY      	Sify Technologies Ltd                             
SIGI      	Selective Insurance Group                         
SIGM      	Sigma Designs                                     
SILC      	Silicom Ltd                                       
SIMO      	Silicon Motion Technology Corp                    
SINA      	Sina Corp                                         
SINO      	Sino-Global Shipping America                      
SIRI      	Sirius XM Radio Inc                               
SIRO      	Sirona Dental Systems                             
SITO      	Single Touch Systems                              
SIVB      	Svb Financial Group                               
SIVBO     	Svb Financial Group                               
SIXD      	6D Global Technologies Inc                        
SKBI      	Skystar Bio-Pharmaceutical Company                
SKIS      	Peak Resorts Inc                                  
SKLN      	Skyline Medical Inc                               
SKOR      	Flexshares Credit-Scored US Cor                   
SKUL      	Skullcandy Inc                                    
SKYS      	Sky Solar Holdings Ltd                            
SKYW      	Skywest Inc                                       
SKYY      	ISE Cloud Computing Index First Trust             
SLAB      	Silicon Laboratories                              
SLCT      	Select Bancorp Inc                                
SLGN      	Silgan Holdings                                   
SLM       	SLM Corp                                          
SLMAP     	SLM 6.97 Cum Pfd A                                
SLMBP     	SLM Corp Pfd B                                    
SLP       	Simulations Plus                                  
SLRC      	Solar Capital Ltd                                 
SLTC      	Selectica Inc                                     
SLTD      	Solar3D Inc                                       
SLVO      	Credit Suisse Ag                                  
SMAC      	Sino Mercury Acquisition Corp                     
SMACR     	Sino Mercury Acquisition Corp                     
SMACU     	Sino Mercury Acquisition Corp                     
SMBC      	Southern Missouri Bancorp                         
SMCI      	Super Micro Computer                              
SMCP      	Alphamark Small Cap Growth ETF                    
SMED      	Sharps Compliance Corp                            
SMIT      	Schmitt Industries                                
SMLR      	Semler Scientific Inc                             
SMMF      	Summit Financial Group                            
SMMT      	Summit Therapeutics Plc                           
SMRT      	Stein Mart Inc                                    
SMSI      	Smith Micro Software                              
SMT       	Smart Technologies Inc                            
SMTC      	Semtech Corp                                      
SMTP      	Smtp Inc                                          
SMTX      	Smtc Corp                                         
SNAK      	Inventure Foods                                   
SNBC      	Sun Bancorp                                       
SNC       	State National Companies Inc                      
SNCR      	Synchronoss Technologies                          
SNDK      	Sandisk Corp                                      
SNFCA     	Security National Financial Corp                  
SNHY      	Sun Hydraulics Corp                               
SNMX      	Senomyx Inc                                       
SNPS      	Synopsys Inc                                      
SNSS      	Sunesis Pharmaceuticals                           
SNTA      	Synta Pharmaceuticals                             
SOCB      	Southcoast Financial Corp                         
SOCL      	G-X Social Media Index ETF                        
SODA      	Sodastream International Ltd                      
SOFO      	Sonic Foundry                                     
SOHO      	Sotherly Hotels Inc                               
SOHOL     	Sotherly Hotels LP                                
SOHOM     	Sotherly Hotels LP                                
SOHU      	Sohu.Com Inc                                      
SONA      	Southern National Bancorp of Virginia             
SONC      	Sonic Corp                                        
SONS      	Sonus Networks                                    
SORL      	Sorl Auto Parts                                   
SOXX      	PHLX Sox Semiconductor Sector Ishares             
SP        	SP Plus Corporation                               
SPAN      	Span-America Medical Systems                      
SPAR      	Spartan Motors                                    
SPCB      	Supercom Ltd                                      
SPDC      	Speed Commerce Inc                                
SPEX      	Spherix Inc                                       
SPHS      	Sophiris Bio Inc                                  
SPIL      	Siliconware Precision Industries Company Ltd      
SPKE      	Spark Energy Inc                                  
SPLK      	Splunk Inc                                        
SPLS      	Staples Inc                                       
SPNC      	The Spectranetics Corp                            
SPNE      	Seaspine Holdings Corporation                     
SPNS      	Sapiens International Corporation N.V.            
SPOK      	Spok Holdings Inc                                 
SPPI      	Spectrum Pharmaceuticals                          
SPRO      	Smartpros Ltd                                     
SPRT      	Support.Com Inc                                   
SPSC      	Sps Commerce                                      
SPTN      	Spartan Stores                                    
SPU       	Skypeople Fruit Juice                             
SPWH      	Sportsman&#39S Warehouse Holdi                    
SPWR      	Sunpower Corp                                     
SQBG      	Sequential Brands Group Inc                       
SQBK      	Square 1 Financial Inc                            
SQI       	Sciquest Inc                                      
SQNM      	Sequenom Inc                                      
SQQQ      	Ultrapro Short QQQ Proshares                      
SRCE      	1St Source Corp                                   
SRCL      	Stericycle Inc                                    
SRCLP     	Stericycle Inc.                                   
SRDX      	Surmodics Inc                                     
SRET      	Global X Superdividend REIT ETF                   
SREV      	Servicesource International In                    
SRNE      	Sorrento Therapeutics                             
SRPT      	Sarepta Therapeutics Inc                          
SRSC      	Sears Canada Inc                                  
SSB       	South State Corporation                           
SSBI      	Summit State Bank                                 
SSFN      	Stewardship Financial Corp                        
SSH       	Sunshine Heart Inc                                
SSNC      	SS&C Technologies Holdings                        
SSRG      	Symmetry Surgical Inc                             
SSRI      	Silver Standard Resources Inc                     
SSYS      	Stratasys Ltd                                     
STAA      	Staar Surgical Company                            
STAF      	Staffing 360 Degrees                              
STB       	Student Transn Inc                                
STBA      	S&T Bancorp                                       
STBZ      	State Bank Finl Corp                              
STCK      	Stock Building Supply Holdings                    
STDY      	Steadymed Ltd                                     
STEM      	Stemcells Inc                                     
STFC      	State Auto Financial Corp                         
STKL      	Sunopta Inc                                       
STKS      	Committed Capital                                 
STLD      	Steel Dynamics                                    
STLY      	Stanley Furniture Company                         
STML      	Stemline Therapeutics Inc                         
STMP      	Stamps.Com Inc                                    
STNR      	Steiner Leisure Ltd                               
STPP      	US Trsy Steepener ETN Ipath                       
STRA      	Strayer Education                                 
STRL      	Sterling Construction Company Inc                 
STRM      	Streamline Health Solutions                       
STRS      	Stratus Properties                                
STRT      	Strattec Security Corp                            
STRZA     	Starz                                             
STRZB     	Starz Series B                                    
STX       	Seagate Technology                                
STXS      	Stereotaxis                                       
STXSW     	Satrix Swix Top 40                                
SUBK      	Suffolk Bancorp                                   
SUMR      	Summer Infant                                     
SUNS      	Solar Senior Capital Ltd                          
SUPN      	Supernus Pharmaceuticals Inc                      
SURG      	Synergetics USA                                   
SVA       	Sinovac Biotech                                   
SVBI      	Severn Bancorp Inc                                
SVVC      	Firsthand Technology Value Fund                   
SWHC      	Smith & Wesson Holding Corp                       
SWIR      	Sierra Wireless                                   
SWKS      	Skyworks Solutions                                
SWSH      	Swisher Hygiene                                   
SXCL      	Steel Excel Inc                                   
SYBT      	S.Y. Bancorp                                      
SYKE      	Sykes Enterprises Inc                             
SYMC      	Symantec Corp                                     
SYMX      	Synthesis Energy Systems                          
SYNA      	Synaptics Inc                                     
SYNC      	Synacor Inc                                       
SYNL      	Synalloy Corp                                     
SYNT      	Syntel Inc                                        
SYPR      	Sypris Solutions                                  
SYRX      	Sysorex Global Holdings Corp                      
SYUT      	Synutra International                             
SZMK      	Sizmek Inc                                        
SZYM      	Solazyme Inc                                      
TACO      	Levy Acquisition Corp                             
TACOW     	Levy Acquisition Corp                             
TACT      	Transact Technologies Inc                         
TAIT      	Taitron Components Inc                            
TANH      	Tantech Holdings                                  
TAPR      	Barclays Plc                                      
TASR      	Taser International                               
TAST      	Carrols Restaurant Group                          
TATT      	Tat Technologies Ltd                              
TAX       	Jth Holding Inc                                   
TAXI      	Medallion Financial                               
TAYD      	Taylor Devices                                    
TBBK      	The Bancorp                                       
TBIO      	Transgenomic Inc                                  
TBK       	Triumph Bancorp Inc                               
TBNK      	Territorial Bancorp Inc                           
TBPH      	Theravance Biopharma Inc                          
TBRA      	Tobira Therapeutics Inc                           
TCBI      	Texas Capital Bancshares                          
TCBIL     	Texas Capital Bancshares Inc                      
TCBIP     	Texas Capital                                     
TCBK      	Trico Bancshares                                  
TCCO      	Technical Communications Corp                     
TCFC      	Tri-County Financial Corp                         
TCON      	Tracon Pharmaceuticals Inc                        
TCPC      	TCP Capital Corp                                  
TCRD      	THL Credit                                        
TCX       	Tucows Inc                                        
TDIV      	First Trust Nasdaq Technol ETF                    
TEAR      	Tearlab Corp                                      
TECD      	Tech Data Corp                                    
TECH      	Techne Corp                                       
TEDU      	Tarena International Inc                          
TENX      	Tenax Therapeutics Inc                            
TERP      	Terraform Power Inc                               
TESO      	Tesco Corp                                        
TESS      	Tessco Technologies Inc                           
TFM       	The Fresh Market                                  
TFSC      	1347 Capital Corp                                 
TFSCR     	1347 Capital Corp                                 
TFSCU     	1347 Capital Corp                                 
TFSCW     	1347 Capital Corp                                 
TFSL      	Tfs Financial Corp                                
TGA       	Transglobe Energy Corp                            
TGEN      	Tecogen Inc                                       
TGLS      	Tecnoglass Inc                                    
TGTX      	Tg Therapeutics                                   
THFF      	First Financial Corporation Indiana               
THLD      	Threshold Pharmaceuticals                         
THOR      	Thoratec Corp                                     
THRM      	Gentherm Inc                                      
THRX      	Theravance                                        
THST      	Truett-Hurst Inc                                  
THTI      	Tht Heat Transfer Technology                      
TICC      	Ticc Capital                                      
TIGR      	Tigerlogic Corp                                   
TIL       	Till Cap Ltd                                      
TILE      	Interface                                         
TINY      	Harris & Harris Group                             
TIPT      	Tiptree Financial Inc                             
TISA      	Top Image Systems                                 
TITN      	Titan Machinery Inc                               
TIVO      	Tivo Inc                                          
TKAI      	Tokai Pharmaceuticals Inc                         
TLF       	Tandy Leather Factory                             
TLGT      	Teligent Inc.                                     
TLMR      	Talmer Bancorp Inc                                
TLOG      	Tetralogic Pharmaceuticals Corp                   
TMUS      	T-Mobile US Inc                                   
TMUSP     	T-Mobile US Inc. 5.50% Mandatory                  
TNAV      	Telenav Inc                                       
TNDM      	Tandem Diabetes Care Inc                          
TNGO      	Tangoe Inc                                        
TNXP      	Tonix Pharm Hldg Cor                              
TOPS      	Top Ships Inc                                     
TOR       	Sutor Technology Group Ltd                        
TORM      	Tor Minerals International Inc                    
TOUR      	Tuniu Corp                                        
TOWN      	Towne Bank                                        
TQQQ      	Ultrapro QQQ Proshares                            
TRAK      	Dealertrack Holdings                              
TRCB      	Two River Bancorp                                 
TRCH      	Torchlight Energy Resources Inc                   
TREE      	Tree.Com                                          
TRIB      	Trinity Biotech Plc                               
TRIL      	Trillium Therapeutics Inc                         
TRIP      	Tripadvisor Inc                                   
TRIV      	Trivascular Technologies Inc                      
TRMB      	Trimble Navigation Ltd                            
TRMK      	Trustmark Corp                                    
TRNS      	Transcat Inc                                      
TRNX      	Tornier N.V.                                      
TROV      	Trovagene Inc                                     
TROVW     	Trovagene Inc                                     
TROW      	T. Rowe Price Group                               
TRS       	Trimas Corp                                       
TRST      	Trustco Bank Corp NY                              
TRTL      	Terrapin 3 Acquisition Corporat                   
TRTLU     	Terrapin 3 Acquisition Corporat                   
TRTLW     	Terrapin 3 Acquisition Corporat                   
TRUE      	Truecar Inc                                       
TRVN      	Trevena Inc                                       
TSBK      	Timberland Bancorp                                
TSC       	Tristate Capital Holdings Inc                     
TSCO      	Tractor Supply Company                            
TSEM      	Tower Semiconductor Ltd                           
TSLA      	Tesla Motors                                      
TSRA      	Tessera Technologies                              
TSRI      	TSR Inc                                           
TSRO      	Tesaro Inc                                        
TST       	Thestreet.Com                                     
TSYS      	Telecommunication Systems                         
TTEC      	Teletech Holdings                                 
TTEK      	Tetra Tech                                        
TTGT      	Techtarget                                        
TTHI      	Transition Therapeutics                           
TTMI      	TTM Technologies                                  
TTNP      	Titan Pharmaceuticals Inc.                        
TTOO      	T2 Biosystems Inc                                 
TTPH      	Tetraphase Pharmaceuticals Inc                    
TTS       	Tile Shop Holdings Inc                            
TTWO      	Take-Two Interactive Software                     
TUBE      	Tubemogul Inc                                     
TUES      	Tuesday Morning                                   
TUSA      	First Trust Total US Market Alphadex ETF          
TUTI      	Tuttle Tactical Management Mult                   
TUTT      	Tuttle Tactical Management U.S                    
TVIX      	Daily 2X VIX ST ETN Velocityshares                
TVIZ      	Daily 2X VIX Med-Term ETN Velocityshares          
TW        	Towers Watson & Co                                
TWER      	Towerstream Corp                                  
TWIN      	Twin Disc Inc                                     
TWMC      	Trans World Entertainment                         
TWOU      	2U Inc                                            
TXN       	Texas Instruments Inc                             
TXRH      	Texas Roadhouse                                   
TYPE      	Monotype Imaging Holdings Inc                     
TZOO      	Travelzoo Inc                                     
UACL      	Universal Truckload Services                      
UAE       	Ishares MSCI UAE Capped ETF                       
UBCP      	United Bancorp                                    
UBFO      	United Security Bancshares                        
UBIC      	Ubic Inc                                          
UBIO      	Proshares Ultrapro Nasdaq Biote                   
UBND      	Wisdomtree Western Asset Uncons                   
UBNK      	United Financial Bancorp Inc                      
UBNT      	Ubiquiti Networks Inc                             
UBOH      	United Bancshares                                 
UBSH      	Union First Market Bankshares Corp                
UBSI      	United Bankshares                                 
UCBA      	United Community Bancorp                          
UCBI      	United Community Banks                            
UCFC      	United Community Financial                        
UCTT      	Ultra Clean Holdings                              
UDF       	United Development Funding IV                     
UEIC      	Universal Electronics Inc                         
UEPS      	Net 1 Ueps Technologies                           
UFCS      	United Fire Group Inc                             
UFPI      	Universal Forest Products                         
UFPT      	Ufp Technologies                                  
UG        	United-Guardian                                   
UGLD      	3X Long Gold ETN Velocityshares                   
UHAL      	Amerco                                            
UIHC      	United Insurance Hld                              
UK        	Recon Capital FTSE 100 ETF                        
ULBI      	Ultralife Corp                                    
ULTA      	Ulta Salon Cosmetics & Fragrance                  
ULTI      	The Ultimate Software Group                       
ULTR      	Ultrapetrol [Bahamas] Ltd                         
UMBF      	UMB Financial Corp                                
UMPQ      	Umpqua Holdings Corp                              
UNAM      	Unico American Corp                               
UNB       	Union Bankshares                                  
UNFI      	United Natural Foods                              
UNIS      	Unilife Corp                                      
UNTD      	United Online                                     
UNTY      	Unity Bancorp                                     
UNXL      	Uni-Pixel                                         
UPIP      	Unwired Planet Inc                                
UPLD      	Upland Software Inc                               
URBN      	Urban Outfitters                                  
URRE      	Uranium Resources                                 
USAK      	USA Truck                                         
USAP      	Universal Stainless & Alloy Products              
USAT      	USA Technologies                                  
USATP     	USA Technologies                                  
USBI      	United Security Bancshares                        
USCR      	US Concrete                                       
USEG      	US Energy                                         
USLM      	United States Lime & Minerals                     
USLV      	3X Long Silver ETN Velocityshares                 
USMD      	Usmd Holdings Inc                                 
UTEK      	Ultratech Inc                                     
UTES      	Reaves Utilities ETF                              
UTHR      	United Therapeutics Corp                          
UTIW      	Uti Worldwide Inc                                 
UTMD      	Utah Medical Products                             
UTSI      	Ustarcom Holdings Corp                            
UVSP      	Univest Corporation of Pennsylvania               
VA        	Virgin America Inc                                
VALU      	Value Line                                        
VALX      	Validea Market Legends ETF                        
VASC      	Vascular Solutions                                
VBFC      	Village Bank and Trust Financial                  
VBIV      	Vbi Vaccines Inc                                  
VBLT      	Vascular Biogenics Ltd                            
VBND      	Vident Core U.S. Bond Strategy                    
VBTX      	Veritex Holdings Inc                              
VCEL      	Vericel Corporation                               
VCIT      	Interm-Term Corp Bd Idx ETF Vanguard              
VCLT      	Long-Term Corp Bond Idx ETF Vanguard              
VCSH      	Short-Term Corp Bd Idx ETF Vanguard               
VCYT      	Veracyte Inc                                      
VDSI      	Vasco Data Security International                 
VDTH      	Videocon D2H Ltd                                  
VECO      	Veeco Instruments Inc                             
VGGL      	Viggle Inc                                        
VGIT      	Interm-Term Govt Bd Idx ETF Vanguard              
VGLT      	Long-Term Govt Bond Idx ETF Vanguard              
VGSH      	Short-Term Govt Bd Idx ETF Vanguard               
VIA       	Viacom Inc Class A                                
VIAB      	Viacom Inc Cl B                                   
VIAV      	Viavi Solutions Inc                               
VICL      	Vical Inc                                         
VICR      	Vicor Corp                                        
VIDI      	Vident International Equity Fun                   
VIIX      	VIX Short-Term ETN Velocityshares                 
VIIZ      	VIX Med-Term ETN Velocityshares                   
VIMC      	Vimicro International Corp                        
VIP       	Open Joint Stock Company Vimpel-Communications    
VIRC      	Virco Manufacturing Corp                          
VIRT      	Virtu Financial Inc                               
VISN      	Visionchina Media                                 
VIVO      	Meridian Bioscience Inc                           
VKTX      	Viking Therapeutics Inc                           
VLGEA     	Village Super Market                              
VLTC      	Voltari Corp                                      
VMBS      	Mortgage Backed Securities ETF Vanguard           
VNDA      	Vanda Pharmaceuticals Inc                         
VNET      	21Vianet Group Inc                                
VNOM      	Viper Energy Partners LP                          
VNQI      	Global Ex-US Real Estate ETF Vanguard             
VNR       	Vanguard Natural Resources Llc                    
VNRAP     	Vanguard Natural Resources Llc Pfd. Series A      
VNRBP     	Vanguard Natural Resources Llc                    
VNRCP     	Vanguard Natural Resources Llc                    
VOD       	Vodafone Group Plc                                
VONE      	Russell 1000 Index ETF Vanguard                   
VONG      	Russell 1000 Growth Index ETF Vanguard            
VONV      	Russell 1000 Value Index ETF Vanguard             
VOXX      	Audiovox Corp                                     
VPCO      	Vapor Corp Nev                                    
VRA       	Vera Bradley                                      
VRML      	Vermillion Inc                                    
VRNG      	Vringo Inc                                        
VRNS      	Varonis Systems Inc                               
VRNT      	Verint Systems Inc                                
VRSK      	Verisk Analytics                                  
VRSN      	Verisign Inc                                      
VRTA      	Vestin Realty Mortgage I                          
VRTB      	Vestin Realty Mortgage II                         
VRTS      	Virtus Investment Partners                        
VRTU      	Virtusa Corp                                      
VRTX      	Vertex Pharmaceuticals Inc                        
VSAR      	Versartis Inc                                     
VSAT      	Viasat Inc                                        
VSCP      	Virtualscopics                                    
VSEC      	VSE Corp                                          
VSTM      	Verastem Inc                                      
VTAE      	Vitae Pharmaceuticals Inc                         
VTHR      	Russell 3000 Index ETF Vanguard                   
VTIP      	Vanguard Short-Term Inflation-P                   
VTL       	Vital Therapies Inc                               
VTNR      	Vertex Energy Inc                                 
VTVT      	Vtv Therapeutics Inc                              
VTWG      	Russell 2000 Growth Index ETF Vanguard            
VTWO      	Russell 2000 Index ETF Vanguard                   
VTWV      	Russell 2000 Value Index ETF Vanguard             
VUSE      	Vident Core U.S. Equity ETF                       
VUZI      	Vuzix Corp                                        
VVUS      	Vivus Inc                                         
VWOB      	Vanguard Emerging Markets Gover                   
VWR       	Vwr Corporation                                   
VXDN      	Accushares Spot CBOE VIX Down Shares              
VXUP      	Accushares Spot CBOE VIX Up Shares                
VXUS      	Total Intl Stock Idx ETF Vanguard                 
WABC      	Westamerica Bancorporation                        
WAFD      	Washington Federal                                
WAFDW     	Washington Federal Inc. Wt                        
WASH      	Washington Trust Bancorp                          
WATT      	Energous Corporation                              
WAVX      	Wave Systems                                      
WAYN      	Wayne Savings Bancshares Inc                      
WB        	Weibo Corp                                        
WBA       	Walgreens Boots Alliance Inc                      
WBB       	Westbury Bancorp Inc                              
WBKC      	Wolverine Bancorp                                 
WBMD      	Webmd Health Corp                                 
WDC       	Western Digital Corp                              
WDFC      	Wd-40 Company                                     
WEBK      	Wellesley Bancorp Inc                             
WEN       	The Wendy's Company                               
WERN      	Werner Enterprises                                
WETF      	Wisdomtree Invstmnts                              
WEYS      	Weyco Group                                       
WFBI      	Washingtonfirst Bk                                
WFD       	Westfield Financial                               
WFM       	Whole Foods Market                                
WGBS      	Wafergen Bio-Systems                              
WHF       	Whitehorse Finance Inc                            
WHFBL     	Whitehorse Finance Inc                            
WHLM      	Wilhemina International Inc                       
WHLR      	Wheeler Real Estate Investment                    
WHLRP     	Wheeler Real Estate Investment                    
WHLRW     	Wheeler Real Estate Investment                    
WIBC      	Wilshire Bancorp                                  
WIFI      	Boingo Wireless Inc                               
WILC      	G. Willi-Food International Ltd                   
WILN      	Wi-Lan Inc                                        
WIN       	Windstream Holdings Inc                           
WINA      	Winmark Corp                                      
WING      	Wingstop Inc                                      
WINS      	SM&A                                              
WIRE      	Encore Wire Corp                                  
WIX       	Wix.Com Ltd                                       
WLB       	Westmoreland Coal Company                         
WLDN      	Willdan Group                                     
WLFC      	Willis Lease Finance Corp                         
WLRH      	Wl Ross Holding Corp                              
WLRHU     	Wl Ross Holding Corp                              
WLRHW     	Wl Ross Holding Corp                              
WMAR      	West Marine                                       
WMGI      	Wright Medical Group N.V.                         
WMGIZ     	Wright Medical Group Inc                          
WMIH      	Wmi Holdings                                      
WOOD      	S&P Global Timber & Forestry Idx Ishares          
WOOF      	Vca Antech                                        
WOWO      	Wowo Ltd                                          
WPCS      	Wpcs International Inc                            
WPPGY     	Wpp Plc                                           
WPRT      	Westport Innovations Inc                          
WRES      	Warren Resources                                  
WRLD      	World Acceptance Corp                             
WSBC      	Wesbanco Inc                                      
WSBF      	Waterstone Financial                              
WSCI      	Wsi Industries Inc                                
WSFS      	WSFS Financial Corp                               
WSFSL     	WSFS Financial Corp                               
WSTC      	West Corp                                         
WSTG      	Wayside Technology Group                          
WSTL      	Westell Technologies                              
WTBA      	West Bancorporation                               
WTFC      	Wintrust Financial Corp                           
WTFCM     	Wintrust Financial Corporation                    
WTFCW     	Wintrust Financial Corp                           
WVFC      	Wvs Financial                                     
WVVI      	Willamette Valley Vineyards                       
WWD       	Woodward Inc                                      
WWWW      	Web.Com Group Inc                                 
WYIGU     	Jm Global Holding Company                         
WYNN      	Wynn Resorts Ltd                                  
XBIT      	Xbiotech Inc                                      
XBKS      	Xenith Bankshares                                 
XCRA      	Xcerra Corp                                       
XELB      	Xcel Brands Inc                                   
XENE      	Xenon Pharmaceuticals Inc                         
XENT      	Intersect Ent Inc                                 
XGTI      	XG Technology Inc                                 
XGTIW     	XG Technology Inc                                 
XIV       	Daily Inverse VIX ST ETN Velocityshares           
XLNX      	Xilinx Inc                                        
XLRN      	Acceleron Pharma Inc                              
XNCR      	Xencor Inc                                        
XNET      	Xunlei Ltd                                        
XNPT      	Xenoport Inc                                      
XOMA      	Xoma Ltd                                          
XONE      	The Exone Company                                 
XOOM      	Xoom Corp                                         
XPLR      	Xplore Tech Corp De                               
XRAY      	Dentsply International Inc                        
XTLB      	Xtl Biopharma Ads                                 
XXIA      	IXIA                                              
YCB       	Your Community Bankshares Inc                     
YDIV      	International Multi-Asset Diver                   
YDLE      	Yodlee Inc                                        
YECO      	Yulong Eco-Materials                              
YHOO      	Yahoo! Inc                                        
YLCO      	Global X Yieldco Index ETF                        
YNDX      	Yandex N.V.                                       
YOD       	You On Demand Holdings Inc                        
YORW      	The York Water Company                            
YPRO      	Advisorshares Trust                               
YRCW      	YRC Worldwide                                     
YY        	YY Inc                                            
Z         	Zillow Inc.                                       
ZAGG      	Zagg Inc                                          
ZAIS      	Zais Group Holdings Inc                           
ZAZA      	Zaza Energy Corp                                  
ZBIO      	Proshares Ultrapro Short Nasdaq                   
ZBRA      	Zebra Technologies Corp                           
ZEUS      	Olympic Steel                                     
ZFGN      	Zafgen Inc                                        
ZG        	Zillow Group Inc.                                 
ZGNX      	Zogenix Inc                                       
ZHNE      	Zhone Technologies                                
ZINC      	Horsehead Holding                                 
ZION      	Zions Bancorporation                              
ZIONW     	Zions Bancorporation                              
ZIOP      	Ziopharm Oncology Inc                             
ZIV       	Daily Inverse VIX Mt ETN Velocityshares           
ZIXI      	Zix Corp                                          
ZLTQ      	Zeltiq Aesthetics Inc                             
ZN        	Zion Oil & Gas Inc                                
ZNGA      	Zynga Inc                                         
ZSAN      	Zosano Pharma Corp                                
ZSPH      	Zs Pharma Inc                                     
ZU        	Zulily Inc                                        
ZUMZ      	Zumiez Inc                                        
ZYNE      	Zynerba Pharmaceuticals                           
