20MICRONS 	20 MICRONS LTD                                    
3IINFOTECH	3I INFOTECH LTD.                                  
3MINDIA   	3M INDIA LIMITED                                  
AARTIDRUGS	AARTI DRUGS LTD.                                  
AARTIIND  	AARTI INDUSTRIES LTD                              
AARVEEDEN 	AARVEE DEN. & EXP. LTD                            
ABAN      	ABAN OFFSHORE LTD.                                
ABB       	ABB LTD.                                          
ABBOTINDIA	ABBOTT INDIA LIMITED                              
ABCIL     	ADITYA BIRLA CHEM (I) LTD                         
ABGSHIP   	ABG SHIPYARD LTD                                  
ABIRLANUVO	ADITYA BIRLA NUVO LIMITED                         
ACC       	ACC LIMITED                                       
ACE       	ACTION CONST EQUIP LTD                            
ACROPETAL 	ACROPETAL TECH LTD                                
ADANIENT  	ADANI ENTERPRISES LIMITED                         
ADANIPOWER	ADANI POWER LTD                                   
ADFFOODS  	ADF FOODS LIMITED                                 
ADHUNIK   	ADHUNIK METALIKS LTD.                             
ADORWELD  	ADOR WELDING LTD                                  
ADSL      	ALLIED DIGITAL SERV. LTD                          
ADVANIHOTR	ADVANI HOT.& RES.(I) LTD                          
ADVANTA   	ADVANTA INDIA LTD                                 
AEGISCHEM 	AEGIS LOGISTICS LIMITED                           
AFL       	ACCEL FRONTLINE LTD                               
AGCNET    	AGC NETWORKS LIMITED                              
AGRODUTCH 	AGRO DUTCH INDUSTRIES LTD                         
AHLEAST   	                                                  
AHLUCONT  	AHLUWALIA CONT IND LTD                            
AHLWEST   	ASIAN HOTELS (WEST) LTD                           
AIAENG    	AIA ENGINEERING LIMITED                           
AJANTPHARM	AJANTA PHARMA LIMITED                             
AJMERA    	AJMERA REALTY & INF I LTD                         
AKSHOPTFBR	AKSH OPTIFIBRE LIMITED                            
AKZOINDIA 	AKZO NOBEL INDIA LIMITED                          
ALBK      	ALLAHABAD BANK                                    
ALCHEM    	ALCHEMIST LTD                                     
ALEMBICLTD	ALEMBIC LIMITED                                   
ALKALI    	ALKALI METALS LTD                                 
ALKYLAMINE	ALKYL AMINES CHEM. LTD                            
ALLCARGO  	ALLCARGO GLOBAL LOG. LTD.                         
ALLSEC    	ALLSEC TECHNOLOGIES LTD                           
ALMONDZ   	ALMONDZ GLOBAL SEC LTD                            
ALOKTEXT  	ALOK INDUSTRIES LTD                               
ALPHAGEO  	ALPHAGEO (INDIA) LIMITED                          
ALPSINDUS 	ALPS INDUSTRIES LTD                               
AMARAJABAT	AMARA RAJA BATTERIES LTD.                         
AMBIKCO   	AMBIKA COTTON MILL LTD.                           
AMBUJACEM 	AMBUJA CEMENTS LTD                                
AMDIND    	AMD INDUSTRIES LIMITED                            
AMRUTANJAN	AMRUTAJAN HEALTH LTD                              
AMTEKAUTO 	AMTEK AUTO LTD.                                   
ANANTRAJ  	ANANT RAJ INDUS LTD                               
ANDHRABANK	ANDHRA BANK                                       
ANDHRACEMT	ANDHRA CEMENTS LIMITED                            
ANDHRSUGAR	ANDHRA SUGARS LTD                                 
ANGIND    	ANG INDUSTRIES LIMITED                            
ANSALAPI  	ANSAL PROP & INFRA LTD                            
ANSALHSG  	ANSAL HOU. & CON. LTD.                            
APARINDS  	APAR INDUSTRIES LTD.                              
APCOTEXIND	APCOTEX INDUSTRIES LIMITE                         
APOLLOHOSP	APOLLO HOSPITALS ENTER. L                         
APOLLOTYRE	APOLLO TYRES LTD                                  
APTECHT   	APTECH LIMITED                                    
ARCHIDPLY 	ARCHIDPLY IND. LTD                                
ARCHIES   	ARCHIES LTD                                       
ARIES     	ARIES AGRO LTD.                                   
ARIHANT   	ARIHANT FOUN & HOU LTD                            
AROGRANITE	ARO GRANITE IND. LTD.                             
ARROWTEX  	ARROW TEXTILES LIMITED                            
ARSHIYA   	ARSHIYA INTERNATIONAL LTD                         
ARSSINFRA 	ARSS INFRA PROJ. LTD                              
ARVIND    	ARVIND LIMITED                                    
ASAHIINDIA	ASAHI INDIA GLASS LIMITED                         
ASAL      	AUTOMOTIVE STAMPINGS & AS                         
ASHAPURMIN	ASHAPURA MINECHEM LTD                             
ASHIANA   	ASHIANA HOUSING LTD                               
ASHIMASYN 	ASHIMA LTD                                        
ASHOKA    	ASHOKA BUILDCON LTD                               
ASHOKLEY  	ASHOK LEYLAND LTD                                 
ASIANHOTNR	ASIAN HOTELS (NORTH) LTD                          
ASIANPAINT	ASIAN PAINTS LIMITED                              
ASIANTILES	ASIAN GRANITO IND. LTD.                           
ASSAMCO   	ASSAM COMPANY INDIA LTD                           
ASTEC     	ASTEC LIFESCIENCES LTD                            
ASTRAL    	ASTRAL POLY TECH LTD                              
ASTRAMICRO	ASTRA MICROWAVE LTD                               
ASTRAZEN  	ASTRAZENECA PHARMA IND LT                         
ATFL      	AGRO TECH FOODS LIMITED                           
ATLANTA   	ATLANTA LIMITED                                   
ATLASCYCLE	ATLAS CYCLE (HARYANA) LTD                         
ATNINTER  	ATN INTERNATIONAL LTD                             
ATUL      	ATUL LTD                                          
AURIONPRO 	AURIONPRO SOLN LTD                                
AUROPHARMA	AUROBINDO PHARMA LTD                              
AUSTRAL   	AUSTRAL COKE & PRO LTD                            
AUTOAXLES 	AUTOMOTIVE AXLES LIMITED                          
AUTOIND   	AUTOLINE INDUSTRIES LTD                           
AUTOLITIND	AUTOLITE (INDIA) LIMITED                          
AVTNPL    	AVT NATURAL PRODUCTS LTD                          
AXISBANK  	AXIS BANK LIMITED                                 
AXISGOLD  	AXIS MF - AXIS GOLD ETF                           
BAGFILMS  	B.A.G FILMS AND MEDIA LTD                         
BAJAJ-AUTO	BAJAJ AUTO LIMITED                                
BAJAJCORP 	BAJAJ CORP LIMITED                                
BAJAJELEC 	BAJAJ ELECT.LTD                                   
BAJAJFINSV	BAJAJ FINSERV LTD.                                
BAJAJHIND 	BAJAJ HINDUSTAN LTD                               
BAJAJHLDNG	BAJAJ HOLDINGS & INVS LTD                         
BAJFINANCE	BAJAJ FINANCE LIMITED                             
BALAJITELE	BALAJI TELEFILMS LIMITED.                         
BALAMINES 	BALAJI AMINES LIMITED                             
BALKRISIND	BALKRISHNA IND. LTD                               
BALLARPUR 	BALLARPUR INDUSTRIES LTD                          
BALMLAWRIE	BALMER LAWRIE & CO LTD                            
BALPHARMA 	BAL PHARMA LTD.                                   
BALRAMCHIN	BALRAMPUR CHINI MILLS LTD                         
BANARISUG 	BANNARI AMMAN SUGARS LTD                          
BANCOINDIA	BANCO PRODUCTS (I) LTD                            
BANG      	BANG OVERSEAS LTD.                                
BANKBARODA	BANK OF BARODA                                    
BANKBEES  	BENCHMARK BANKBEES                                
BANKINDIA 	BANK OF INDIA                                     
BANKNIFTY 	BANK NIFTY                                        
BANSWRAS  	BANSWARA SYNTEX LIMITED                           
BARTRONICS	BARTRONICS INDIA LIMITED                          
BASF      	BASF INDIA LTD                                    
BASML     	BANNARI AM SPIN MILL LTD.                         
BATAINDIA 	BATA INDIA LTD                                    
BAYERCROP 	BAYER CROPSCIENCE LTD                             
BBL       	BHARAT BIJLEE LTD                                 
BBTC      	BOMBAY BURMAH TRADING COR                         
BEDMUTHA  	BEDMUTHA INDUST LTD                               
BEL       	BHARAT ELECTRONICS LTD                            
BEML      	BEML LIMITED                                      
BERGEPAINT	BERGER PAINTS (I) LTD                             
BFINVEST  	BF INVESTMENT LIMITED                             
BFUTILITIE	BF UTILITIES LIMITED                              
BGRENERGY 	BGR ENERGY SYSTEMS LTD                            
BHAGYNAGAR	BHAGYANAGAR INDIA LIMITED                         
BHARATFORG	BHARAT FORGE LTD                                  
BHARATGEAR	BHARAT GEARS LTD.                                 
BHARATRAS 	BHARAT RASAYAN LTD                                
BHARTIARTL	BHARTI AIRTEL LIMITED                             
BHEL      	BHEL                                              
BHUSANSTL 	BHUSHAN STEEL LIMITED                             
BIL       	BHARTIYA INTERNATIONAL                            
BILENERGY 	BIL ENERGY SYSTEMS LTD                            
BILPOWER  	BILPOWER LIMITED                                  
BINANIIND 	BINANI INDUSTRIES LTD                             
BINDALAGRO	OSWAL CHEM. & FERT. LTD.                          
BIOCON    	BIOCON LIMITED.                                   
BIRLACORPN	BIRLA CORPORATION LTD                             
BIRLACOT  	BIRLA COTSYN LTD                                  
BIRLAMONEY	ADITYA BIRLA MONEY LTD                            
BLBLIMITED	BLB LIMITED                                       
BLISSGVS  	BLISS GVS PHARMA LTD                              
BLKASHYAP 	B.L.KASHYAP & SON LTD                             
BLUECHIP  	BLUE CHIP INDIA LIMITED                           
BLUEDART  	BLUE DART EXPRESS LTD                             
BLUESTARCO	BLUE STAR LIMITED                                 
BLUESTINFO	BLUE STAR INFOTECH                                
BOMDYEING 	BOMBAY DYEING & MFG. CO L                         
BOSCHLTD  	BOSCH LIMITED                                     
BPCL      	BHARAT PETROLEUM CORP  LT                         
BPL       	BPL LTD                                           
BRFL      	BOMBAY RAYON FASHIONS LTD                         
BRIGADE   	BRIGADE ENTER. LTD                                
BRITANNIA 	8.25% SEC RED NCD                                 
BROADCAST 	BROADCAST INITIAT LTD                             
BSELINFRA 	BSEL INFRASTRUCTURE REALT                         
BSL       	BSL LTD                                           
BSLGOLDETF	BIRLA SL GOLD ETF - GO                            
BURNPUR   	BURNPUR CEMENT LTD.                               
BVCL      	BARAK VALLEY CEM. LTD.                            
CADILAHC  	CADILA HEALTHCARE LIMITED                         
CAIRN     	CAIRN INDIA LIMITED                               
CALSOFT   	CALIFORNIA SOFTWARE CO LT                         
CANBK     	CANARA BANK                                       
CANDC     	C&C CONST. LTD.                                   
CANFINHOME	CAN FIN HOMES LTD                                 
CANTABIL  	CANTABIL RETAIL LTD                               
CARBORUNIV	CARBORUNDUM UNIVERSAL LTD                         
CCCL      	CONS. CONST. CONSORT LTD                          
CCL       	CCL PRODUCTS (I) LTD                              
CEATLTD   	CEAT LIMITED                                      
CEBBCO    	COMMERCIAL ENG & CO. LTD                          
CELEBRITY 	CELEBRITY FASHIONS LTD                            
CELESTIAL 	CELESTIAL BIOLABS LTD                             
CENTENKA  	CENTURY ENKA LTD                                  
CENTEXT   	CENTURY EXTRUSIONS LTD                            
CENTRALBK 	CENTRAL BANK OF INDIA                             
CENTUM    	CENTUM ELECTRONICS LTD                            
CENTURYPLY	CENTURY PLYBOARDS (I) LTD                         
CENTURYTEX	CENTURY TEXTILES LTD                              
CERA      	CERA SANITARYWARE LTD                             
CESC      	CESC LTD                                          
CHAMBLFERT	CHAMBAL FERTILIZERS LTD                           
CHEMFALKAL	CHEMFAB ALKALIS LTD                               
CHENNPETRO	CHENNAI PETROLEUM CORP LT                         
CHOLAFIN  	CHOLAMANDALAM IN & FIN CO                         
CINEVISTA 	CINEVISTAAS LTD                                   
CIPLA     	CIPLA LTD                                         
CLNINDIA  	CLARIANT CHEMICALS (INDIA                         
COALINDIA 	COAL INDIA LTD                                    
COLPAL    	COLGATE PALMOLIVE LTD.                            
CONCOR    	CONTAINER CORP OF IND LTD                         
CONSOFINVT	CONSO. FIN. & HOLD. LTD.                          
CORDSCABLE	CORDS CABLE INDUS LTD.                            
COROMANDEL	COROMANDEL INTERNTL. LTD                          
CORPBANK  	CORPORATION BANK                                  
COSMOFILMS	COSMO FILMS LTD                                   
COX&KINGS 	COX & KINGS LIMITED                               
CREATIVEYE	CREATIVE EYE LIMITED                              
CRISIL    	CRISIL LTD                                        
CROMPGREAV	CROMPTON GREAVES LTD                              
CTE       	CAMBRIDGE TECH ENTER LTD                          
CUB       	CITY UNION BANK LTD                               
CUMMINSIND	CUMMINS INDIA LTD                                 
CURATECH  	CURA TECHNOLOGIES LTD                             
CYBERMEDIA	CYBER MEDIA (INDIA) LTD.                          
CYBERTECH 	CYBERTECH SYSTEMS & SOFTW                         
DAAWAT    	LT FOODS LIMITED                                  
DABUR     	DABUR INDIA LTD                                   
DALMIASUG 	DALMIA BHARAT SUG IN LTD                          
DATAMATICS	DATAMATICS GLOBAL SER LTD                         
DBCORP    	D.B.CORP LTD                                      
DBREALTY  	D B REALTY LIMITED                                
DCM       	DCM LTD                                           
DCW       	DCW LTD                                           
DECCANCE  	DECCAN CEMENTS LIMITED                            
DEEPAKFERT	DEEPAK FERTILIZERS & PETR                         
DEEPAKNTR 	DEEPAK NITRITE LTD                                
DEEPIND   	DEEP INDUSTRIES LTD                               
DELTACORP 	DELTA CORP LIMITED                                
DELTAMAGNT	DELTA MAGNETS LIMITED                             
DEN       	DEN NETWORKS LTD                                  
DENABANK  	DENA BANK                                         
DENORA    	DE NORA INDIA LIMITED                             
DHAMPURSUG	DHAMPUR SUGAR MILLS LTD                           
DHANBANK  	DHANLAXMI BANK LIMITED                            
DHANUKA   	DHANUKA AGRITECH LTD                              
DHARSUGAR 	DHARANI SUGARS & CHEMICAL                         
DHUNINV   	DHUNSERI INVESTMENTS LTD                          
DIAPOWER  	DIAMOND POWER INFRA LTD                           
DICIND    	DIC INDIA LIMITED                                 
DIGJAM    	DIGJAM LIMITED                                    
DISHMAN   	DISHMAN PHARMA & CHEM LTD                         
DISHTV    	DISH TV INDIA LTD.                                
DIVISLAB  	DIVI'S LABORATORIES LTD                           
DLF       	DLF LIMITED                                       
DLINKINDIA	D-LINK INDIA LTD                                  
DOLPHINOFF	DOLPHIN OFF. ENT IND LTD.                         
DONEAR    	DONEAR IND. LIMITED                               
DPSCLTD   	DPSC LIMITED                                      
DQE       	DQ ENTERTAINMENT INT LTD                          
DREDGECORP	DREDGING CORP OF INDIA                            
DRREDDY   	9.25% UNSEC RED NCD                               
DSKULKARNI	D S KULKARNI DEVELOPERS L                         
DWARKESH  	DWARIKESH SUGAR IND LTD                           
DYNAMATECH	DYNAMATIC TECHNOLOGIES                            
EASTSILK  	EASTERN SILK INDUSTRIES L                         
EASUNREYRL	EASUN REYROLLE LTD                                
ECEIND    	ECE INDUSTRIES LTD.                               
ECLERX    	ECLERX SERVICES LTD                               
EDELWEISS 	EDELWEISS CAP LTD                                 
EDL       	EMPEE DISTI. LTD.                                 
EDUCOMP   	EDUCOMP SOLUTIONS LTD                             
EICHERMOT 	EICHER MOTORS LTD                                 
EIDPARRY  	EID PARRY INDIA LTD                               
EIHAHOTELS	EIH ASSOCIATED HOTELS LTD                         
EIHOTEL   	EIH LIMITED                                       
EKC       	EVEREST KANTO CYLINDERLTD                         
ELDERPHARM	ELDER PHARMACEUTICALS LTD                         
ELECON    	ELECON ENG. CO. LTD                               
ELECTCAST 	ELECTROSTEEL CASTINGS LTD                         
ELECTHERM 	ELECTROTHERM (I) LTD.                             
ELGIEQUIP 	ELGI EQUIPMENTS LTD                               
EMAMIINFRA	EMAMI INFRASTRUCTURE LTD                          
EMAMILTD  	EMAMI LIMITED                                     
EMCO      	EMCO LIMITED                                      
EMKAY     	EMKAY GLOBAL FIN SERV LTD                         
EMMBI     	EMMBI POLYARNS LTD                                
ENERGYDEV 	ENERGY DEVE. CO.LTD                               
ENGINERSIN	ENGINEERS INDIA LTD                               
ENIL      	ENTERTAIN NET. IND. LTD.                          
ERAINFRA  	ERA INFRA ENGINEERING LTD                         
EROSMEDIA 	EROS INTL MEDIA LTD                               
ESABINDIA 	ESAB INDIA LTD                                    
ESCORTS   	ESCORTS INDIA LTD                                 
ESL       	ELECTROSTEEL STEELS LTD                           
ESSAROIL  	ESSAR OIL LTD                                     
ESSARPORTS	ESSAR PORTS LIMITED                               
ESSDEE    	ESS DEE ALUM LTD                                  
ESSELPACK 	ESSEL PROPACK LTD                                 
ESTER     	ESTER INDUSTRIES LTD                              
EUROCERA  	EURO CERAMICS LTD                                 
EUROMULTI 	EURO MULTIVISION LTD                              
EUROTEXIND	EUROTEX INDUSTRIES LTD                            
EVEREADY  	EVEREADY INDS. IND.  LTD.                         
EVERESTIND	EVEREST INDUSTRIES LTD                            
EVERONN   	EVERONN EDUCATION LIMITED                         
EXCELCROP 	EXCEL CROP CARE LTD                               
EXCELINDUS	EXCEL INDUSTRIES LTD                              
EXIDEIND  	EXIDE INDUSTRIES LTD                              
FACT      	FACT LTD                                          
FAGBEARING	FAG BEARINGS INDIA LTD                            
FARMAXIND 	FARMAX INDIA LTD                                  
FCSSOFT   	FCS SOFTWARE SOLN. LTD.                           
FDC       	FDC LIMITED                                       
FEDDERLOYD	FEDDERS LLOYDS CORPORATIO                         
FEDERALBNK	FEDERAL BANK LTD                                  
FIEMIND   	FIEM INDUSTRIES LIMITED                           
FINANTECH 	FINANCIAL TECHNO (I) LTD                          
FINCABLES 	FINOLEX CABLES LTD                                
FINPIPE   	FINOLEX INDUSTRIES LTD                            
FIRSTWIN  	FIRST WIN IND. LTD.                               
FMGOETZE  	FEDERAL-MOGUL GOETZE (IND                         
FORTIS    	FORTIS HEALTHCARE (I) LTD                         
FOSECOIND 	FOSECO INDIA LTD                                  
FSL       	FIRSTSOURCE SOLU. LTD.                            
GABRIEL   	GABRIEL INDIA LTD                                 
GAEL      	GUJARAT AMBUJA EXPORTS LT                         
GAIL      	GAIL (INDIA) LTD                                  
GAL       	GYSCOAL ALLOYS LTD                                
GALLANTT  	GALLANTT METAL LIMITED                            
GALLISPAT 	GALLANTT ISPAT LTD                                
GAMMNINFRA	GAMMON INFRA PROJ LTD.                            
GAMMONIND 	GAMMON INDIA LTD                                  
GANDHITUBE	                                                  
GANESHHOUC	GANESH HOUSING CORP LTD                           
GANGOTRI  	GANGOTRI TEXTILES LTD.                            
GARDENSILK	GARDEN SILK MILLS LTD                             
GARWALLROP	GARWARE-WALL ROPES LTD                            
GATI      	GATI LIMITED                                      
GDL       	GATEWAY DISTRIPARKS LTD.                          
GEECEE    	GEECEE VENTURES LIMITED                           
GEINDSYS  	GEI IND SYSTEMS LTD                               
GEMINI    	GEMINI COMM. LTD                                  
GENESYS   	GENESYS INTL CORPN LTD                            
GENUSPOWER	GENUS POWER INFRASTRU LTD                         
GEOJITBNPP	GEOJIT BNP P. FIN SER LTD                         
GEOMETRIC 	GEOMETRIC LIMITED                                 
GESHIP    	THE GE SHPG.LTD                                   
GHCL      	GHCL LIMITED                                      
GICHSGFIN 	GIC HOUSING FINANCE LTD                           
GILLANDERS	GILLANDERS ARBUTHNOT LTD                          
GILLETTE  	GILLETTE INDIA LTD                                
GINNIFILA 	GINNI FILAMENTS LTD                               
GIPCL     	GUJ IND POW CO. LTD                               
GISOLUTION	GI ENGINEERING SOLNS LTD                          
GITANJALI 	GITANJALI GEMS LIMITED                            
GKWLIMITED	GKW LIMITED                                       
GLAXO     	GLAXOSMITHKLINE PHARMA LT                         
GLENMARK  	GLENMARK PHARMACEUTICALS                          
GLFL      	GUJARAT LEASE FINANCING L                         
GLOBALVECT	GLOBAL VEC HELICORP LTD                           
GLOBOFFS  	GLOBAL OFFSHORE SERV LTD                          
GLOBUSSPR 	GLOBUS SPIRITS LTD                                
GMBREW    	G M BREWERIES LTD                                 
GMDCLTD   	GUJARAT MINERAL DEV CORP                          
GMRINFRA  	GMR INFRASTRUCTURE LTD.                           
GNFC      	GUJARAT NARMADA FERT. CO                          
GOACARBON 	GOA CARBON LIMITED                                
GODFRYPHLP	GODFREY PHILLIPS INDIA LT                         
GODREJCP  	GODREJ CONSUMER PRODUCTS                          
GODREJIND 	GODREJ INDUSTRIES LTD                             
GODREJPROP	GODREJ PROPERTIES LTD                             
GOKEX     	GOKALDAS EXPORTS LTD.                             
GOKUL     	GOKUL REFOILS & SOLV LTD                          
GOLDBEES  	BENCHMARK GOLDBEES                                
GOLDENTOBC	GOLDEN TOBACCO LIMITED                            
GOLDIAM   	GOLDIAM INTERNATIONAL LTD                         
GOLDINFRA 	GOLDSTONE INFRATECH LTD                           
GOLDSHARE 	UTI GOLD ETF                                      
GOLDTECH  	GOLDSTONE TECHNOLOGIES LT                         
GPIL      	GODAWARI POW & ISP LTD                            
GPPL      	GUJARAT PIPAVAV PORT LTD                          
GRANULES  	GRANULES INDIA LIMITED                            
GRAPHITE  	GRAPHITE INDIA LTD                                
GRASIM    	GRASIM INDUSTRIES LTD                             
GRAVITA   	GRAVITA INDIA LIMITED                             
GREAVESCOT	GREAVES COTTON LTD.                               
GREENPLY  	GREENPLY INDUSTRIES LTD                           
GREENPOWER	ORIENT GREEN POWER CO LTD                         
GRINDWELL 	GRINDWELL NORTON LIMITED                          
GRUH      	GRUH FINANCE LTD.                                 
GSFC      	GUJ STATE FERT & CHEM LTD                         
GSKCONS   	GLAXOSMITHKLINE CONSUMER                          
GSPL      	GUJARAT STATE PETRO LTD                           
GTL       	GTL LTD                                           
GTLINFRA  	GTL INFRA.LTD                                     
GTNIND    	GTN INDUSTRIES LIMITED                            
GTNTEX    	GTN TEXTILES LIMITED                              
GTOFFSHORE	GREAT OFFSHORE LTD                                
GUFICBIO  	GUFIC BIOSCIENCES LTD.                            
GUJALKALI 	GUJARAT ALKALIES & CHEM                           
GUJAPOLLO 	GUJ. APOLLO IND. LTD.                             
GUJFLUORO 	GUJARAT FLUOROCHEMICALS L                         
GUJNRECOKE	GUJARAT N R E COKE LTD                            
GUJNREDVR 	GUJ NRE DVR 'B' CLASS                             
GVKPIL    	GVK POW. & INFRA LTD.                             
HANUNG    	HANUNG TOYS & TEX LTD                             
HARITASEAT	HARITA SEATING SYS. LTD                           
HARRMALAYA	HARRISON MALAYALAM LTD                            
HATHWAY   	HATHWAY CABLE & DATACOM                           
HAVELLS   	HAVELLS INDIA LIMITED                             
HBLPOWER  	HBL POWER SYSTEMS LTD.                            
HBSTOCK   	HB STOCKHOLDINGS LIMITED                          
HCC       	HINDUSTAN CONSTRUCTION CO                         
HCIL      	HIMADRI CHEM. & IND. LTD                          
HCL-INSYS 	HCL INFOSYSTEMS LTD                               
HCLTECH   	HCL TECHNOLOGIES LTD                              
HDFC      	HDFC LTD WARRANTS                                 
HDFCBANK  	HDFC BANK LTD                                     
HDFCMFGETF	HDFC GOLD ETF                                     
HDIL      	HOUSING DEV & INFRA LTD                           
HEG       	HEG LTD                                           
HEIDELBERG	HEIDELBERGCEMENT (I) LTD                          
HERCULES  	HERCULES HOI. LTD.                                
HERITGFOOD	HERITAGE FOODS (INDIA) LT                         
HEXAWARE  	HEXAWARE TECHNOLOGIES LTD                         
HFCL      	HIMACHAL FUT COM LTD                              
HIKAL     	HIKAL LIMITED                                     
HILTON    	HILTON METAL FORGING LTD                          
HIMATSEIDE	HIMATSINGKA SEIDE LTD                             
HINDALCO  	HINDALCO  INDUSTRIES  LTD                         
HINDCOMPOS	HINDUSTAN COMPOSITES LTD.                         
HINDCOPPER	HINDUSTAN COPPER LTD                              
HINDDORROL	HINDUSTAN DORR OLIVER LTD                         
HINDMOTORS	HINDUSTAN MOTORS LIMITED                          
HINDNATGLS	HIND NATL GLASS & IND LTD                         
HINDOILEXP	HINDUSTAN OIL EXPLORATION                         
HINDPETRO 	HINDUSTAN PETROLEUM CORP                          
HINDSYNTEX	HIND SYNTEX LTD.                                  
HINDUJAFO 	HINDUJA FOUNDRIES LIMITED                         
HINDUJAVEN	HINDUJA VENTURES LIMITED                          
HINDUNILVR	HINDUSTAN UNILEVER LTD.                           
HINDZINC  	HINDUSTAN ZINC LIMITED                            
HIRECT    	HIND RECTIFIER LIMITED                            
HITACHIHOM	HITACHI HOME & LIFE SOLUT                         
HITECHGEAR	HI-TECH GEARS LTD                                 
HITECHPLAS	HITECH PLAST LIMITED                              
HMT       	HINDUSTAN MACHINE TOOLS L                         
HMVL      	HINDUSTAN MEDIA VENT LTD                          
HNGSNGBEES	HANG SENG BENCHMARK ETS                           
HOCL      	HINDUSTAN ORGANIC CHEMICA                         
HONAUT    	HONEYWELL AUTOMATION IND                          
HONDAPOWER	HONDA SIEL POWER PROD LTD                         
HOTELEELA 	HOTEL LEELA VENTURES LTD                          
HOTELRUGBY	HOTEL RUGBY LTD                                   
HOVS      	HOV SERVICES LTD                                  
HSIL      	HSIL LIMITED                                      
HTMEDIA   	HT MEDIA LIMITED                                  
IBREALEST 	INDIABULLS REAL EST. LTD                          
ICICIBANK 	ICICI BANK LTD.                                   
ICIL      	INDO COUNT INDUSTRIES LTD                         
ICRA      	ICRA LIMITED                                      
ICSA      	ICSA (INDIA) LIMITED                              
IDBI      	IDBI BANK LIMITED                                 
IDEA      	IDEA CELLULAR LIMITED                             
IDFC      	INFRA. DEV. FIN. CO. LTD                          
IFBAGRO   	IFB AGRO INDUSTRIES LTD                           
IFBIND    	IFB INDUSTRIES LTD                                
IFCI      	IFCI LTD                                          
IFGLREFRAC	IFGL REFRACTORIES LTD                             
IGARASHI  	IGARASHI MOTORS INDIA LTD                         
IGL       	INDRAPRASTHA GAS LTD                              
IGPL      	I G PETROCHEMICALS LTD                            
IITL      	INDUSTRIAL INV TRUST LTD                          
IL&FSENGG 	IL&FS ENG AND CONS CO LTD                         
IL&FSTRANS	IL&FS TRANS NET LTD                               
IMFA      	INDIAN METALS & FERRO                             
IMPAL     	IND MOTOR PART & ACC LTD                          
IMPEXFERRO	IMPEX FERRO TECH LIMITED                          
INDBANK   	INDBANK MERCH BANK                                
INDHOTEL  	THE INDIAN HOTELS CO. LTD                         
INDIACEM  	THE INDIA CEMENTS LIMITED                         
INDIAGLYCO	INDIA GLYCOLS LTD                                 
INDIANB   	INDIAN BANK                                       
INDIANCARD	INDIAN CARD CLOTHING CO.                          
INDIANHUME	INDIAN HUME PIPE CO. LTD.                         
INDIAVIX  	INDIA VIX                                         
INDLMETER 	IMP POWERS LTD                                    
INDNIPPON 	INDIA NIPPON ELECT  LTD                           
INDOCO    	INDOCO REMEDIES LTD.                              
INDORAMA  	INDO RAMA SYNTHETICS LTD                          
INDOSOLAR 	INDOSOLAR LIMITED                                 
INDOTECH  	INDO TECH TRANSFORM LTD.                          
INDRAMEDCO	INDRAPRASTHA MEDICAL CORP                         
INDSWFTLAB	IND SWIFT LABORATORIES LT                         
INDTERRAIN	IND TERRAIN FASHIONS LTD                          
INDUSINDBK	INDUSIND BANK LIMITED                             
INFINITE  	INFINITE COMPUTER SOL LTD                         
INFOMEDIA 	INFOMEDIA 18 LIMITED                              
INFRABEES 	INFRA BENCHMARK ETS                               
INFY      	INFOSYS LIMITED                                   
INGERRAND 	INGERSOLL-RAND INDIA LTD                          
INOXLEISUR	INOX LEISURE LIMITED                              
INSECTICID	INSECTICIDES (I) LTD                              
IOB       	INDIAN OVERSEAS BANK                              
IOC       	INDIAN OIL CORP LTD                               
IOLCP     	IOL CHEM AND PHARMA LTD                           
IPCALAB   	IPCA LABORATORIES LTD                             
IRB       	IRB INFRA DEV LTD.                                
ISFT      	INTRASOFT TECH. LTD                               
ISMTLTD   	ISMT LIMITED                                      
ITC       	ITC LTD                                           
ITDCEM    	ITD CEMENTATION INDIA LTD                         
ITI       	ITI LTD                                           
IVC       	IL&FS INVESTMENT MANAGERS                         
IVP       	IVP LTD                                           
IVRCLINFRA	IVRCL LIMITED                                     
J&KBANK   	J & K BANK LTD.                                   
JAGRAN    	JAGRAN PRAKASHAN LIMITED                          
JAGSNPHARM	JAGSONPAL PHARMACEUTICALS                         
JAIBALAJI 	JAI BALAJI INDUSTRIES LTD                         
JAICORPLTD	JAI CORP LIMITED                                  
JAMNAAUTO 	JAMNA AUTO IND LTD                                
JAYAGROGN 	JAYANT AGRO ORGANICS LTD                          
JAYBARMARU	JAY BHARAT MARUTI LTD                             
JAYNECOIND	JAYASWAL NECO INDUSTR LTD                         
JAYSREETEA	JAYSHREE TEA & INDUSTRIES                         
JBCHEPHARM	J B CHEMICALS AND PHARMA                          
JBFIND    	JBF INDUSTRIES LTD                                
JCTEL     	JCT ELE. LTD                                      
JENSONICOL	JENSON & NICHOLSON (IND)                          
JETAIRWAYS	JET AIRWAYS (INDIA) LTD.                          
JIKIND    	JIK INDUSTRIES LTD                                
JINDALPHOT	JINDAL PHOTO LIMITED                              
JINDALPOLY	JINDAL POLY FILMS LIMITED                         
JINDALSAW 	JINDAL SAW LIMITED                                
JINDALSTEL	JINDAL STEEL & POWER LTD                          
JINDCOT   	JINDAL COTEX LTD                                  
JINDRILL  	JINDAL DRILLING IND. LTD                          
JINDWORLD 	JINDAL WORLDWIDE LTD                              
JISLJALEQS	JAIN IRRIGATION SYSTEMS                           
JKCEMENT  	JK CEMENT LIMITED                                 
JKIL      	JKUMAR INFR.LTD.                                  
JKLAKSHMI 	JK LAKSHMI CEMENT LTD                             
JKPAPER   	JK PAPER LIMITED                                  
JKTYRE    	JK TYRE & INDUSTRIES LTD                          
JMCPROJECT	JMC PROJECTS (I) LTD.                             
JMFINANCIL	JM FINANCIAL LIMITED                              
JMTAUTOLTD	JMT AUTO LIMITED                                  
JOCIL     	JOCIL LIMITED                                     
JPASSOCIAT	JAIPRAKASH ASSOCIATES LTD                         
JPINFRATEC	JAYPEE INFRATECH LTD                              
JPPOWER   	JAIPRAKASH POWER VEN. LTD                         
JSL       	JSL STAINLESS LIMITED                             
JSWENERGY 	JSW ENERGY LIMITED                                
JSWSTEEL  	JSW STEEL LIMITED                                 
JUBILANT  	JUBILANT LIFE SCIENCE LTD                         
JUBLFOOD  	JUBILANT FOODWORKS LTD                            
JUBLINDS  	JUBILANT INDUSTRIES LTD                           
JUNIORBEES	NIFTY JR BENCHMARK ETF                            
JVLAGRO   	JVL AGRO INDUSTRIES LTD                           
JYOTHYLAB 	JYOTHY LABS LTD                                   
JYOTISTRUC	JYOTI STRUCTURES LTD                              
KABRAEXTRU	KABRA EXTRUSION TECHNIK L                         
KAJARIACER	KAJARIA CERAMICS LTD                              
KAKATCEM  	KAKATIYA CEM SUGAR &IND L                         
KALINDEE  	KALINDEE RAIL NR. (E) LTD                         
KALPATPOWR	KALPATARU POWER TRANS. LT                         
KAMATHOTEL	KAMAT HOTELS (I) LTD                              
KANORICHEM	KANORIA CHEMICALS & INDUS                         
KANSAINER 	KANSAI NEROLAC PAINTS LTD                         
KARMAENG  	KARMA ENERGY LIMITED                              
KARURVYSYA	KARUR VYSYA BANK LTD                              
KAUSHALYA 	KAUSHALYA INFRA DEV LTD.                          
KAVVERITEL	KAVVERI TEL. LTD.                                 
KCP       	KCP LTD                                           
KCPSUGIND 	KCP SUGAR IND CORP LTD.                           
KEC       	KEC INTL. LIMITED                                 
KECL      	KIRLOSKAR ELECTRIC CO LTD                         
KEI       	KEI INDUSTRIES LTD.                               
KEMROCK   	KEMROCK IND LTD                                   
KESARENT  	KESAR ENTERPRISES LTD.                            
KGL       	KARUTURI GLOBAL LIMITED                           
KHAITANELE	KHAITAN ELECTRICALS LTD                           
KHAITANLTD	KHAITAN (INDIA)LTD.                               
KHANDSE   	KHANDWALA SECURITIES LTD                          
KICL      	KALYANI INVEST CO LTD                             
KIL       	KAMDHENU ISPAT LIMITED                            
KILITCH   	KILITCH DRUGS INDIA LTD                           
KIRIINDUS 	KIRI INDUSTRIES LIMITED                           
KIRLOSBROS	KIRLOSKAR BROTHERS LTD                            
KIRLOSENG 	KIRLOSKAR OIL ENG LTD                             
KIRLOSIND 	KIRLOSKAR INDUSTRIES LTD                          
KKCL      	KEWAL KIRAN CLOTHING LTD                          
KMSUGAR   	K M SUGAR MILLS LTD                               
KNRCON    	KNR CONSTRU LTD.                                  
KOHINOOR  	KOHINOOR FOODS LIMITED                            
KOLTEPATIL	KOLTE PATIL DEV. LTD.                             
KOPRAN    	KOPRAN LTD                                        
KOTAKBANK 	KOTAK MAHINDRA BANK LTD                           
KOTAKGOLD 	KOTAK GOLD ETF                                    
KOTAKNIFTY	KOTAK NIFTY ETF                                   
KOTAKPSUBK	KOTAK PSU BANK                                    
KOTARISUG 	KOTHARI SUG & CHEM LTD.                           
KOTHARIPET	KOTHARI PETROCHEM LTD                             
KOTHARIPRO	KOTHARI PRODUCTS LTD                              
KPIT      	KPIT CUMMINS INFOSYSTEMS                          
KPRMILL   	KPR MILL LTD.                                     
KRBL      	KRBL LIMITED                                      
KSBPUMPS  	KSB PUMPS LTD                                     
KSCL      	KAVERI SEED CO. LTD.                              
KSERASERA 	K SERA SERA LIMITED                               
KSK       	KSK ENERGY VENTURES LTD                           
KSL       	KALYANI STEELS LIMITED                            
KTIL      	KESAR TER & INFRA LTD                             
KTKBANK   	KARNATAKA BANK LIMITED                            
KWALITY   	KWALITY DAIRY (INDIA)                             
LAKPRE    	LAKSHMI PRE SCRE LTD                              
LAKSHMIEFL	LAKSHMI ENG. & FOODS LTD                          
LAKSHVILAS	LAKSHMI VILAS BANK LTD                            
LAOPALA   	LA OPALA RG LIMITED                               
LAXMIMACH 	LAKSHMI MACHINES LTD                              
LCCINFOTEC	LCC INFOTECH LTD                                  
LGBBROSLTD	LG BALAKRISHNAN & BROS                            
LGBFORGE  	LGB FORGE LIMITED                                 
LIBERTSHOE	LIBERTY SHOES LTD                                 
LICHSGFIN 	LIC HOUSING FINANCE LTD                           
LIQUIDBEES	LIQUID BENCHMARK ETS                              
LITL      	LANCO INFRATECH LTD.                              
LLOYDELENG	LLOYD ELECTRIC & ENGG LTD                         
LML       	LML LTD                                           
LOKESHMACH	LOKESH MACHINES LTD                               
LOTUSEYE  	LOTUS EYE HOSPITAL LTD.                           
LOVABLE   	LOVABLE LINGERIE LTD                              
LPDC      	LANDMARK PR.DEV.CO.LTD                            
LT        	LARSEN & TOUBRO LTD.                              
LUMAXAUTO 	LUMAX AUTOMOTIVE SYST LTD                         
LUMAXIND  	LUMAX INDUSTRIES LTD                              
LUMAXTECH 	LUMAX AUTO TECH LTD                               
LUPIN     	LUPIN LIMITED                                     
LYKALABS  	LYKA LABS LTD                                     
M&M       	MAHINDRA & MAHINDRA LTD                           
M&MFIN    	M&M FIN. SERVICES LTD                             
M100      	MOST SHARES M100 ETF                              
M50       	MOST SHARES M50 ETF                               
MADHAV    	MADHAV MARBLE & GRANITE                           
MADHUCON  	MADHUCON PROJECTS LTD.                            
MADRASFERT	MADRAS FERTILISERS LTD                            
MAGMA     	MAGMA FINCORP LIMITED                             
MAGNUM    	MAGNUM VENTURES LTD.                              
MAHABANK  	BANK OF MAHARASHTRA                               
MAHLIFE   	MAHINDRA LIFESPACE DEVLTD                         
MAHSCOOTER	MAHARASHTRA SCOOTERS LTD                          
MAHSEAMLES	MAHARASHTRA SEAMLESS LTD                          
MAITHANALL	MAITHAN ALLOYS LTD                                
MALUPAPER 	MALU PAPER MILLS LIMITED                          
MANAKSIA  	MANAKSIA LTD.                                     
MANALIPETC	MANALI PETRO. LIMITED                             
MANAPPURAM	MANAPPURAM GEN FIN                                
MANDHANA  	MANDHANA INDUS. LTD                               
MANGALAM  	MANGALAM DRUG & CHEM LTD                          
MANGCHEFER	MANG.CHEM.FERT.LTD                                
MANGLMCEM 	MANGALAM CEMENT LTD                               
MANGTIMBER	MANGALAM TIMBER PRODUCTS                          
MANINDS   	MAN INDUSTRIES (I) LTD.                           
MANINFRA  	MAN INFRA LTD                                     
MANUGRAPH 	MANUGRAPH INDIA LIMITED                           
MARALOVER 	MARAL OVERSEAS LTD                                
MARICO    	MARICO LIMITED                                    
MARKSANS  	MARKSANS PHARMA LIMITED                           
MARUTI    	MARUTI SUZUKI INDIA LTD.                          
MASTEK    	MASTEK LTD                                        
MAWANASUG 	MAWANA SUGARS LIMITED                             
MAX       	MAX INDIA LTD                                     
MAXWELL   	MAXWELL INDUSTRIES LTD                            
MBECL     	MCNALLY BH. ENG. CO.LTD                           
MBLINFRA  	MBL INFRASTRUCTURES LTD                           
MCDHOLDING	MCDOWELL HOLDINGS LTD.                            
MCDOWELL-N	UNITED SPIRITS LIMITED                            
MCLEODRUSS	MCLEOD RUSSEL INDIA LTD.                          
MEGASOFT  	MEGASOFT LTD                                      
MEGH      	MEGHMANI ORGANICS LTD.                            
MELSTAR   	MELSTAR INFORMATION TECH                          
MERCK     	MERCK LIMITED                                     
MHRIL     	MAHINDRA HOLIDAYS LTD                             
MIC       	MIC ELECTRONICS LIMITED                           
MICROSEC  	MICROSEC FIN SERV LTD                             
MINDAIND  	MINDA INDUSTRIES LTD.                             
MINDTREE  	MINDTREE LIMITED                                  
MIRCELECTR	MIRC ELECTRONICS LTD                              
MIRZAINT  	MIRZA INTERNATIONAL LIMIT                         
MMFL      	MM FORGINGS LTD                                   
MMTC      	MMTC LIMITED                                      
MOIL      	MOIL LIMITED                                      
MONNETISPA	MONNET ISPAT LTD                                  
MONSANTO  	MONSANTO INDIA LIMITED                            
MOREPENLAB	MOREPEN LAB. LTD                                  
MOSERBAER 	MOSER-BAER (I) LTD                                
MOTHERSUMI	MOTHERSON SUMI SYSTEMS LT                         
MOTILALOFS	MOTILAL OSWAL FIN LTD                             
MPHASIS   	MPHASIS LIMITED                                   
MPSLTD    	MPS LIMITED                                       
MRF       	MRF LTD                                           
MRO-TEK   	MRO-TEK LIMITED                                   
MRPL      	MRPL                                              
MSPL      	MSP STEEL & POWER LTD.                            
MTNL      	MAHANAGAR TELEPHONE NIGAM                         
MUKANDENGG	MUKAND ENGINEERS LIMITED                          
MUKANDLTD 	MUKAND LTD.                                       
MUKTAARTS 	MUKTA ARTS LIMITED                                
MUNJALAU  	MUNJAL AUTO IND. LTD.                             
MUNJALSHOW	MUNJAL SHOWA LTD                                  
MURUDCERA 	MURUDESHWAR CERAMICS LTD                          
MUTHOOTFIN	MUTHOOT FINANCE LIMITED                           
MVL       	MVL LIMITED                                       
MYSOREBANK	STATE BANK OF MYSORE                              
N100      	MOST SHARES N100 ETF                              
NAGREEKCAP	NAGREEKA CAP & INFR.LTD                           
NAGREEKEXP	NAGREEKA EXPORTS LTD.                             
NAHARCAP  	NAHAR CAP & FIN.                                  
NAHARINDUS	NAHAR INDS ENT LTD                                
NAHARPOLY 	NAHAR POLY FILMS LIMITED                          
NAHARSPING	NAHAR SPINNING MILLS LTD.                         
NATCOPHARM	NATCO PHARMA LTD.                                 
NATIONALUM	NATIONAL ALUMINIUM CO LTD                         
NAUKRI    	INFO EDGE (I) LTD                                 
NAVINFLUOR	NAVIN FLUORINE INT. LTD                           
NBVENTURES	NAVA BHARAT VENTURES LIMI                         
NCC       	NCC LIMITED                                       
NCLIND    	NCL INDUSTRIES LIMITED                            
NDTV      	NDTV LTD                                          
NECLIFE   	NECTAR LIFESCIENCES LTD.                          
NELCAST   	NELCAST LIMITED                                   
NELCO     	NELCO LTD                                         
NESCO     	NESCO LTD.                                        
NESTLEIND 	NESTLE INDIA LIMITED                              
NET4      	NET 4 INDIA LIMITED                               
NETWORK18 	NON-CONV CUM RED PREF SH                          
NEULANDLAB	NEULAND LAB LTD.                                  
NEXTMEDIA 	NEXT MEDIAWORKS LIMITED                           
NEYVELILIG	NEYVELI LIGNITE CORPORATI                         
NFL       	NATIONAL FERT. LTD                                
NHPC      	NHPC LTD                                          
NICCO     	NICCO CORP LTD                                    
NIFTYBEES 	NIFTY BMARK EXCH. TRD FND                         
NIITLTD   	NIIT LIMITED                                      
NIITTECH  	NIIT TECHNOLOGIES LTD                             
NILKAMAL  	NILKAMAL LIMITED                                  
NIPPOBATRY	NIPPO BATTERIES CO. LIMIT                         
NITCO     	NITCO LIMITED                                     
NITESHEST 	NITESH ESTATES LTD                                
NITINFIRE 	NITIN FIRE PROT IND. LTD.                         
NITINSPIN 	NITIN SPINNERS LIMITED                            
NMDC      	NMDC LTD.                                         
NOCIL     	NOCIL LIMITED                                     
NOIDATOLL 	NOIDA TOLL BRIDGE CO LTD                          
NORBTEAEXP	NORBEN TEA & EXPORTS LTD                          
NRBBEARING	NRB BEARING LIMITED                               
NSIL      	NALWA SONS INVESTMENT LTD                         
NTPC      	NTPC LTD                                          
NUCLEUS   	NUCLEUS SOFTWARE EXPORTS                          
NUTEK     	NU TEK INDIA LTD                                  
OBEROIRLTY	OBEROI REALTY LIMITED                             
OCL       	OCL INDIA LTD                                     
OFSS      	ORACLE FIN SERV SOFT LTD.                         
OIL       	OIL INDIA LTD                                     
OILCOUNTUB	OIL COUNTRY TUBULAR LTD                           
OISL      	OCL IRON AND STEEL LTD                            
OMAXAUTO  	OMAX AUTOS LTD                                    
OMAXE     	OMAXE LIMITED                                     
OMKARCHEM 	OMKAR SPL CHEM LTD                                
OMMETALS  	OM METALS INFRAPRO LTD                            
OMNITECH  	OMNITECH INFOSOLU LTD.                            
ONGC      	OIL AND NATURAL GAS CORP.                         
ONMOBILE  	ONMOBILE GLOBAL LTD.                              
ONWARDTEC 	ONWARD TECHNOLOGIES LTD                           
OPTOCIRCUI	OPTO CIRCUITS (I) LTD.                            
ORBITCORP 	ORBIT CORP. LTD.                                  
ORCHIDCHEM	ORCHID CHEM & PHARMA LTD                          
ORIENTABRA	ORIENT ABRASIVE LTD                               
ORIENTALTL	ORIENTAL TRIMEX LTD                               
ORIENTBANK	ORIENTAL BANK OF COMMERCE                         
ORIENTHOT 	ORIENT HOTELS LTD                                 
ORIENTLTD 	ORIENT PRESS LIMITED                              
ORIENTPPR 	ORIENT PAPER AND INDS LTD                         
ORISSAMINE	ORISSA MIN DEV CO LTD                             
OUDHSUG   	THE OUDH SUGAR MILLS LTD                          
PAEL      	PAE LIMITED                                       
PAGEIND   	PAGE INDUSTRIES LTD                               
PANACEABIO	PANACEA BIOTEC LTD                                
PANORAMUNI	PANORAMIC UNIVERSAL LTD                           
PAPERPROD 	THE PAPER PRODUCTS LTD                            
PARABDRUGS	PARABOLIC DRUGS LTD                               
PARACABLES	PARAMOUNT COMM LTD                                
PARRYSUGAR	PARRYS SUGAR INDUSTRIES L                         
PARSVNATH 	PARSVNATH DEVELOPER LTD                           
PATELENG  	PATEL ENGINEERING LTD.                            
PATINTLOG 	PATEL INT. LOG. LTD                               
PATSPINLTD	PATSPIN INDIA LTD                                 
PBAINFRA  	PBA INFRASTRUCTURE LTD.                           
PDPL      	PARENTERAL DRUGS LTD                              
PDUMJEIND 	PUDUMJEE INDUSTRIES LTD                           
PDUMJEPULP	PUDUMJEE PULP & PAPER MIL                         
PEARLPOLY 	PEARL POLYMERS LTD                                
PENIND    	PENNAR INDUSTRIES LTD                             
PENINLAND 	PENINSULA LAND LIMITED                            
PERSISTENT	PERSISTENT SYSTEMS LTD                            
PETRONENGG	PETRON ENGG CONSTRUCT LTD                         
PETRONET  	PETRONET LNG LIMITED                              
PFC       	POWER FIN CORP LTD.                               
PFIZER    	PFIZER LTD                                        
PFOCUS    	PRIME FOCUS LIMITED                               
PFS       	PTC INDIA FIN SERV LTD                            
PGHH      	P&G HYGIENE & HEALTH CARE                         
PHILIPCARB	PHILIPS CARBON BLACK LTD                          
PHOENIXLTD	THE PHOENIX MILLS LTD                             
PIDILITIND	PIDILITE INDUSTRIES LTD                           
PIIND     	PI INDUSTRIES LTD                                 
PIONDIST  	PIONEER DIST LTD                                  
PIONEEREMB	PIONEER EMBROIDERIES LTD                          
PITTILAM  	PITTI LAMINATIONS LTD                             
PLASTIBLEN	PLASTIBLENDS INDIA LTD                            
PNB       	PUNJAB NATIONAL BANK                              
PNBGILTS  	PNB GILTS LIMITED                                 
PNC       	PRITISH NANDY COMMUNICATI                         
POCHIRAJU 	POCHIRAJU IND LTD                                 
POLARIS   	POLARIS SOFTWARE LAB LTD                          
POLYPLEX  	POLYPLEX CORPORATION LTD                          
PONNIERODE	PONNIE SUGARS (ERODE) LTD                         
POWERGRID 	POWER GRID CORP. LTD.                             
PPAP      	PRECISION PIPES LTD.                              
PRADIP    	PRADIP OVERSEAS LTD                               
PRAENG    	PRAJAY ENG. SYN. LTD.                             
PRAJIND   	PRAJ INDUSTRIES LTD                               
PRAKASH   	PRAKASH INDUSTRIES LTD                            
PRAKASHSTL	PRAKASH STEELAGE LTD                              
PRATIBHA  	PRATIBHA INDS. LTD.                               
PRECOT    	PRECOT MERIDIAN LIMITED                           
PRECWIRE  	PRECISION WIRES INDIA LTD                         
PREMIER   	PREMIER LIMITED                                   
PRESTIGE  	PRESTIGE ESTATE LTD                               
PRICOL    	PRICOL LIMITED                                    
PRIMESECU 	PRIME SECURITIES LIMITED                          
PRISMCEM  	PRISM CEMENTS LTD                                 
PSB       	PUNJAB & SIND BANK                                
PSL       	PSL LIMITED                                       
PSUBNKBEES	PSU BANK BEES                                     
PTC       	PTC INDIA LIMITED                                 
PTL       	PTL ENTERPRISES LTD                               
PUNJABCHEM	PUNJAB CHEM & CROP PROT L                         
PUNJLLOYD 	PUNJ LLOYD LIMITED                                
PURVA     	PURAVANKARA PROJ. LTD.                            
PVP       	PVP VENTURES LIMITED                              
PVR       	PVR LIMITED                                       
QGOLDHALF 	QUANTUM GOLD FUND                                 
QNIFTY    	QUANTUM INDEX FUND-ETF                            
QUINTEGRA 	QUINTEGRA SOLUTIONS LTD.                          
RADAAN    	RADAAN MEDIAWORKS (I) LTD                         
RADICO    	RADICO KHAITAN LTD                                
RAINBOWPAP	RAINBOW PAPERS LTD                                
RAJESHEXPO	RAJESH EXPORTS LTD                                
RAJRAYON  	RAJ RAYON INDUSTRIES LTD                          
RAJSREESUG	RAJSHREE SUGAR & CHEMICAL                         
RAJTV     	RAJ TV NETWORK LTD                                
RAJVIR    	RAJVIR INDUSTRIES LIMITED                         
RALLIS    	RALLIS INDIA LTD                                  
RAMANEWS  	RAMA NEWSPRI & PAPER LTD                          
RAMCOIND  	RAMCO INDUSTRIES LIMITED                          
RAMCOSYS  	RAMCO SYSTEMS LTD.                                
RAMKY     	RAMKY INFRA LTD                                   
RANASUG   	RANA SUGARS LTD.                                  
RANEENGINE	RANE ENG VALVE LTD                                
RANEHOLDIN	RANE HOLDINGS LIMITED                             
RATNAMANI 	RATNAMANI MET & TUB LTD.                          
RAYMOND   	RAYMOND LTD                                       
RBL       	RANE BRAKE LINING LTD                             
RCF       	RASHTRIYA CHEMICALS & FER                         
RCOM      	RELIANCE COMMUNICATIONS L                         
RECLTD    	RURAL ELEC CORP. LTD.                             
REDINGTON 	REDINGTON (INDIA) LTD.                            
REFEX     	REFEX REFRIGERANTS LTD                            
REIAGROLTD	REI AGRO LIMITED                                  
REISIXTEN 	REI SIX TEN RETAIL LTD                            
RELAXO    	RELAXO FOOT LTD.                                  
RELBANK   	REL. BANKING ETF                                  
RELCAPITAL	RELIANCE CAPITAL LTD                              
RELGOLD   	RELIANCE GOLD ETF                                 
RELGRNIFTY	RELIGARE MF - NIFTY ETF                           
RELIANCE  	RELIANCE INDUSTRIES LTD                           
RELIGARE  	RELIGARE ENTER. LTD.                              
RELIGAREGO	RELIGARE GOLD ETF                                 
RELINFRA  	RELIANCE INFRASTRUCTU LTD                         
REMSONSIND	REMSONS INDUSTRIES LTD                            
RENUKA    	SHREE RENUKA SUGARS LTD                           
REPRO     	REPRO INDIA LIMITED                               
RESPONIND 	RESPONSIVE INDUSTRIES LTD                         
REVATHI   	REVATHI EQUIPMENT LTD                             
RICOAUTO  	RICO AUTO INDUSTRIES LTD                          
RIIL      	RELIANCE INDUSTRIAL INFRA                         
RJL       	RENAISSANCE JEWEL. LTD.                           
RKDL      	RAVI KUMAR DIST. LTD.                             
RKFORGE   	RAMKRISHNA FORGINGS LTD                           
RMCL      	RADHA MADHAV CO. LTD.                             
RML       	RANE (MADRAS) LIMITED                             
ROHITFERRO	ROHIT FERRO-TECH LIMITED                          
ROHLTD    	ROYAL ORCHID HOTELS LTD                           
ROLTA     	ROLTA INDIA LTD                                   
RPGLIFE   	RPG LIFE SCIENCES LTD                             
RPOWER    	RELIANCE POWER LTD.                               
RPPINFRA  	R.P.P INFRA PROJECTS LTD                          
RSSOFTWARE	R. S. SOFTWARE (INDIA) LI                         
RSWM      	RSWM LIMITED                                      
RSYSTEMS  	R SYS INTERNATIONAL LTD                           
RUBYMILLS 	THE RUBY MILLS LTD                                
RUCHIRA   	RUCHIRA PAPERS LIMITED                            
RUCHISOYA 	RUCHI SOYA INDUSTRIES LTD                         
RUSHIL    	RUSHIL DECOR LIMITED                              
SABTN     	SRI ADHIKARI BROS.                                
SADBHAV   	SADBHAV ENGINEERING LTD                           
SAGCEM    	SAGAR CEMENTS LIMITED                             
SAIL      	STEEL AUTHORITY OF INDIA                          
SAKHTISUG 	SAKTHI SUGARS LTD                                 
SAKSOFT   	SAKSOFT LIMITED                                   
SAKUMA    	SAKUMA EXPORTS LIMITED                            
SALORAINTL	SALORA INTERNATIONAL LTD                          
SALSTEEL  	S.A.L. STEEL LTD.                                 
SAMBHAAV  	SAMBHAAV MEDIA LTD                                
SAMTEL    	SAMTEL COLOR LTD                                  
SANDESH   	                                                  
SANGAMIND 	SANGAM (INDIA) LTD                                
SANGHIIND 	SANGHI INDUSTRIES LTD                             
SANGHVIFOR	SANGHVI FOR & ENG LTD                             
SANGHVIMOV	SANGHVI MOVERS LTD                                
SANWARIA  	SANWARIA AGRO OILS LTD                            
SARDAEN   	SARDA ENERGY & MIN LTD                            
SAREGAMA  	SAREGAMA INDIA LIMITED                            
SARLAPOLY 	SARLA PERF. FIBERS LTD                            
SASKEN    	SASKEN COMMU TECHNO LTD                           
SATHAISPAT	SATHAVAHANA ISPAT LTD                             
SBBJ      	STATE BANK OF BIKANER & J                         
SBIGETS   	SBI MF-SBI GOLD ETS-GO                            
SBIN      	State Bank of India                               
SBT       	STATE BANK OF TRAVANCORE                          
SCI       	SHIPPING CORP OF INDIA LT                         
SEAMECLTD 	SEAMEC LIMITED                                    
SELAN     	SELAN EXPLO. TECH LTD                             
SELMCL    	SEL MANU. CO. LTD.                                
SERVALL   	SERVALAKSHMI PAPER LTD                            
SESHAPAPER	SESHASAYEE PAPER & BOARDS                         
SGJHL     	SH GANESH JEWEL HOUSE LTD                         
SGL       	STL GLOBAL LIMITED                                
SHAHALLOYS	SHAH ALLOYS LIMITED                               
SHALPAINTS	SHALIM PAINTS LTD                                 
SHANTIGEAR	SHANTHI GEARS LTD                                 
SHARIABEES	SHARIAH BENCHMARK ETF                             
SHASUNPHAR	SHASUN PHARMA LIMITED                             
SHILPAMED 	SHILPA MEDICARE LTD                               
SHILPI    	SHILPI CABLE TECH LTD                             
SHIV-VANI 	SHIVVANI OIL&G.ESERLTD                            
SHIVAMAUTO	SHIVAM AUTO.LTD                                   
SHIVTEX   	SHIVA TEXYARN LIMITED                             
SHOPERSTOP	SHOPPERS STOP LIMITED                             
SHREECEM  	SHREE CEMENTS LTD                                 
SHRENUJ   	SHRENUJ & CO LTD                                  
SHREYANIND	SHREYANS INDUSTRIES LTD                           
SHREYAS   	SHREYAS SHIPPING & LOGIST                         
SHRIRAMCIT	SHRIRAM CITYUNI FIN.LTD.                          
SHRIRAMEPC	SHRIRAM EPC LTD.                                  
SHYAMTEL  	SHYAM TELECOM LIMITED                             
SICAGEN   	SICAGEN INDIA LIMITED                             
SICAL     	SICAL LOGISTICS LIMITED                           
SIEMENS   	SIEMENS LTD                                       
SILINV    	SIL INVESTMENTS LIMITED                           
SIMBHSUGAR	SIMBHAOLI SUGARS LIMITED                          
SIMPLEX   	SIMPLEX PROJECTS LTD.                             
SIMPLEXINF	SIMPLEX INFRASTRUCTURES L                         
SINTEX    	SINTEX INDUSTRIES LTD                             
SIYSIL    	SIYARAM SILK MILLS LTD                            
SJVN      	SJVN LTD                                          
SKFINDIA  	SKF INDIA LTD                                     
SKMEGGPROD	SKM EGG PROD EXPORT(I) LT                         
SKSMICRO  	SKS MICROFINANCE LTD                              
SMARTLINK 	SMARTLINK NETWORK SYS LTD                         
SMLISUZU  	SML ISUZU LIMITED                                 
SMPL      	SUJANA METAL PRODUCTS LTD                         
SMSPHARMA 	SMS PHARMACEUTICALS LTD.                          
SOBHA     	SOBHA DEVELOPERS LTD                              
SOLARINDS 	SOLAR INDUSTRIES (I) LTD                          
SOMANYCERA	SOMANY CERAMICS LIMITED                           
SOMATEX   	SOMA TEXTILES & INDUST LT                         
SONASTEER 	SONA KOYO STER SYS LTD                            
SONATSOFTW	SONATA SOFTWARE LTD                               
SOTL      	SAVITA OIL TECHNOLO. LTD                          
SOUTHBANK 	THE SOUTH INDIAN BANK LTD                         
SPARC     	SUN PHARMA ADV.RES.CO.LTD                         
SPECTACLE 	SPECTACLE INFOTEK LIMITED                         
SPENTEX   	SPENTEX IND. LTD                                  
SPIC      	SPIC LTD                                          
SPLIL     	SPL INDUSTRIES LIMITED                            
SPMLINFRA 	SPML INFRA LIMITED                                
SPYL      	SHEKHAWATI POLY-YARN LTD.                         
SREINFRA  	SREI INFRASTRUCTURE FINAN                         
SRF       	SRF LTD                                           
SRHHYPOLTD	SREE RAYALSEEMA HHP LTD.                          
SRTRANSFIN	NCD DOUBLE BOND OPT IV                            
SSWL      	STEEL STRIPS WHEELS LTD.                          
STAR      	STRIDES ARCOLAB LIMITED                           
STARPAPER 	STAR PAPER MILLS LTD                              
STCINDIA  	THE STATE TRADING CORPN                           
STERLINBIO	STERLING BIOTECH LTD                              
STERTOOLS 	STERLING TOOLS LIMITED                            
STINDIA   	STI INDIA LTD                                     
STOREONE  	STORE ONE RETAIL IND LTD                          
STRTECH   	STERLITE TECHNOLOGIES LTD                         
SUBEX     	SUBEX LIMITED                                     
SUBROS    	SUBROS LIMITED                                    
SUDAR     	SUDAR GARMENTS LTD                                
SUDARSCHEM	SUDARSHAN CHEMICAL INDS L                         
SUJANAUNI 	SUJANA UNI. INDS. LTD.                            
SUMEETINDS	SUMEET IND LIMITED                                
SUMMITSEC 	SUMMIT SECURITIES LTD                             
SUNDARAM  	SUNDARAM MULTI PAP LTD                            
SUNDARMFIN	SUNDARAM FINANCE LTD                              
SUNDRMBRAK	SUNDARAM BRAK LININGS LTD                         
SUNDRMFAST	SUNDRAM FASTENERS LTD                             
SUNFLAG   	SUNFLAG IRON AND STEEL CO                         
SUNILHITEC	SUNIL HITECH ENGR. LTD                            
SUNPHARMA 	SUN PHARMACEUTICALS IND.                          
SUNTECK   	SUNTECK REALTY LIMITED                            
SUNTV     	SUN TV NETWORK LIMITED                            
SUPERSPIN 	SUPER SPINNING MILLS LTD                          
SUPPETRO  	SUPREME PETROCHEMICALS LT                         
SUPRAJIT  	SUPRAJIT ENGINEERING LTD                          
SUPREMEIND	SUPREME INDUSTRIES LTD                            
SUPREMEINF	SUPREME INFRA. LTD.                               
SURANACORP	SURANA CORPORATION LTD                            
SURANAIND 	SURANA INDUSTRIES LTD                             
SURANAT&P 	SURANA TELECOM AND POW LT                         
SURYAJYOTI	SURYAJYOTI SPIN.MILLS LTD                         
SURYALAXMI	SURYALAKSHMI COT MIL LTD                          
SURYAROSNI	SURYA ROSHNI LTD                                  
SUTLEJTEX 	SUTLEJ TEXT & INDUS LTD                           
SUVEN     	SUVEN LIFE SCIENCES LTD                           
SUZLON    	SUZLON ENERGY LIMITED                             
SWARAJENG 	SWARAJ ENGINES LTD                                
SYMPHONY  	SYMPHONY LIMITED                                  
SYNCOM    	SYNCOM HEALTHCARE LTD                             
SYNDIBANK 	SYNDICATE BANK                                    
TAINWALCHM	TAINWALA CHEMICAL AND PLA                         
TAJGVK    	TAJ GVK HOTELS & RESORTS                          
TAKE      	TAKE SOLUTIONS LTD                                
TALBROAUTO	TALBROS AUTO. COMP. LTD                           
TALWALKARS	TALWALKAR FITNESS LTD                             
TANLA     	TANLA SOLUTIONS LIMITED                           
TANTIACONS	TANTIA CONST LTD                                  
TARAPUR   	TARAPUR TRANSFORMERS LTD                          
TATACHEM  	TATA CHEMICALS LTD                                
TATACOFFEE	TATA COFFEE LIMITED                               
TATACOMM  	TATA COMMUNICATIONS LTD                           
TATAELXSI 	TATA ELXSI LIMITED                                
TATAGLOBAL	TATA GLOBAL BEVERAGES LTD                         
TATAINVEST	TATA INVESTMENT CORP LTD                          
TATAMETALI	TATA METALIKS LTD                                 
TATAMOTORS	TATA MOTORS LIMITED                               
TATAMTRDVR	TATA MOTORS DVR 'A' ORD                           
TATAPOWER 	TATA POWER CO LTD                                 
TATASPONGE	TATA SPONGE IRON LIMITED                          
TATASTEEL 	TATA STEEL LIMITED                                
TCI       	TRANSPORT CORPN OF INDIA                          
TCIDEVELOP	TCI DEVELOPERS LIMITED                            
TCIFINANCE	TCI FINANCE LTD                                   
TCS       	TATA CONSULTANCY SERV LT                          
TECHM     	TECH MAHINDRA LIMITED                             
TECHNO    	TECHNO ELT & ENG CO. LTD                          
TECHNOFAB 	TECHNOFAB ENG LTD                                 
TEXMOPIPES	TEXMO PIPE & PRODUCTS LTD                         
TEXRAIL   	TEXMACO RAIL & ENG. LTD.                          
TFCILTD   	TOURISM FINANCE CORP. OF                          
TFL       	TRANSWARRANTY FIN. LTD.                           
THANGAMAYL	THANGAMAYIL JEWELLERY LTD                         
THERMAX   	THERMAX LTD                                       
THIRUSUGAR	THIRU AROORAN SUGARS LTD                          
THOMASCOOK	THOMAS COOK (INDIA) LTD                           
TI        	TILAKNAGAR INDUSTRIES LTD                         
TIDEWATER 	TIDE WATER OIL LTD                                
TIIL      	TECHNOCRAFT IND LTD                               
TIL       	TIL LTD                                           
TIMESGTY  	TIMES GUARANTY LIMITED                            
TIMETECHNO	TIME TECHNOPLAST LTD.                             
TIMKEN    	TIMKEN INDIA LTD.                                 
TINPLATE  	THE TINPLATE CO. (I) LTD                          
TIPSINDLTD	TIPS INDUSTRIES LIMITED                           
TIRUMALCHM	THIRUMALAI CHEMICALS LTD                          
TITAN     	TITAN INDUSTRIES LTD                              
TNPETRO   	TAMILNADU PETROPRODUCTS L                         
TNPL      	TAMILNADU NEWSPRT & PAPER                         
TODAYS    	TODAY'S WRITING PRODUCTS                          
TOKYOPLAST	TOKYO PLAST INTL LTD                              
TORNTPHARM	TORRENT PHARMACEUTICALS L                         
TORNTPOWER	TORRENT POWER LTD                                 
TRENT     	SERIES A TRENT CCCPS                              
TRF       	TRF LIMITED                                       
TRICOM    	TRICOM INDIA LIMITED                              
TRIDENT   	TRIDENT LIMITED                                   
TRIGYN    	TRIGYN TECHNOLOGIES LTD                           
TRIL      	TRANS & RECTI. LTD                                
TRIVENI   	TRIVENI ENGG. & INDS. LTD                         
TTKPRESTIG	TTK PRESTIGE LTD                                  
TTL       	T T LIMITED                                       
TTML      	TATA TELESERV(MAHARASTRA)                         
TUBEINVEST	TUBE INVESTMENTS OF INDIA                         
TULSI     	TULSI EXTRUSION LTD.                              
TVSELECT  	TVS ELECTRONICS LTD                               
TVSMOTOR  	TVS MOTOR COMPANY  LTD                            
TVSSRICHAK	TVS SRICHAKRA LIMITED                             
TVTODAY   	TV TODAY NETWORK LTD                              
TWL       	TITAGARH WAGONS LTD.                              
UBHOLDINGS	UNITED BREW. (HOLD.) LTD                          
UBL       	UNITED BREWERIES LTD                              
UCALFUEL  	UCAL FUEL SYSTEMS LTD                             
UCOBANK   	UCO BANK                                          
UFLEX     	UFLEX LIMITED                                     
ULTRACEMCO	ULTRATECH CEMENT LIMITED                          
UMESLTD   	USHA MARTIN EDU & SOL LTD                         
UNICHEMLAB	UNICHEM LABORATORIES LTD                          
UNIENTER  	UNIPHOS ENTERPRISES LTD                           
UNIONBANK 	UNION BANK OF INDIA                               
UNIPLY    	UNIPLY INDUSTRIES LIMITED                         
UNITECH   	UNITECH LTD                                       
UNITEDBNK 	UNITED BANK OF INDIA                              
UNITEDTEA 	                                                  
UNITY     	UNITY INFRAPROJECTS LTD                           
UPERGANGES	UPPER GANGES SUGAR & INDS                         
USHAMART  	USHA MARTIN LTD.                                  
USHERAGRO 	USHER AGRO LTD                                    
UTTAMSTL  	UTTAM GALVA STEELS LTD                            
UTTAMSUGAR	UTTAM SUGAR MILLS LTD.                            
VADILALIND	VADILAL INDUSTRIES LTD                            
VALECHAENG	VALECHA ENG. LIMITED                              
VALUEIND  	VALUE INDUSTRIES LIMITED                          
VARDHACRLC	VARDHAMAN ACRYLICS LTD                            
VARDMNPOLY	VARDHMAN POLYTEX LTD.                             
VASCONEQ  	VASCON ENGINEERS LTD                              
VENKEYS   	VENKY'S (INDIA) LIMITED                           
VENUSREM  	VENUS REMEDIES LIMITED                            
VESUVIUS  	VESUVIUS INDIA LTD                                
VGUARD    	V-GUARD IND LTD.                                  
VHL       	VARDHMAN HOLDINGS LIMITED                         
VICEROY   	VICEROY HOTELS LIMITED                            
VIDEOIND  	VIDEOCON INDUSTRIES LIMIT                         
VIJAYABANK	VIJAYA BANK                                       
VIJSHAN   	VIJAY SHANTHI BUILD LTD                           
VIMTALABS 	VIMTA LABS LIMITED                                
VINATIORGA	VINATI ORGANICS LTD                               
VINDHYATEL	VINDHYA TELELINKS LTD                             
VINYLINDIA	VINYL CHEMICALS (I) LTD.                          
VIPIND    	VIP INDUSTRIES LTD                                
VISAKAIND 	VISAKA INDUSTRIES LIMITED                         
VISASTEEL 	VISA STEEL LIMITED                                
VISESHINFO	VISESH INFOTECNICS LTD                            
VISUINTL  	VISU INTERNATIONAL LTD                            
VIVIMEDLAB	VIVIMED LABS LIMITED                              
VLSFINANCE	VLS FINANCE LTD                                   
VOLTAMP   	VOLTAMP TRANSFORMERS LTD                          
VOLTAS    	VOLTAS LTD                                        
VSTIND    	VST INDUSTRIES LTD                                
VSTTILLERS	VST TILLERS TRACTORS LTD                          
VTL       	VARDHMAN TEXTILES LIMITED                         
WABAG     	VA TECH WABAG LTD                                 
WALCHANNAG	WALCHANDNAGAR INDUSTRIES                          
WEBELSOLAR	WEBSOL ENERGY SYSTEMS LTD                         
WEIZFOREX 	WEIZMANN FOREX LIMITED                            
WEIZMANIND	WEIZMANN LTD                                      
WELCORP   	WELSPUN CORP LIMITED                              
WELINV    	WELSPUN INV & COMM LTD                            
WELSPUNIND	WELSPUN INDIA LTD                                 
WENDT     	WENDT (INDIA) LIMITED                             
WHEELS    	WHEELS INDIA LTD                                  
WHIRLPOOL 	WHIRLPOOL OF INDIA LTD                            
WILLAMAGOR	WILLIAMSON MAGOR                                  
WIPRO     	WIPRO LTD                                         
WOCKPHARMA	WOCKHARDT LIMITED                                 
WSI       	W.S.INDUSTRIES (I) LTD.                           
WSTCSTPAPR	WEST COAST PAPER MILLS LT                         
XLENERGY  	XL ENERGY LIMITED                                 
XPROINDIA 	XPRO INDIA LIMITED                                
YESBANK   	YES BANK LIMITED                                  
ZANDUREALT	ZANDU REALTY LIMITED                              
ZEEL      	ZEE ENTERTAINMENT ENT LTD                         
ZEELEARN  	ZEE LEARN LIMITED                                 
ZENITHBIR 	ZENITH BIRLA (INDIA) LTD                          
ZENITHCOMP	ZENITH COMPUTERS LIMITED                          
ZENSARTECH	ZENSAR TECHNOLOGIES  LTD                          
ZICOM     	ZICOM ELECT SEC SYS LTD                           
ZODIACLOTH	ZODIAC CLOTHING CO. LTD.                          
ZODJRDMKJ 	ZODIAC JRD-MKJ LTD                                
ZYDUSWELL 	ZYDUS WELLNESS LIMITED                            
ZYLOG     	ZYLOG SYSTEMS LTD.                                
