Sym	Name	Exch
A	Agilent Technologies	NYSE
AA	Alcoa Corp	NYSE
AAC	Aac Holdings Inc	NYSE
AAN	Aaron's Inc	NYSE
AAP	Advance Auto Parts Inc	NYSE
AAT	American Assets Trust	NYSE
AAV	Advantage Oil & Gas Ltd	NYSE
AB	Alliancebernstein Holding LP	NYSE
ABB	Abb Ltd	NYSE
ABBV	Abbvie Inc	NYSE
ABC	Amerisourcebergen Corp	NYSE
ABEV	Ambev S.A.	NYSE
ABG	Asbury Automotive Group Inc	NYSE
ABM	ABM Industries Incorporated	NYSE
ABR	Arbor Realty Trust	NYSE
ABR-A	Arbor Realty Trust Inc	NYSE
ABR-B	Arbor Realty Trust Inc	NYSE
ABR-C	Arbor Realty Trust	NYSE
ABRN	Arbor Realty Trust 7.375% Senior	NYSE
ABT	Abbott Laboratories	NYSE
ABX	Barrick Gold Corp	NYSE
AC	Associated Capital Group Inc	NYSE
ACC	American Campus Communities Inc	NYSE
ACCO	Acco Brands Corp	NYSE
ACH	Aluminum Corporation of China Ltd	NYSE
ACM	Aecom Technology Corp	NYSE
ACN	Accenture Plc	NYSE
ACP	Avenue Income Credit Strategies	NYSE
ACRE	Ares Commercial Real Estate Cor	NYSE
ACV	Allianzgi Diversified Income &	NYSE
ADC	Agree Realty Corp	NYSE
ADM	Archer Daniels Midland Company	NYSE
ADNT	Adient Plc	NYSE
ADS	Alliance Data Systems Corp	NYSE
ADSW	Advanced Disposal Services Inc	NYSE
ADT	ADT Inc.	NYSE
ADX	Adams Express Company	NYSE
AEB	Aegon N.V. Perp Cap Secs Floating Rate [Ne]	NYSE
AED	Aegon N.V. Perp Cap Secs [Ne]	NYSE
AEE	Ameren Corp	NYSE
AEG	Aegon N.V.	NYSE
AEH	Aegon N.V. Perp Cap Secs	NYSE
AEK	Aegon Nv 8.00% Non-Cum Notes Due 2042	NYSE
AEL	American Equity Investment Life	NYSE
AEM	Agnico-Eagle Mines Ltd	NYSE
AEO	American Eagle Outfitters	NYSE
AEP	American Electric Power Company	NYSE
AER	Aercap Holdings N.V.	NYSE
AES	The Aes Corp	NYSE
AET	Aetna Inc	NYSE
AEUA	Anadarko Petroleum Corp	NYSE
AFB	Alliance National Municipal	NYSE
AFC	Allied Capital Corp	NYSE
AFG	American Financial Group	NYSE
AFGE	American Financial Group Inc	NYSE
AFGH	American Financial Group Inc	NYSE
AFI	Armstrong Flooring Inc	NYSE
AFL	Aflac Incorporated	NYSE
AFS-A	Amtrust Financial Services Inc	NYSE
AFS-B	Amtrust Financial Services Dep Pfd	NYSE
AFS-C	Amtrust Financial Services Series C	NYSE
AFS-D	Amtrust Financial Services Dep Pfd	NYSE
AFS-E	Amtrust Financial Services Inc Prf	NYSE
AFS-F	Amtrust Financial Services Inc	NYSE
AFSS	Amtrust Financial Services Inc	NYSE
AFST	Amtrust Financial Services Inc	NYSE
AFT	Apollo Senior Floating Rate Fund Inc	NYSE
AG	First Majestic Silver	NYSE
AGC	Advent Claymore Convertible Securities	NYSE
AGCO	Agco Corp	NYSE
AGD	Alpine Global Dynamic Dividend Fund	NYSE
AGI	Alamos Gold Inc	NYSE
AGM	Federal Agricultural Mortgage Corp	NYSE
AGM-A	Federal Agricultural Mortgage	NYSE
AGM-B	Federal Ag	NYSE
AGM-C	Federal Agricultural Mortgage	NYSE
AGM.A	Federal Agricultural Mortgage Corp	NYSE
AGN	Allergan Plc	NYSE
AGN-A	Allergan Plc 5.50% Mandatory C	NYSE
AGO	Assured Guaranty Ltd	NYSE
AGO-B	Assured Guaranty Ltd [B]	NYSE
AGO-E	Assured Guaranty Ltd [E]	NYSE
AGO-F	Assured Guaranty Ltd [F]	NYSE
AGR	Avangrid Inc	NYSE
AGRO	Adecoagro S.A.	NYSE
AGS	Playags Inc.	NYSE
AGX	Argan Inc	NYSE
AHC	A.H. Belo Corp	NYSE
AHH	Armada Hoffler Properties Inc	NYSE
AHL	Aspen Insurance Holdings	NYSE
AHL-C	Aspen Ins Pfd Inc	NYSE
AHL-D	Aspen Insurance Holdings Ltd	NYSE
AHP	Ashford Hospitality Prime Inc	NYSE
AHP-B	Ashford Hospitality Prime Inc	NYSE
AHT	Ashford Hospitality Trust Inc	NYSE
AHT-D	Ashford Hosp D Pfd	NYSE
AHT-F	Ashford Hospitality Trust Inc	NYSE
AHT-G	Ashford Hospitality Trust Inc	NYSE
AHT-H	Ashford Hospitality Trust Inc Cum Pfd Ser H	NYSE
AHT-I	Ashford Hospitality Trust Inc. 7.50% Series I Pf	NYSE
AI	Arlington Asset Investment Corp	NYSE
AI-B	Arlington Asset 7.00% Series B Pfd	NYSE
AIC	Arlington Asset Investment Cor	NYSE
AIF	Apollo Tactical Income Fund Inc	NYSE
AIG	American International Group	NYSE
AIG.W	American International Group	NYSE
AIN	Albany International Corp	NYSE
AIR	AAR Corp	NYSE
AIT	Applied Industrial Technologies	NYSE
AIV	Apartment Investment and Management	NYSE
AIV-A	Apartment Investment and Manag	NYSE
AIW	Arlington Asset Investment Cor	NYSE
AIY	Apollo Investment Corp	NYSE
AIZ	Assurant Inc	NYSE
AIZP	Assurant Inc. 6.50% Series D Mandatory Converti	NYSE
AJG	Arthur J. Gallagher & Co	NYSE
AJRD	Aerojet Rocketdyne Holdings	NYSE
AJX	Great Ajax Corp	NYSE
AJXA	Great Ajax Corp 7.25% Convertible Senior Notes	NYSE
AKO.A	Embotell Andina Sa A	NYSE
AKO.B	Embotell Andna Sa B	NYSE
AKP	Alliance California Muni	NYSE
AKR	Acadia Realty Trust	NYSE
AKS	AK Steel Holding Corp	NYSE
AL	Air Lease Corporation Class A C	NYSE
ALB	Albemarle Corp	NYSE
ALE	Allete Inc	NYSE
ALEX	Alexander and Baldwin Inc	NYSE
ALG	Alamo Group	NYSE
ALK	Alaska Air Group	NYSE
ALL	Allstate Corp	NYSE
ALL-A	Allstate Corporation Pfd	NYSE
ALL-B	Ally Financial Inc Fixed Rate F	NYSE
ALL-C	The Allstate Corp	NYSE
ALL-D	Allstate Corp	NYSE
ALL-E	The Allstate Corp	NYSE
ALL-F	The Allstate Corp	NYSE
ALL-Y	GMAC Capital Trust I Fixed Rate	NYSE
ALLE	Allegion Plc Ordinary Shares Wh	NYSE
ALLY	Ally Financial	NYSE
ALP-Q	Alabama Power Co. Pfd	NYSE
ALSN	Allison Transmission Holdings	NYSE
ALV	Autoliv Inc	NYSE
ALX	Alexander's Inc	NYSE
AM	Antero Resources Midstream Llc	NYSE
AMBR	Amber Road Inc	NYSE
AMC	Amc Entertainment Holdings Inc	NYSE
AME	Amtek Inc	NYSE
AMG	Affiliated Managers Group	NYSE
AMGP	Antero Midstream Gp LP	NYSE
AMH	American Homes 4 Rent	NYSE
AMH-C	American Homes	NYSE
AMH-D	American Homes 4 Rent	NYSE
AMH-E	American Homes 4 Rent 6.35% Ser	NYSE
AMH-F	American Homes 4 Rent Cum Red Perp Pfd Shs	NYSE
AMH-G	American Homes 4 Rent Series G Pfd	NYSE
AMID	American Midstreampartners LP	NYSE
AMN	Amn Healthcare Services Inc	NYSE
AMOV	America Movil A ADR	NYSE
AMP	Ameriprise Financial Services	NYSE
AMRC	Ameresco Inc	NYSE
AMT	American Tower Corp	NYSE
AMX	America Movil S.A.B. De C.V.	NYSE
AN	Autonation Inc	NYSE
ANDV	Andeavor	NYSE
ANDX	Andeavor Logistics LP	NYSE
ANET	Arista Networks Inc	NYSE
ANF	Abercrombie & Fitch Company	NYSE
ANFI	Amira Nature Foods Ltd	NYSE
ANH	Anworth Mortgage Asset Corp	NYSE
ANH-A	Anworth Mtg Pfd A	NYSE
ANH-B	Anworth 6.25 Pr S B	NYSE
ANH-C	Anworth Mortgage Asset Corpora	NYSE
ANTM	Anthem Inc	NYSE
ANTX	Anthem Inc	NYSE
ANW	Aegean Marine Petroleum Network	NYSE
AOD	Alpine Total Dynamic Dividend	NYSE
AOI	Alliance One International	NYSE
AON	AON Plc	NYSE
AOS	Smith [A.O.] Corp	NYSE
AP	Ampco-Pittsburgh Corp	NYSE
APA	Apache Corp	NYSE
APAM	Artisan Partners Asset Manageme	NYSE
APB	Asia Pacific Fund Inc	NYSE
APC	Anadarko Petroleum Corp	NYSE
APD	Air Products and Chemicals	NYSE
APF	Morgan Stanley Asia Pacific Fund Inc	NYSE
APH	Amphenol Corp	NYSE
APLE	Apple Hospitality REIT Inc	NYSE
APO	Apollo Global Management Llc C	NYSE
APO-A	Apollo Global Management Llc Pfd Ser A	NYSE
APRN	Blue Apron Holdings Inc	NYSE
APTS	Preferred Apartment Communities	NYSE
APTV	Aptiv Plc	NYSE
APU	Amerigas Partners LP	NYSE
AQ	Aquantia Corp	NYSE
AQN	Algonquin Pwr & Util	NYSE
AQUA	Evoqua Water Technologies Corp	NYSE
AR	Antero Resources Corp	NYSE
ARA	American Renal Associates Holdi	NYSE
ARC	American Reprographics Company	NYSE
ARCH	Arch Coal Inc	NYSE
ARCO	Arcos Dorados Holdings Inc	NYSE
ARD	Ardagh Group S.A.	NYSE
ARDC	Ares Dynamic Credit Allocation	NYSE
ARE	Alexandria Real Estate Equities	NYSE
ARE-A	Alexandria Real Estate Equities	NYSE
ARE-D	Alexandria Real Estate Equitie	NYSE
ARES	Ares Management LP	NYSE
ARI	Apollo Commercial Real Estate	NYSE
ARI-C	Apollo Commercial 8% Cum. Perp. Pfd. Series C	NYSE
ARL	American Realty Investors	NYSE
ARMK	Aramark Holdings Corp	NYSE
ARNC	Arconic Inc	NYSE
AROC	Archrock Inc	NYSE
ARR	Armour Residential R	NYSE
ARR-A	Armour Residential REIT Inc	NYSE
ARR-B	Armour Residential REIT Inc	NYSE
ARW	Arrow Electronics	NYSE
ASA	ASA Gold and Precious Metals	NYSE
ASB	Associated Banc-Corp	NYSE
ASB-C	Associated Banc-Corp Depositary	NYSE
ASB-D	Associated Banc-Corp	NYSE
ASC	Ardmore Shipping Corp	NYSE
ASG	Liberty All-Star Growth Fund	NYSE
ASGN	On Assignment	NYSE
ASH	Ashland Global Holdings Inc	NYSE
ASIX	Advansix Inc	NYSE
ASPN	Aspen Aerogels Inc	NYSE
ASR	Grupo Aeroportuario Del Sureste	NYSE
ASX	Advanced Semiconductor Engineering	NYSE
AT	Atlantic Power Corp	NYSE
ATEN	A10 Networks Inc	NYSE
ATGE	Adtalem Global Education Inc	NYSE
ATH	Athene Holding Ltd	NYSE
ATHM	Autohome Inc	NYSE
ATI	Allegheny Technologies Inc	NYSE
ATKR	Atkore International Group	NYSE
ATO	Atmos Energy Corp	NYSE
ATR	Aptargroup	NYSE
ATTO	Atento S.A.	NYSE
ATU	Actuant Corp	NYSE
ATUS	Altice USA Inc Class A	NYSE
ATV	Acorn International	NYSE
AU	Anglogold Ashanti Ltd	NYSE
AUO	Au Optronics Corp	NYSE
AUY	Yamana Gold	NYSE
AVA	Avista Corp	NYSE
AVAL	Grupo Aval Acciones Y Valores S	NYSE
AVB	Avalonbay Communities	NYSE
AVD	American Vanguard Corp	NYSE
AVH	Avianca Holdings S.A.	NYSE
AVK	Advent Claymore Convertible Securities	NYSE
AVP	Avon Products	NYSE
AVT	Avnet Inc	NYSE
AVX	Avx Corp	NYSE
AVY	Avery Dennison Corp	NYSE
AVYA	Avaya Holdings Corp	NYSE
AWF	Alliancebernstein Global High Income Fund	NYSE
AWI	Armstrong World Industries Inc	NYSE
AWK	American Water Works	NYSE
AWP	Alpine Global Premier Propertie	NYSE
AWR	American States Water Company	NYSE
AXE	Anixter International Inc	NYSE
AXL	American Axle & Manufacturing	NYSE
AXP	American Express Company	NYSE
AXR	Amrep Corp	NYSE
AXS	Axis Capital Holdings	NYSE
AXS-D	Axis Capital Holdings Ltd	NYSE
AXS-E	Axis Capital Holdings Ltd	NYSE
AXTA	Axalta Coating Systems Ltd	NYSE
AYI	Acuity Brands Inc	NYSE
AYR	Aircastle Ltd	NYSE
AYX	Alteryx Inc	NYSE
AZN	Astrazeneca Plc	NYSE
AZO	Autozone	NYSE
AZRE	Azure Power Global Ltd	NYSE
AZUL	Azul S.A. ADR	NYSE
AZZ	Azz Inc	NYSE
B	Barnes Group	NYSE
BA	Boeing Company	NYSE
BABA	Alibaba Group Holding Ltd	NYSE
BAC	Bank of America Corp	NYSE
BAC-A	Bank of America Corp	NYSE
BAC-C	Bank of America Corp	NYSE
BAC-D	Bac Dep Share D	NYSE
BAC-E	Bank Amer Corp Dep R	NYSE
BAC-I	Bank Amer Corp Pfd	NYSE
BAC-L	Bank Amer Pfd Ser L	NYSE
BAC-W	Bank of America Corp	NYSE
BAC-Y	Bank of America Corp	NYSE
BAC.A	Bank of America Corporation Bac	NYSE
BAC.B	Bank of America Corporation Bac	NYSE
BAF	Blackrock Income Inv Quality Trust	NYSE
BAH	Booz Allen Hamilton Holding Corp	NYSE
BAK	Braskem S.A.	NYSE
BAM	Brookfield Asset Management Inc	NYSE
BAN-C	Banc of California Inc Deposi	NYSE
BAN-D	Bank of California Inc Pref Share Series D	NYSE
BAN-E	Banc of California Inc	NYSE
BANC	First Pactrust Bancorp	NYSE
BAP	Credicorp Ltd	NYSE
BAS	Basic Energy Services	NYSE
BAX	Baxter International Inc	NYSE
BB	Blackberry Ltd	NYSE
BBD	Banco Bradesco S.A.	NYSE
BBDO	Banco Bradesco S.A.	NYSE
BBF	Blackrock Muni Income Trust	NYSE
BBG	Bill Barrett Corp	NYSE
BBK	Blackrock Muni Trust	NYSE
BBL	Bhp Billiton Plc	NYSE
BBN	Balckrock Build America Trust	NYSE
BBT	BB&T Corp	NYSE
BBT-D	BB&T Corp	NYSE
BBT-E	BB&T Corp	NYSE
BBT-F	BB&T Corp	NYSE
BBT-G	BB&T Corporation Ser G	NYSE
BBT-H	BB&T Corp	NYSE
BBU	Brookfield Business Partners LP	NYSE
BBVA	Banco Bilbao Viscaya Argentaria S.A.	NYSE
BBW	Build-A-Bear Workshop	NYSE
BBX	Bbx Capital Corp	NYSE
BBY	Best Buy Co	NYSE
BC	Brunswick Corp	NYSE
BCC	Boise Cascade L.L.C.	NYSE
BCE	BCE Inc	NYSE
BCEI	Bonanza Creek Energy Inc	NYSE
BCH	Banco De Chile	NYSE
BCO	Brink's Company	NYSE
BCRH	Blue Capital Reinsurance Holdi	NYSE
BCS	Barclays Plc	NYSE
BCS-D	Barclays Bank Plc	NYSE
BCX	Blackrock Resources	NYSE
BDC	Belden Inc	NYSE
BDC-B	Belden Inc	NYSE
BDJ	Blackrock Enhanced Dividend Achievers	NYSE
BDN	Brandywine Realty Trust	NYSE
BDX	Becton Dickinson and Company	NYSE
BDXA	Becton Dickinson & Co	NYSE
BEDU	Bright Scholar Education Holdings Ltd	NYSE
BEL	Belmond Ltd	NYSE
BEN	Franklin Resources	NYSE
BEP	Brookfield Renewable	NYSE
BERY	Berry Global Group	NYSE
BF.A	Brown Forman Inc A	NYSE
BF.B	Brown Forman Inc B	NYSE
BFAM	Bright Horizons Family Solutions Inc	NYSE
BFK	Blackrock Muni Income Trust	NYSE
BFO	Blackrock Florida Muni 2020 Trust	NYSE
BFR	Bbva Banco Frances S.A.	NYSE
BFS	Saul Centers	NYSE
BFS-C	Saul Centers Inc	NYSE
BFS-D	Saul Centers Inc Dep Shs Repstg 1/100Th Pfd Ser	NYSE
BFZ	Blackrock California Muni Trust	NYSE
BG	Bunge Ltd	NYSE
BGB	Blackstone / Gso Strategic Cre	NYSE
BGC	General Cable Corp	NYSE
BGCA	Bgc Partners Inc	NYSE
BGG	Briggs & Stratton Corp	NYSE
BGH	Babson Capital Global Short Du	NYSE
BGIO	Blackrock 2022 Global Income Opportunity Trust	NYSE
BGR	Blackrock Energy and Resources Trust	NYSE
BGS	B&G Foods Holdings	NYSE
BGT	Blackrock Global	NYSE
BGX	Blackstone Gso Long Short Credit Fund	NYSE
BGY	Blackrock International	NYSE
BH	Biglari Holdings Inc	NYSE
BHE	Benchmark Electronics	NYSE
BHGE	Baker Hughes A Ge Co. Cl. A	NYSE
BHK	Blackrock Core Trust	NYSE
BHLB	Berkshire Hills Bancorp	NYSE
BHP	Bhp Billiton Ltd	NYSE
BHVN	Biohaven Pharmaceutical Holding Company Ltd	NYSE
BID	Sotheby's Holdings	NYSE
BIF	Boulder Growth & Income Fund Inc	NYSE
BIG	Big Lots	NYSE
BIO	Bio-Rad Laboratories	NYSE
BIO.B	Bio Rad Labs Cl B	NYSE
BIP	Brookfield Infrastructure Partners LP	NYSE
BIT	Blackrock Multi-Sector Income T	NYSE
BITA	Bitauto Holdings Ltd	NYSE
BJZ	Blackrock California Muni 2018 Trust	NYSE
BK	Bank of New York Mellon Corp	NYSE
BK-C	The Bank of New York Mellon Co	NYSE
BKD	Brookdale Senior Living Inc	NYSE
BKE	Buckle Inc	NYSE
BKH	Black Hills Corp	NYSE
BKHU	Black Hills Corp	NYSE
BKI	Black Knight Inc	NYSE
BKK	Blackrock Muni 2020 Trust	NYSE
BKN	Blackrock Investment Quality Municipal	NYSE
BKS	Barnes & Noble	NYSE
BKT	Blackrock Income Trust Inc	NYSE
BKU	BankUnited Inc	NYSE
BLD	Topbuild Corp	NYSE
BLH	Blackrock New York Muni 2018 Trust	NYSE
BLK	Blackrock	NYSE
BLL	Ball Corp	NYSE
BLW	Blackrock Limited Duration Income Trust	NYSE
BLX	Banco Latinoamericano De Comercio	NYSE
BMA	Banco Macro S.A.	NYSE
BME	Blackrock Health Sciences Trust	NYSE
BMI	Badger Meter	NYSE
BML-G	Bank America Dep G	NYSE
BML-H	Bank America Dep H	NYSE
BML-I	Bank America Dep I	NYSE
BML-J	Bank America Dep J	NYSE
BML-L	Bank America Dep L	NYSE
BMO	Bank of Montreal	NYSE
BMS	Bemis Company	NYSE
BMY	Bristol-Myers Squibb Company	NYSE
BNED	Barnes & Noble Education Inc C	NYSE
BNJ	Blackrock New Jersey Muni Income Trust	NYSE
BNS	Bank of Nova Scotia	NYSE
BNY	Blackrock New York Muni Trust Inc	NYSE
BOE	Blackrock Global	NYSE
BOH	Bank of Hawaii Corp	NYSE
BOOT	Boot Barn Holdings Inc	NYSE
BORN	China New Borun Corp	NYSE
BOX	Box Inc	NYSE
BP	BP Plc	NYSE
BPI	Bridgepoint Education	NYSE
BPK	Blackrock Muni 2018 Trust	NYSE
BPL	Buckeye Partners LP	NYSE
BPMP	BP Midstream Partners LP	NYSE
BPT	BP Prudhoe Bay Royalty Trust	NYSE
BQH	Blackrock New York Muni Trust	NYSE
BR	Broadridge Financial Solutions Llc	NYSE
BRC	Brady Corp	NYSE
BRFS	Brf-Brasil Foods S.A.	NYSE
BRK.A	Berkshire Hath Hld A	NYSE
BRK.B	Berkshire Hath Hld B	NYSE
BRO	Brown & Brown	NYSE
BRS	Bristow Group Inc	NYSE
BRSS	Global Brass and Copper Holdin	NYSE
BRT	BRT Realty Trust	NYSE
BRX	Brixmor Property Group Inc	NYSE
BSAC	Banco Santander Chile ADR	NYSE
BSBR	Banco Santander Brasil S.A.	NYSE
BSD	Blackrock Strategic Muni Trust Inc	NYSE
BSE	Blackrock New York Muni Income Trust	NYSE
BSL	Blackstone Gso Senior Floating Rate	NYSE
BSM	Black Stone Minerals LP	NYSE
BSMX	Grupo Financiero Santander Mexico	NYSE
BST	Blackrock Science and Technolo	NYSE
BSTI	Best Inc ADR	NYSE
BSX	Boston Scientific Corp	NYSE
BT	Bt Group Plc	NYSE
BTA	Blackrock Long-Term Muni Advantage Trust	NYSE
BTE	Baytex Energy Corp	NYSE
BTI	British American Tobacco Industries	NYSE
BTO	John Hancock Bank and Thrift Fund	NYSE
BTT	Blackrock Municipal Target Term	NYSE
BTU	Peabody Energy Corp	NYSE
BTZ	Blackrock Preferred	NYSE
BUD	Anheuser-Busch Inbev S.A.	NYSE
BUI	Blackrock Utility and Infrastr	NYSE
BURL	Burlington Stores Inc	NYSE
BVN	Compania Mina Buenaventura S.A.	NYSE
BW	Babcock & Wilcox Enterprises I	NYSE
BWA	Borgwarner Inc	NYSE
BWG	Legg Mason Bw Global Income Op	NYSE
BWP	Boardwalk Pipeline Partners LP	NYSE
BWXT	Bwx Technologies Inc	NYSE
BX	The Blackstone Group LP	NYSE
BXC	Bluelinx Holdings Inc	NYSE
BXE	Bellatrix Exploration Ltd	NYSE
BXG	Bluegreen Vacations Corporation	NYSE
BXMT	Blackstone Mortgage Trust Inc Cl A	NYSE
BXMX	Nuveen Equity Premium	NYSE
BXP	Boston Properties	NYSE
BXP-B	Boston Properties Inc	NYSE
BXS	Bancorpsouth Inc	NYSE
BY	Byline Bancorp Inc	NYSE
BYD	Boyd Gaming Corp	NYSE
BYM	Blackrock Muni Income Quality Trust	NYSE
BZH	Beazer Homes USA	NYSE
C	Citigroup Inc	NYSE
C-C	Citigroup Inc Prfd C 5.8 P12/31/49 +C	NYSE
C-J	Citigroup Inc Prfd C V7.125 P12/31/49 J	NYSE
C-K	Citigroup Inc Prfd C V6.875 P12/31/49 K	NYSE
C-L	Citigroup Inc Prfd C 6.875 P12/31/49 L	NYSE
C-N	Citigroup Cap Prfd C V7.875 10/30/40	NYSE
C-S	Citigroup Inc Prfd C 6.3	NYSE
C.A	Citigroup Inc Wrnt 'A'	NYSE
CAAP	Corporacion America Airports Sa	NYSE
CABO	Cable One Inc	NYSE
CACI	Caci International	NYSE
CADE	Cadence Bancorporation Class A	NYSE
CAE	Cae Inc	NYSE
CAF	Morgan Stanley China A Share Fund Inc	NYSE
CAG	Conagra Brands Inc	NYSE
CAH	Cardinal Health	NYSE
CAI	Cai International	NYSE
CAJ	Canon Inc	NYSE
CAL	Caleres Inc	NYSE
CALX	Calix Inc	NYSE
CAPL	Crossamerica Partners LP	NYSE
CARS	Cars.Com Inc	NYSE
CAT	Caterpillar Inc	NYSE
CATO	Cato Corp	NYSE
CB	Chubb Ltd	NYSE
CBA	Clearbridge American Energy ML	NYSE
CBB	Cincinnati Bell Inc	NYSE
CBB-B	Cincinnati Bell Pr B	NYSE
CBD	Companhia Brasileira De Distribuicao	NYSE
CBG	CBRE Group Inc	NYSE
CBH	Allianzgi Convertible Income 2024 Target Term Fu	NYSE
CBI	Chicago Bridge & Iron Company N.V.	NYSE
CBK	Christopher & Banks Corp	NYSE
CBL	Cbl & Associates Properties	NYSE
CBL-D	Cbl Pfd D	NYSE
CBL-E	Cbl & Associates Properties I	NYSE
CBM	Cambrex Corp	NYSE
CBO	Cbo Common Stock	NYSE
CBPX	Continental Building Products	NYSE
CBRE	CBRE Group Inc	NYSE
CBS	CBS Corp	NYSE
CBS.A	CBS Corp	NYSE
CBT	Cabot Corp	NYSE
CBU	Community Bank System	NYSE
CBX	Cbx [Listing Market NYSE Test]	NYSE
CBZ	Cbiz Inc	NYSE
CC	Chemours Company	NYSE
CCC	Calgon Carbon Corp	NYSE
CCE	Coca Cola European Partners	NYSE
CCI	Crown Castle International Corp	NYSE
CCI-A	Crown Castle International Corp	NYSE
CCJ	Cameco Corp	NYSE
CCK	Crown Cork & Seal Company	NYSE
CCL	Carnival Corp	NYSE
CCM	Concord Medical Services	NYSE
CCO	Clear Channel Outdoor Holdings	NYSE
CCR	Consol Coal Resources LP	NYSE
CCS	Century Communities Inc	NYSE
CCT	Corporate Capital Trust Inc	NYSE
CCU	Compania Cervecerias Unidas S.A.	NYSE
CCZ	Comcast Corp	NYSE
CDE	Coeur Mining Inc	NYSE
CDR	Cedar Shopping Centers Inc	NYSE
CDR-B	Cedar Realty Trust Inc	NYSE
CDR-C	Cedar Realty Trust Inc	NYSE
CE	Celanese Corp	NYSE
CEA	China Eastern Airlines Corp Ltd	NYSE
CEE	Central Europe and Russia Fund	NYSE
CEIX	Consol Energy Inc	NYSE
CEL	Cellcom Israel	NYSE
CELP	Cypress Energy Partners LP	NYSE
CEM	Clearbridge Energy MLP Fund Inc	NYSE
CEN	Center Coast MLP & Infrastructure	NYSE
CEO	Cnooc Ltd	NYSE
CEPU	Central Puerto S.A. ADR	NYSE
CEQP	Crestwood Equity Partners LP	NYSE
CF	Cf Industries Holdings	NYSE
CFC-B	Countrywide Cap V	NYSE
CFG	Citizens Financial Group Inc/Ri	NYSE
CFR	Cullen/Frost Bankers	NYSE
CFR-A	Cullen/Frost Bankers Inc	NYSE
CFX	Colfax Corp	NYSE
CGA	China Green Agriculture	NYSE
CGG	Compagnie Generale De Gephysqu	NYSE
CGI	Celadon Group	NYSE
CHA	China Telecom Corp Ltd	NYSE
CHCT	Community Healthcare Trust Inc	NYSE
CHD	Church & Dwight Company	NYSE
CHE	Chemed Inc	NYSE
CHGG	Chegg Inc	NYSE
CHH	Choice Hotels International	NYSE
CHK	Chesapeake Energy Corp	NYSE
CHK-D	Chesapeake En Cv Pfd	NYSE
CHKR	Chesapeake Granite Wash Trust	NYSE
CHL	China Mobile [Hong Kong] Ltd	NYSE
CHM-A	Cherry Hill Mortgage Investment Corp	NYSE
CHMI	Cherry Hill Mortgage Investmen	NYSE
CHN	China Fund	NYSE
CHS	Chico's Fas	NYSE
CHSP	Chesapeake Lodging Trust	NYSE
CHT	Chunghwa Telecom Co Ltd	NYSE
CHU	China Unicom [Hong Kong] Ltd	NYSE
CI	Cigna Corp	NYSE
CIA	Citizens Inc	NYSE
CIB	Bancolombia S.A.	NYSE
CIC	Capitol Investment Corp IV	NYSE
CIC.U	Capitol Investment Corp IV Units	NYSE
CIC.W	Capitol Investment Corp IV Wrnt	NYSE
CIEN	Ciena Corp	NYSE
CIF	Colonial Intermediate High	NYSE
CIG	Comp En De Mn Cemig ADR	NYSE
CIG.C	Comp En De Mn Cemig Class C ADR	NYSE
CII	Blackrock Capital and Income Strategies	NYSE
CIM	Chimera Investment Corp	NYSE
CIM-A	Chimera Investment Corp	NYSE
CIM-B	Chimera Investment Corp	NYSE
CINR	Ciner Resources LP	NYSE
CIO	City Office REIT Inc	NYSE
CIO-A	City Office REIT Inc	NYSE
CIR	Circor International	NYSE
CISN	Cision Ltd	NYSE
CIT	Cit Group Inc [Del]	NYSE
CIVI	Civitas Solutions Inc	NYSE
CJ	C&J Energy Services Inc	NYSE
CKH	Seacor Smit Inc	NYSE
CL	Colgate-Palmolive Company	NYSE
CLB	Core Laboratories N.V.	NYSE
CLD	Cloud Peak Energy Inc	NYSE
CLDR	Cloudera Inc	NYSE
CLDT	Chatham Lodging Trust [Reit]	NYSE
CLF	Cleveland-Cliffs Inc	NYSE
CLGX	Corelogic	NYSE
CLH	Clean Harbors	NYSE
CLI	Mack-Cali Realty Corp	NYSE
CLN-B	Colony Financial Inc Perp Pfd	NYSE
CLN-D	Colony Northstar [Clnspd]	NYSE
CLN-E	Colony Northstar [Clnspe]	NYSE
CLN-G	Colony Northstar [Clnspg]	NYSE
CLN-H	Colony Northstar [Clnsph]	NYSE
CLN-I	Colony Northstar Inc. 7.15% Series I Pfd	NYSE
CLN-J	Colony Northstar Inc Cum Red Perp Pfd Ser J	NYSE
CLNC	Colony Northstar Credit Real Estate Inc. Class	NYSE
CLNS	Colony Northstar Inc	NYSE
CLPR	Clipper Realty Inc	NYSE
CLR	Continental Resources	NYSE
CLS	Celestica Inc	NYSE
CLW	Clearwater Paper Corp	NYSE
CLX	Clorox Company	NYSE
CM	Canadian Imperial Bank of Commerce	NYSE
CMA	Comerica Inc	NYSE
CMA.W	Comerica Inc	NYSE
CMC	Commercial Metals Company	NYSE
CMCM	Cheetah Mobile Inc	NYSE
CMD	Cantel Medical	NYSE
CMG	Chipotle Mexican Grill	NYSE
CMI	Cummins Inc	NYSE
CMO	Capstead Mortgage Corp	NYSE
CMO-E	Capstead Mortgage Corp	NYSE
CMP	Compass Minerals Intl Inc	NYSE
CMR-B	Costamare Inc Perpetual Prefer	NYSE
CMR-C	Costamare Inc Perpetual Prefer	NYSE
CMR-D	Costamare Inc 8.75% Series D Cum Perp Pref	NYSE
CMR-E	Costamare Inc. Pfd	NYSE
CMRE	Costamare Inc	NYSE
CMS	Cms Energy Corp	NYSE
CMS-B	Consumers Engry 4.50	NYSE
CMSA	Cms Energy Corporation 5.625% Junior Subordinate	NYSE
CMU	Colonial Muni Income Trust	NYSE
CNA	Cna Financial Corp	NYSE
CNC	Centene Corp	NYSE
CNDT	Conduent Inc	NYSE
CNHI	CNH Industrial N.V.	NYSE
CNI	Canadian National Railway Company	NYSE
CNK	Cinemark Holdings Inc	NYSE
CNNE	Cannae Holdings Inc	NYSE
CNO	Cno Financial Group	NYSE
CNP	Centerpoint Energy Inc	NYSE
CNQ	Canadian Natural Resources	NYSE
CNS	Cohn & Steers Inc	NYSE
CNX	CNX Resources Corp	NYSE
CNXM	CNX Midstream Partners LP	NYSE
CO	Global Cord Blood Corp.	NYSE
COD-A	Compass Diversified Holdings Pfd Ser A	NYSE
COD-B	Compass Diversified Holdings Fixed/Fltg Rate Cum	NYSE
CODI	Compass Diversified Holdings	NYSE
COE	China Online Education Group	NYSE
COF	Capital One Financial Corp	NYSE
COF-C	Capital One Financial Corporat	NYSE
COF-D	Capital One Financial Corporat	NYSE
COF-F	Capital One Financial Corporat	NYSE
COF-G	Capital One Financial Corp	NYSE
COF-H	Capital One Financial Corp Pfd	NYSE
COF-P	Capital One Financial Corp Pfd	NYSE
COF.W	Capital One Financial Corp	NYSE
COG	Cabot Oil & Gas Corp	NYSE
COL	Rockwell Collins	NYSE
COLD	Americold Realty Trust	NYSE
COO	Cooper Companies	NYSE
COP	Conocophillips	NYSE
COR	Coresite Realty Corp	NYSE
COR-Z	Corenergy Infrastructure Trust Inc Dep. Pfd	NYSE
CORR	Corenergy Infrastructure Trust Inc	NYSE
COT	Cott Corp	NYSE
COTV	Cotiviti Holdings	NYSE
COTY	Coty Inc	NYSE
CP	Canadian Pacific Railway	NYSE
CPA	Copa Holdings S.A.	NYSE
CPAC	Cementos Pacasmayo S.A.A	NYSE
CPB	Campbell Soup Company	NYSE
CPE	Callon Petroleum Company	NYSE
CPE-A	Callon Petroleum Company Prefer	NYSE
CPF	Central Pacific Financial Co	NYSE
CPG	Crescent Pt Energy	NYSE
CPK	Chesapeake Utilities Corp	NYSE
CPL	Cpfl Energia S.A.	NYSE
CPN	Calpine Corp	NYSE
CPS	Cooper Std Hldg Inc	NYSE
CPT	Camden Property Trust	NYSE
CR	Crane Company	NYSE
CRC	California Resources Corporatio	NYSE
CRCM	Care.Com Inc	NYSE
CRD.A	Crawford Co Cl A	NYSE
CRD.B	Crawford Co Cl B	NYSE
CRH	CRH Plc	NYSE
CRI	Carter's Inc	NYSE
CRK	Comstock Resources	NYSE
CRL	Charles River Laboratories Intl	NYSE
CRM	Salesforce.Com Inc	NYSE
CRR	Carbo Ceramics	NYSE
CRS	Carpenter Technology Corp	NYSE
CRT	Cross Timbers Royalty Trust	NYSE
CRY	Cryolife	NYSE
CS	Credit Suisse Group	NYSE
CSL	Carlisle Companies Inc	NYSE
CSLT	Castlight Health Inc	NYSE
CSRA	Csra Inc	NYSE
CSS	Css Industries	NYSE
CSTM	Constellium N.V.	NYSE
CSU	Capital Senior Living Corp	NYSE
CSV	Carriage Services	NYSE
CTAA	Qwest Corp	NYSE
CTB	Cooper Tire & Rubber Company	NYSE
CTBB	Qwest Corp	NYSE
CTDD	Qwest Corporation 6.75% Notes Due 2057	NYSE
CTL	Centurylink	NYSE
CTLT	Catalent Inc	NYSE
CTR	Clearbridge Energy MLP Fund In	NYSE
CTS	Cts Corp	NYSE
CTT	Catchmark Timber Trust Inc	NYSE
CTU	Qwest Corp	NYSE
CTV	Qwest Corp	NYSE
CTW	Qwest Corp	NYSE
CTX	Qwest Corp	NYSE
CTY	Qwest Corp	NYSE
CTZ	Qwest Corporation 6.625% Notes	NYSE
CUB	Cubic Corp	NYSE
CUB-C	Customers Bancorp Inc Perp Pref Series C	NYSE
CUB-D	Customers Bancorp Inc	NYSE
CUB-E	Customers Bancorp Inc	NYSE
CUB-F	Customers Bancorp Inc Prf	NYSE
CUBE	Cubesmart	NYSE
CUBI	Customers Bancorp	NYSE
CUBS	Customers Bancorp Inc	NYSE
CUK	Carnival Plc ADR	NYSE
CULP	Culp Inc	NYSE
CURO	Curo Group Holdings Corp	NYSE
CUZ	Cousins Properties Inc	NYSE
CVA	Covanta Holding Corp	NYSE
CVE	Cenovus Energy Inc	NYSE
CVEO	Civeo Corp	NYSE
CVG	Convergys Corp	NYSE
CVI	Cvr Energy Inc	NYSE
CVNA	Carvana Co. Class A	NYSE
CVRR	Cvr Refining LP	NYSE
CVS	CVS Corp	NYSE
CVX	Chevron Corp	NYSE
CW	Curtiss-Wright Corp	NYSE
CWH	Camping World Holdings Inc	NYSE
CWT	California Water Service Group Holding	NYSE
CX	Cemex S.A.B. De C.V.	NYSE
CXE	Colonial High Income Muni Trust	NYSE
CXH	Colonial Investment Grade Muni Trust	NYSE
CXO	Concho Resources Inc	NYSE
CXP	Columbia Property Trust Inc	NYSE
CXW	Corecivic Inc	NYSE
CYD	China Yuchai International	NYSE
CYH	Community Health Systems	NYSE
CYS	Cys Investments Inc	NYSE
CYS-A	Cys Investments Inc	NYSE
CYS-B	Cys Investments Inc	NYSE
CZZ	Cosan Ltd	NYSE
D	Dominion Resources	NYSE
DAC	Danaos Corp	NYSE
DAL	Delta Air Lines Inc	NYSE
DAN	Dana Inc	NYSE
DAR	Darling International Inc	NYSE
DATA	Tableau Software Inc Class A	NYSE
DB	Deutsche Bank Ag	NYSE
DBD	Diebold Nixdorf Inc	NYSE
DBL	Doubleline Opportunistic Credi	NYSE
DCF	Dreyfus Alcentra Global Credit Income 2024 Targe	NYSE
DCI	Donaldson Company	NYSE
DCM	Ntt Docomo Inc	NYSE
DCO	Ducommun Inc	NYSE
DCP	Dcp Midstream LP	NYSE
DCT	Dct Industrial Trust Inc	NYSE
DCUD	Dominion Resources Inc	NYSE
DD-A	Du Pont E I 3.50 Pfd	NYSE
DD-B	Du Pont E I 4.50 Pfd	NYSE
DDD	3D Systems Corp	NYSE
DDE	Dover Downs Gaming & Entertainment Inc	NYSE
DDF	Delaware Dividend & Income	NYSE
DDR	DDR Corp	NYSE
DDR-A	DDR Corp Dep Shs Repstg 1/20Th Cl A Cum Red Pfd	NYSE
DDR-J	DDR Corp	NYSE
DDR-K	DDR Corp	NYSE
DDS	Dillard's	NYSE
DDT	Dillard's	NYSE
DE	Deere & Company	NYSE
DEA	Easterly Government Properties	NYSE
DECK	Deckers Outdoor Corp	NYSE
DEI	Douglas Emmett	NYSE
DEO	Diageo Plc	NYSE
DESP	Despegar.Com Corp	NYSE
DEX	Delaware Enhanced Global Dividend	NYSE
DF	Dean Foods Company	NYSE
DFIN	Donnelly Financial Solutions Inc	NYSE
DFP	Flaherty & Crumrine Dynamic	NYSE
DFS	Discover Financial Services	NYSE
DG	Dollar General Corp	NYSE
DGX	Quest Diagnostics Inc	NYSE
DHCP	Ditech Holding Corporation	NYSE
DHF	Dreyfus High Yield Strategies Fund	NYSE
DHG	Dws High Income Opportunities Fund	NYSE
DHI	D.R. Horton	NYSE
DHR	Danaher Corp	NYSE
DHT	Dht Holdings	NYSE
DHX	Dice Holdings	NYSE
DIAX	Nuveen DOW	NYSE
DIN	Dineequity Inc	NYSE
DIS	Walt Disney Company	NYSE
DK	Delek US Holdings	NYSE
DKL	Delek Logistics Partners LP	NYSE
DKS	Dick's Sporting Goods Inc	NYSE
DKT	Deutsch Bk Contingent Cap TR V	NYSE
DL	China Distance Education Holdings	NYSE
DLB	Dolby Laboratories	NYSE
DLN-A	Dynagas Lng Partners LP 9.00% Series A	NYSE
DLNG	Dynagas Lng Partners LP	NYSE
DLPH	Delphi Technologies Plc	NYSE
DLR	Digital Realty Trust	NYSE
DLR-C	Digital Realty Trust Inc 6.625% Series C	NYSE
DLR-G	Digital Realty Trust Inc	NYSE
DLR-H	Digital Realty	NYSE
DLR-I	Digital Rlty TR Inc Pfd Sr I %	NYSE
DLR-J	Digital Realty Trust Inc Cum Redeemable Pfd Ser	NYSE
DLX	Deluxe Corp	NYSE
DM	Dominion Midstream Partners LP	NYSE
DMB	Dreyfus Municipal Bond Infrastr	NYSE
DMO	Western Asset Mortgage Defined Opp	NYSE
DNB	Dun & Bradstreet Corp	NYSE
DNI	Chartwell Dividend & Income Fund	NYSE
DNOW	Now Inc	NYSE
DNP	Duff & Phelps Utilities Income	NYSE
DNR	Denbury Resources	NYSE
DO	Diamond Offshore Drilling	NYSE
DOC	Physicians Realty Trust	NYSE
DOOR	Masonite Wrldwde Hld	NYSE
DOV	Dover Corp	NYSE
DPG	Duff & Phelps Global Utility I	NYSE
DPLO	Diplomat Pharmacy Inc	NYSE
DPS	Dr Pepper Snapple Group Inc	NYSE
DPZ	Domino's Pizza Inc	NYSE
DQ	Daqo New Energy	NYSE
DRD	Drdgold Ltd	NYSE
DRE	Duke Realty Corp	NYSE
DRH	Diamondrock Hospitality Company	NYSE
DRI	Darden Restaurants	NYSE
DRQ	Dril-Quip	NYSE
DRUA	Dominion Resources Inc	NYSE
DS	Drive Shack Inc	NYSE
DS-B	Drive Shack Inc [Dspb]	NYSE
DS-C	Drive Shack Inc [Dspc]	NYSE
DS-D	Drive Shack Inc [Dspd]	NYSE
DSE	Duff & Phelps Select Energy ML	NYSE
DSL	Doubleline Income Solutions Fun	NYSE
DSM	Dreyfus Strategic Muni Bond Fund	NYSE
DST	Dst Systems	NYSE
DSU	Blackrock Debt Strategies Fund	NYSE
DSW	DSW Inc	NYSE
DSX	Diana Shipping Inc	NYSE
DSX-B	Diana Shipping	NYSE
DSXN	Diana Shipping Inc	NYSE
DTE	Dte Energy Company	NYSE
DTF	Duff & Phelps Utilities Tax-Free Income	NYSE
DTJ	Dte Energy Company 2016 Series	NYSE
DTL.P	Datalink Corp	NYSE
DTQ	Dte Energy Co	NYSE
DTV	Dte Energy Co	NYSE
DTW	Dte Energy Company 2017 Series E 5.25% Jr	NYSE
DTY	Dte Energy Co	NYSE
DUC	Duff & Phelps Utility & Corporate Trust	NYSE
DUK	Duke Energy Corp	NYSE
DUKH	Duke Energy Corp	NYSE
DVA	Davita Healthcare Partners Inc	NYSE
DVD	Dover Downs Entertainment	NYSE
DVMT	Dell Technologies Inc Cl V	NYSE
DVN	Devon Energy Corp	NYSE
DWDP	Dowdupont Inc	NYSE
DX	Dynex Capital	NYSE
DX-A	Dynex Capital Inc	NYSE
DX-B	Dynex Capital Inc	NYSE
DXB	Deutsche Bk Contingent Cap TR I	NYSE
DXC	Dxc Technology Company	NYSE
DY	Dycom Industries	NYSE
DYN	Dynegy Inc	NYSE
DYN.A	Dynegy Inc	NYSE
DYNC	Dynegy Inc 7.00% Tangible Equi	NYSE
E	Eni S.P.A.	NYSE
EAB	First Mortgage Bonds	NYSE
EAE	Entergy Arkansas Inc	NYSE
EAI	Entergy Arkansas Inc	NYSE
EARN	Ellington Residential Mortgage	NYSE
EAT	Brinker International	NYSE
EBF	Ennis Inc	NYSE
EBR	Centrais Electricas Brazil	NYSE
EBR.B	Centrais Eletricas Brasileiras	NYSE
EBS	Emergent Biosolutions	NYSE
EC	Ecopetrol S.A.	NYSE
ECA	Encana Corp	NYSE
ECC	Eagle Point Credit Co. Inc	NYSE
ECCA	Eagle Point Credit Company Inc	NYSE
ECCB	Eagle Point Credit Company Inc	NYSE
ECCY	Eagle Point Credit Company Inc	NYSE
ECCZ	Eagle Point Credit Co. Inc	NYSE
ECL	Ecolab Inc	NYSE
ECOM	Channeladvisor Corp	NYSE
ECR	Eclipse Resources Corp	NYSE
ECT	Eca Marcellus Trust I	NYSE
ED	Consolidated Edison Company of New York	NYSE
EDD	Emerging Markets Domestic Debt Fund	NYSE
EDF	Stone Harbor Emerging Markets	NYSE
EDI	Stone Harbor Emerging Markets	NYSE
EDN	Empresa Distribuidora Y Comercializadora	NYSE
EDR	Education Realty Trust Inc	NYSE
EDU	New Oriental Education & Technology Group	NYSE
EE	El Paso Electric Company	NYSE
EEA	European Equity Fund	NYSE
EEP	Enbridge Energy LP	NYSE
EEQ	Enbridge Energy Management Llc	NYSE
EEX	Emerald Expositions Events Inc	NYSE
EFC	Ellington Financial Llc	NYSE
EFF	Eaton Vance Floating-Rate Inco	NYSE
EFL	Eaton Vance Floating-Rate 2022 Target Term Trust	NYSE
EFR	Eaton Vance Senior Floating-Rate Fund	NYSE
EFT	Eaton Vance Floating Rate Income Trust	NYSE
EFX	Equifax Inc	NYSE
EGF	Blackrock Enhanced Government Fund	NYSE
EGHT	8X8 Inc	NYSE
EGIF	Eagle Growth and Income Opportu	NYSE
EGL	Engility Holdings Inc	NYSE
EGN	Energen Corp	NYSE
EGO	Eldorado Gold Corp	NYSE
EGP	Eastgroup Properties	NYSE
EGY	Vaalco Energy Inc	NYSE
EHC	Encompass Health Corp.	NYSE
EHI	Western Asset Global High	NYSE
EHIC	Ehi Car Services Ltd	NYSE
EHT	Eaton Vance High Income 2021 Ta	NYSE
EIG	Employers Holdings Inc	NYSE
EIX	Edison International	NYSE
EL	Estee Lauder Companies	NYSE
ELC	Entergy Louisiana Llc	NYSE
ELF	E.L.F. Beauty Inc	NYSE
ELJ	Entergy Louisiana Llc	NYSE
ELLI	Ellie Mae Inc	NYSE
ELP	Companhia Paranaense De Energia	NYSE
ELS	Equity Lifestyle Properties	NYSE
ELU	Entergy Louisiana Llc First M	NYSE
ELVT	Elevate Credit Inc	NYSE
ELY	Callaway Golf Company	NYSE
EMD	Western Asset Emerging Market Debt Fund Inc	NYSE
EME	Emcor Group	NYSE
EMES	Emerge Energy Services LP	NYSE
EMF	Templeton Emerging Markets Fund	NYSE
EMN	Eastman Chemical Company	NYSE
EMO	Clearbridge Energy MLP Opportu	NYSE
EMP	Entergy Mississippi Inc 4.9% Bonds	NYSE
EMR	Emerson Electric Company	NYSE
ENB	Enbridge Inc	NYSE
ENBL	Enable Midstream Partners LP	NYSE
ENIA	Enersis Americas S.A. American	NYSE
ENIC	Enersis Chile S.A. ADR	NYSE
ENJ	Entergy New Orleans Inc	NYSE
ENLC	Enlink Midstream Llc	NYSE
ENLK	Enlink Midstream Partners LP	NYSE
ENO	Entergy New Orleans Inc.First	NYSE
ENR	Energizer Holdings Inc	NYSE
ENS	Enersys Inc	NYSE
ENV	Envestnet Inc	NYSE
ENVA	Enova International Inc	NYSE
ENZ	Enzo Biochem	NYSE
EOCC	Empresa Nacional De Electricida	NYSE
EOD	Wells Fargo Global Dividend Opportunity	NYSE
EOG	Eog Resources	NYSE
EOI	Eaton Vance Enhance Equity	NYSE
EOS	Eaton Vance Enhanced Equity II	NYSE
EOT	Eaton Vance Muni Income Trust	NYSE
EP-C	El Paso Egy Cap I Pr	NYSE
EPAM	Epam Systems Inc	NYSE
EPC	Edgewell Personal Care	NYSE
EPD	Enterprise Products Partners LP	NYSE
EPE	Ep Energy Corp	NYSE
EPR	Entertainment Properties Trust	NYSE
EPR-C	Entertainment Prp Pf	NYSE
EPR-E	Entertainment Ppty P	NYSE
EPR-G	Epr Properties Pfd Ser G	NYSE
EQC	Equity Commonwealth	NYSE
EQC-D	Equity Commonwealth	NYSE
EQCO	Equity Commonwealth	NYSE
EQGP	Eqt Gp Holdings LP	NYSE
EQM	Equity Midstream Partners LP	NYSE
EQR	Equity Residential	NYSE
EQS	Equus Total Return	NYSE
EQT	Eqt Corp	NYSE
ERA	Era Group Inc	NYSE
ERF	Enerplus Corp	NYSE
ERJ	Embraer-Empresa Brasileira De Aeronautica	NYSE
EROS	Eros International Plc	NYSE
ES	Eversource Energy	NYSE
ESE	Esco Technologies Inc	NYSE
ESL	Esterline Technologies Corp	NYSE
ESNT	Essent Group Ltd	NYSE
ESRT	Empire State Realty Trust Inc	NYSE
ESS	Essex Property Trust	NYSE
ESTE	Earthstone Energy	NYSE
ESV	Ensco Plc	NYSE
ETB	Eaton Vance Tax-Managed Buy-Write	NYSE
ETE	Energy Transfer Equity LP	NYSE
ETG	Eaton Vance Tax-Advantaged Global Dividend	NYSE
ETH	Ethan Allen Interiors Inc	NYSE
ETJ	Eaton Vance Risk-Managed Diversified Equity	NYSE
ETM	Entercom Communications Corp	NYSE
ETN	Eaton Corp	NYSE
ETO	Eaton Vance Tax-Advantage Global Dividend Opp	NYSE
ETP	Energy Transfer Partners	NYSE
ETR	Entergy Corp	NYSE
ETV	Eaton Vance Corp	NYSE
ETW	Eaton Vance Corp	NYSE
ETX	Eaton Vance Municipal Income T	NYSE
ETY	Eaton Vance Tax-Managed Diversified Equity	NYSE
EURN	Euronav Nv	NYSE
EV	Eaton Vance Corp	NYSE
EVA	Enviva Partners LP	NYSE
EVC	Entravision Communications Corp	NYSE
EVF	Eaton Vance Senior Income Trust	NYSE
EVG	Eaton Vance Short Diversified	NYSE
EVH	Evolent Health Inc Class A Com	NYSE
EVHC	Envision Healthcare Holdings	NYSE
EVN	Eaton Vance Muni Income Trust	NYSE
EVR	Evercore Partners Inc	NYSE
EVRI	Everi Holdings Inc	NYSE
EVT	Eaton Vance Tax Advantaged Dividend	NYSE
EVTC	Evertec Inc	NYSE
EW	Edwards Lifesciences Corp	NYSE
EXC	Exelon Corp	NYSE
EXD	Eaton Vance Tax-Advantaged Bond	NYSE
EXG	Eaton Vance Tax-Managed Global Diversified Equit	NYSE
EXK	Endeavour Silver Corp	NYSE
EXP	Eagle Materials Inc	NYSE
EXPR	Express Inc	NYSE
EXR	Extra Space Storage Inc	NYSE
EXTN	Exterran Corp	NYSE
EZT	First Mortgage Bonds	NYSE
F	Ford Motor Company	NYSE
FAC	Liberte Investors Inc	NYSE
FAF	First American Corp	NYSE
FAM	First Trust/Aberdeen Global Opportunity	NYSE
FBC	Flagstar Bancorp	NYSE
FBHS	Fortune Brands Home & Security	NYSE
FBK	Fb Financial Corp	NYSE
FBM	Foundation Building Materials Inc	NYSE
FBP	First Bancorp	NYSE
FBR	Fibria Celulose S.A.	NYSE
FC	Franklin Covey Company	NYSE
FCAU	Fiat Chrysler Automobiles N.V.	NYSE
FCB	Fcb Financial Holdings Inc	NYSE
FCE.A	Forest City Ent Cl A	NYSE
FCF	First Commonwealth Financial Corp	NYSE
FCFS	First Cash Fin Svcs	NYSE
FCN	Fti Consulting	NYSE
FCPT	Four Corners Property Trust In	NYSE
FCT	Senior Floating Rate II	NYSE
FCX	Freeport-Mcmoran Inc	NYSE
FDC	First Data Corp	NYSE
FDEU	First Trust Dynamic Europe Equi	NYSE
FDP	Fresh Del Monte Produce	NYSE
FDS	Factset Research Systems Inc	NYSE
FDX	Fedex Corp	NYSE
FE	Firstenergy Corp	NYSE
FEDU	Four Seasons Education [Cayman] Inc	NYSE
FEI	First Trust MLP and Energy Inc	NYSE
FELP	Foresight Energy LP	NYSE
FENG	Phoenix New Media Ltd	NYSE
FEO	First Trust/Aberdeen Emerging Opportunity Fund	NYSE
FET	Forum Energy Technologies Inc	NYSE
FF	Futurefuel Corp	NYSE
FFA	First Trust Enhanced Equity Income Fund	NYSE
FFC	Flaherty Crumrine/Claymore Preferred Securities	NYSE
FFG	Fbl Financial Group	NYSE
FG	Fgl Holdings	NYSE
FG.W	Fgl Holdings WT	NYSE
FGB	Specialty Finance and Financial Fund	NYSE
FGP	Ferrellgas Partners LP	NYSE
FHN	First Horizon National Corp	NYSE
FHN-A	First Horizon National Corpora	NYSE
FHY	Strategic High II	NYSE
FI	Frank's International N.V.	NYSE
FICO	Fair Isaac and Company Inc	NYSE
FIF	First Trust Energy Infrastruct	NYSE
FII	Federated Investors	NYSE
FIS	Fidelity National Information Services	NYSE
FIT	Fitbit Inc	NYSE
FIV	First Trust Senior Floating Rate 2022 Target Ter	NYSE
FIX	Comfort Systems USA	NYSE
FL	Footlocker Inc	NYSE
FLC	Flaherty & Crumrine/Claymore Total Return	NYSE
FLO	Flowers Foods	NYSE
FLOW	SPX Flow Inc	NYSE
FLR	Fluor Corp	NYSE
FLS	Flowserve Corp	NYSE
FLT	Fleetcor Technologies	NYSE
FLY	Fly Leasing Ltd	NYSE
FMC	FMC Corp	NYSE
FMN	Federated Premier Muni	NYSE
FMO	Fiduciary/Claymore MLP Opportunity Fund	NYSE
FMS	Fresenius Medical Care Corp	NYSE
FMSA	Fmsa Holdings Inc	NYSE
FMX	Fomento Economico Mexicano S.A.B. De C.V.	NYSE
FMY	First Trust/Fidac Mortgage Income Fund	NYSE
FN	Fabrinet	NYSE
FNB	F.N.B. Corp	NYSE
FNB-E	F.N.B. Corporation Representin	NYSE
FND	Floor & Decor Holdings Inc	NYSE
FNF	Fidelity National Financial	NYSE
FNV	Franco Nev Corp	NYSE
FOE	Ferro Corp	NYSE
FOF	Cohen & Steers Closed-End Opportunity Fund	NYSE
FOR	Forestar Group Inc	NYSE
FPF	First Trust Intermediate Durat	NYSE
FPH	Five Point Holdings Llc Class A	NYSE
FPI	Farmland Partners Inc	NYSE
FPI-B	Farmland Partners Inc	NYSE
FPL	First Trust New Opportunities M	NYSE
FR	First Industrial Realty Trust	NYSE
FRA	Blackrock Floating Rate Income Fund	NYSE
FRAC	Keane Group Inc	NYSE
FRC	First Republic Bank	NYSE
FRC-D	First Republic Bank San Francis	NYSE
FRC-E	First Republic Bank	NYSE
FRC-F	First Republic Bank	NYSE
FRC-G	First Republic Bank	NYSE
FRC-H	First Republic Bank [San Francisco Ca] Dep Shs R	NYSE
FRO	Frontline Ltd	NYSE
FRT	Federal Realty Investment Trust	NYSE
FRT-C	Federal Realty Investment Dep Shs Repstg 1/1000T	NYSE
FSB	Franklin Financial Network Inc	NYSE
FSD	High Income Long Short Fund	NYSE
FSIC	FS Investment Corp	NYSE
FSM	Fortuna Silver Mines	NYSE
FSS	Federal Signal Corp	NYSE
FT	Franklin Universal Trust	NYSE
FTAI	Fortress Transportation & Infra	NYSE
FTI	Technipfmc Plc	NYSE
FTK	Flotek Industries	NYSE
FTS	Fortis Inc	NYSE
FTSI	Fts International Inc.	NYSE
FTV	Fortive Corp	NYSE
FUL	H. B. Fuller Company	NYSE
FUN	Cedar Fair LP	NYSE
G	Genpact Ltd	NYSE
GAB	Gabelli Equity Trust	NYSE
GAB-D	Gabelli Eq TR Pfd D	NYSE
GAB-G	The Gabelli Equity Trust Inc	NYSE
GAB-H	The Gabelli Eqty Trust Inc	NYSE
GAB-J	Gabelli Equity Trust Inc	NYSE
GAM	General American Investors	NYSE
GAM-B	Genl Amer Invs Pfd	NYSE
GATX	GATX Corp	NYSE
GBAB	Guggenheim Build America Bonds	NYSE
GBL	Gamco Investors	NYSE
GBX	Greenbrier Companies	NYSE
GCAP	Gain Capital Holdings	NYSE
GCH	Greater China Fund	NYSE
GCI	Gannett Co. Inc	NYSE
GCO	Genesco Inc	NYSE
GCP	Gcp Applied Technologies Inc C	NYSE
GCV	Gabelli Convertible and Income Securities	NYSE
GCV-B	Gabelli 6.00% Pfd B	NYSE
GD	General Dynamics Corp	NYSE
GDDY	Godaddy Inc	NYSE
GDI	Gardner Denver Holdings Inc	NYSE
GDL	The Gdl Fund	NYSE
GDL-B	The Gdl Fund Series B Cumulativ	NYSE
GDO	Western Asset Global Corporate Defined	NYSE
GDOT	Green Dot Corp	NYSE
GDV	Gabelli Dividend	NYSE
GDV-A	Gabelli Dv	NYSE
GDV-D	Gabelli Pref D	NYSE
GDV-G	Gabelli Dividend & Income Trust	NYSE
GE	General Electric Company	NYSE
GEB	General Electric Capital Corpo	NYSE
GEF	Greif Bros. Corp	NYSE
GEF.B	Greif Bros. Corp	NYSE
GEH	General Electric Capital Corpo	NYSE
GEK	General Electric Capital Corpo	NYSE
GEL	Genesis Energy LP	NYSE
GEN	Genesis Healthcare Inc	NYSE
GEO	Geo Group Inc	NYSE
GER	Goldman Sachs MLP Energy Renai	NYSE
GES	Guess Inc	NYSE
GF	New Germany Fund	NYSE
GFA	Gafisa S.A.	NYSE
GFF	Griffon Corp	NYSE
GFI	Gold Fields Ltd	NYSE
GFY	Western Asset Variable Rate Strategic	NYSE
GG	Goldcorp Inc	NYSE
GGB	Gerdau S.A.	NYSE
GGG	Graco Inc	NYSE
GGM	Guggenheim Credit Allocation F	NYSE
GGP	Ggp Inc	NYSE
GGP-A	Ggp Inc Prf A	NYSE
GGT	Gabelli Global Multi-Media Trust	NYSE
GGT-B	Gabelli Global Multi-Media Trus	NYSE
GGT-E	Gabelli Multimedia Trust Inc Pfd Ser E	NYSE
GGZ	Gabelli Global Small and Mid CA	NYSE
GGZ-A	Gabelli Global Small and Mid CA	NYSE
GHC	Graham Holdings Company	NYSE
GHL	Greenhill & Co. Inc	NYSE
GHM	Graham Corp	NYSE
GHY	Prudential Global Short Durati	NYSE
GIB	CGI Group	NYSE
GIG	Gigcapital Inc. Common Stock	NYSE
GIG.P	Gig Capital Rt Rights	NYSE
GIG.U	Gigcapital Inc Unit	NYSE
GIG.W	Gig Capital WT Warrant	NYSE
GIL	Gildan Activewear	NYSE
GIM	Templeton Global	NYSE
GIS	General Mills	NYSE
GJH	Strats Sm Trust For United States Cellular Corp	NYSE
GJO	Strats Sm Trust For Wal-Mart Stores Inc Securiti	NYSE
GJP	Strats Sm Trust For Dominion Resources Inc Secur	NYSE
GJR	Strats Sm Trust For The Procter & Gamble Co Secu	NYSE
GJS	Strats Sm Trust For Goldman Sachs Group Securiti	NYSE
GJT	Strats Sm Trust For Allstate Corp Securities Ser	NYSE
GJV	Strats Sm Trust For News Corp Securities Series	NYSE
GKOS	Glaukos Corp	NYSE
GLO-A	Gaslog Partners LP 8.625% Series A	NYSE
GLO-B	Gaslog Partners LP Perp Pref Unit Ser B Fixed/Fl	NYSE
GLO-G	Gaslog Partners LP 8.75% Series A	NYSE
GLOB	Globant S.A.	NYSE
GLOG	Gaslog Ltd	NYSE
GLOP	Gaslog Partners LP	NYSE
GLP	Global Partners LP	NYSE
GLT	Glatfelter	NYSE
GLW	Corning Inc	NYSE
GM	General Motors Company	NYSE
GM.B	General Mtrs	NYSE
GME	Gamestop Corp	NYSE
GMED	Globus Medical Inc	NYSE
GMR-A	Global Med REIT Inc Pfd.	NYSE
GMRE	Global Medical REIT Inc	NYSE
GMS	Gms	NYSE
GMTA	GATX Corporation 5.625% Senior	NYSE
GMZ	Goldman Sachs MLP Income Oppor	NYSE
GNC	GNC Holdings Inc	NYSE
GNE	Genie Energy Ltd Class B	NYSE
GNE-A	Genie Energy Ltd Series	NYSE
GNK	Genco Shipping & Trading Ltd	NYSE
GNL	Global Net Lease Inc	NYSE
GNL-A	Global Net Lease Inc 7.25% Pfd Ser A	NYSE
GNRC	Generac Holdings Inc	NYSE
GNRT	Gener8 Maritime Inc	NYSE
GNT	Gabelli Natural Resources Gold	NYSE
GNT-A	Gamco Natural Resources Gold & Income Trust	NYSE
GNW	Genworth Financial Inc	NYSE
GOF	Claymore/Guggenheim Strategic Fund	NYSE
GOL	Gol Linhas Aereas Inteligentes S.A.	NYSE
GOLF	Acushnet Holdings Corp	NYSE
GOOS	Canada Goose Holdings Inc Subordinate Voting Sh	NYSE
GPC	Genuine Parts Company	NYSE
GPI	Group 1 Automotive	NYSE
GPJA	Georgia Power Company Series 2017A 5.00% Jr	NYSE
GPK	Graphic Packaging Holding Company	NYSE
GPM	Guggenheim Enhanced Equity	NYSE
GPMT	Granite Point Mortgage Trust Inc	NYSE
GPN	Global Payments Inc	NYSE
GPRK	Geopark Hldgs Lmtd	NYSE
GPS	Gap Inc	NYSE
GPT	Gramercy Property Trust	NYSE
GPT-A	Gramercy Property Trust	NYSE
GPX	Gp Strategies Corp	NYSE
GRA	W.R. Grace & Company	NYSE
GRAM	Graa Y Montero S.A.A	NYSE
GRC	Gorman-Rupp Company	NYSE
GRP.U	Granite Real Estate Investment	NYSE
GRR	Asia Tigers Fund	NYSE
GRUB	Grubhub Inc	NYSE
GRX	The Gabelli Healthcare & Wellness Trust	NYSE
GRX-A	The Gabelli Healthcare & Welln	NYSE
GRX-B	The Gabelli Healthcare & Welln	NYSE
GS	Goldman Sachs Group	NYSE
GS-A	Goldman Sachs Pfd Series A	NYSE
GS-B	Goldman Sachs Pfd Series B	NYSE
GS-C	Goldman Sachs Pfd Series C	NYSE
GS-D	Goldman Sachs Pfd Series D	NYSE
GS-J	Goldman Sachs Pfd Series J	NYSE
GS-K	Goldman Sachs Pfd Series K	NYSE
GS-N	Goldman Sachs Pfd Series N	NYSE
GSBD	Goldman Sachs Bdc Inc	NYSE
GSH	Guangshen Railway Company	NYSE
GSK	Glaxosmithkline Plc	NYSE
GSL	Global Ship Lease Inc	NYSE
GSL-B	Global Ship Lease Inc	NYSE
GTES	Gates Industrial Corporation Plc Ordinary Shares	NYSE
GTN	Gray Television	NYSE
GTN.A	Gray Television	NYSE
GTS	Triple-S Management Corp	NYSE
GTT	Global Telcom & Technology Inc	NYSE
GTY	Getty Realty Corp	NYSE
GUT	Gabelli Utility Trust	NYSE
GUT-A	Gabelli Util Pfd A	NYSE
GUT-C	Gabelli Utility Trust	NYSE
GVA	Granite Construction Inc	NYSE
GWB	Great Western Bancorp Inc	NYSE
GWR	Genesee & Wyoming	NYSE
GWRE	Guidewire Software Inc	NYSE
GWW	W.W. Grainger	NYSE
GXP	Great Plains Energy Inc	NYSE
GYB	Cabco Series 2004-101 Trust	NYSE
GYC	Corporate Asset Backed Corp Cabco	NYSE
GZT	Gazit-Globe Ltd	NYSE
H	Hyatt Hotels Corp	NYSE
HAE	Haemonetics Corp	NYSE
HAL	Halliburton Company	NYSE
HASI	Hannon Armstrong Sustainable In	NYSE
HBB	Horizons CA Select Universe Bond ETF	NYSE
HBI	Hanesbrands Inc	NYSE
HBM	Hudbay Minerals Inc	NYSE
HBM.W	Hudbay Minerals Inc	NYSE
HCA	Hca Holdings Inc	NYSE
HCC	Warrior Met Coal Inc	NYSE
HCHC	Hc2 Holdings Inc	NYSE
HCI	Homeowners Choice	NYSE
HCLP	Hi-Crush Partners LP	NYSE
HCN	Welltower Inc	NYSE
HCN-I	Health Care REIT Inc	NYSE
HCP	HCP Inc	NYSE
HD	Home Depot	NYSE
HDB	Hdfc Bank Ltd	NYSE
HE	Hawaiian Electric Industries	NYSE
HE-U	Heco Cap III 6.50	NYSE
HEI	Heico Corp	NYSE
HEI.A	Heico Cp Cl A	NYSE
HEP	Holly Energy Partners LP	NYSE
HEQ	John Hancock Hedged Eqty & Inc	NYSE
HES	Hess Corp	NYSE
HES-A	Hess Corp	NYSE
HESM	Hess Midstream Partners LP	NYSE
HF	HFF Inc	NYSE
HFC	Hollyfrontier Corp	NYSE
HFRO	Highland Floating Rate Opportunities Fund	NYSE
HGH	The Hartford Financial Srvcs G	NYSE
HGT	Hugoton Royalty Trust	NYSE
HGV	Hilton Grand Vacations Inc	NYSE
HHC	Howard Hughes Corp	NYSE
HHS	Harte-Hanks	NYSE
HI	Hillenbrand Inc	NYSE
HIE	Miller/Howard High Income Eqty	NYSE
HIFR	Infrareit Inc	NYSE
HIG	Hartford Financial Services Group	NYSE
HIG.W	Hartford Financial Services Group	NYSE
HII	Huntington Ingalls Industries	NYSE
HIL	Hill International	NYSE
HIO	Western Asset High	NYSE
HIVE	Aerohive Networks Inc	NYSE
HIW	Highwoods Properties	NYSE
HIX	Western Asset High Income Fund II Inc	NYSE
HJV	MS S.A.C. Saturns Ge Series 2002-14	NYSE
HK	Halcon Resources	NYSE
HK.W	Halcon Resources Corp Warrant	NYSE
HL	Hecla Mining Company	NYSE
HL-B	Hecla Mining Pfd B	NYSE
HLF	Herbalife Ltd	NYSE
HLI	Houlihan Lokey	NYSE
HLT	Hilton Inc	NYSE
HLX	Helix Energy Solutions Group	NYSE
HMC	Honda Motor Company	NYSE
HMI	Huami Corporation ADR	NYSE
HML-A	Hoegh Lng Partners LP Cum Red Pfd Ser A	NYSE
HMLP	Hoegh Lng Partners LP	NYSE
HMN	Horace Mann Educators Corp	NYSE
HMY	Harmony Gold Mining Co. Ltd	NYSE
HNI	Hon Industries Inc	NYSE
HNP	Huaneng Power Intl	NYSE
HOG	Harley-Davidson Inc	NYSE
HOME	At Home Group Inc	NYSE
HON	Honeywell International Inc	NYSE
HOS	Hornbeck Offshore Services	NYSE
HOV	Hovnanian Enterprises Inc	NYSE
HP	Helmerich & Payne	NYSE
HPE	Hewlett Packard Enterprise Comp	NYSE
HPF	John Hancock Pfd II	NYSE
HPI	John Hancock Preferred	NYSE
HPP	Hudson Pacific Properties	NYSE
HPQ	Hewlett-Packard Company	NYSE
HPR	Highpoint Resources Corp.	NYSE
HPS	John Hancock Preferred Income Fund III	NYSE
HQH	Tekla Healthcare Investors	NYSE
HQL	Tekla Life Sciences Investors	NYSE
HR	Healthcare Realty Trust Inc	NYSE
HRB	H&R Block	NYSE
HRC	Hill-Rom Holdings Inc	NYSE
HRG	Hrg Group Inc	NYSE
HRI	Herc Holdings Inc	NYSE
HRL	Hormel Foods Corp	NYSE
HRS	Harris Corp	NYSE
HRTG	Heritage Insurance Holdings	NYSE
HSB-A	HSBC Holdings Plc	NYSE
HSBC	HSBC Holdings Plc	NYSE
HSC	Harsco Corp	NYSE
HSEA	HSBC Holdings Plc Perpetual S	NYSE
HSEB	HSBC Holdings Plc Perp Sub Cap	NYSE
HST	Host Marriott Financial Trust	NYSE
HSY	Hershey Foods Corp	NYSE
HT	Hersha Hospitality Trust	NYSE
HT-C	Hersha Hospitality Trust	NYSE
HT-D	Hersha Hospitality Trust 6.50%	NYSE
HT-E	Hersha Hospitality Trust	NYSE
HTA	Healthcare Trust of America I	NYSE
HTD	John Hancock Tax Advantaged Dividend	NYSE
HTFA	Horizon Technology Finance 6.25% Notes Due 2022	NYSE
HTGC	Hercules Technology Growth Capital	NYSE
HTGX	Hercules Technology Growth Cap	NYSE
HTH	Hilltop Holdings Inc	NYSE
HTY	John Hancock Tax-Advantaged Global	NYSE
HTZ	Hertz Global Holdings Inc	NYSE
HUBB	Hubbell Inc B	NYSE
HUBS	Hubspot Inc	NYSE
HUD	Hudson Ltd. Class A Common Shares	NYSE
HUM	Humana Inc	NYSE
HUN	Huntsman Corp	NYSE
HVT	Haverty Furniture Companies	NYSE
HVT.A	Haverty Furn Cl A SC	NYSE
HXL	Hexcel Corp	NYSE
HY	Hyster-Yale Materials Handling	NYSE
HYB	New America High	NYSE
HYH	Halyard Health Inc	NYSE
HYI	Western Asset High Yield Defined	NYSE
HYT	Blackrock High Yield Fund Vi Inc	NYSE
HZN	Horizon Global Corporation Comm	NYSE
HZO	Marinemax Inc	NYSE
I	Intelsat S.A.	NYSE
IAE	VOYA Asia Pacific High Dividend Equity	NYSE
IAG	Iamgold Corp	NYSE
IBA	Industrias Bachoco S.A. De C.V.	NYSE
IBM	International Business Machines	NYSE
IBN	Icici Bank Ltd	NYSE
IBP	Installed Building Products I	NYSE
ICB	MS Income Securities	NYSE
ICD	Independence Contract Drilling Inc	NYSE
ICE	Intercontinental Exchange	NYSE
ICL	Israel Chemicals Ltd	NYSE
IDA	Idacorp Inc	NYSE
IDE	VOYA Infrastructure Industrial	NYSE
IDT	IDT Corp	NYSE
IEX	Idex Corp	NYSE
IFF	International Flavors & Fragrances	NYSE
IFN	India Fund	NYSE
IGA	VOYA Global Advantage and Premium	NYSE
IGD	VOYA Global Equity Dividend and Premium	NYSE
IGI	Western Asset Investment Grade Defined	NYSE
IGR	VOYA Clarion Global Real Estate	NYSE
IGT	International Game Technology	NYSE
IHC	Independence Holding Company	NYSE
IHD	VOYA Emerging Markets High Dividend	NYSE
IHG	Intercontinental Hotels Group	NYSE
IHIT	Invesco High Income 2023 Target Term Fund	NYSE
IHTA	Invesco High Income 2024 Target Term Fund	NYSE
IID	VOYA International High Dividend Equity	NYSE
IIF	Morgan Stanley India Investment Fund Inc	NYSE
IIM	Invesco Insured Muni Income Trust	NYSE
IIP-A	Innovative Industrial Properties 9.00% Series A	NYSE
IIPR	Innovative Industrial Properties	NYSE
IMAX	Imax Corp	NYSE
INB	Cohen & Steers Global Income Builder	NYSE
INF	Brookfield Global Listed Infra	NYSE
INFY	Infosys Ltd	NYSE
ING	VOYA Group N.V.	NYSE
INGR	Ingredion Inc	NYSE
INN	Summit Hotel Properties	NYSE
INN-C	Summit Hotel Properties Inc	NYSE
INN-D	Summit Hotel Properties Inc	NYSE
INN-E	Summit Hotel Properties Inc Cum Red Pfd Ser E	NYSE
INSI	Insight Select Income Fund	NYSE
INST	Instructure Inc	NYSE
INSW	International Seaways Inc	NYSE
INT	World Fuel Services Corp	NYSE
INVH	Invitation Homes Inc	NYSE
INXN	Interxion Holding N.V.	NYSE
IO	ION Geophysical Corp	NYSE
IP	International Paper Company	NYSE
IPG	Interpublic Group of Companies	NYSE
IPHI	Inphi Corp	NYSE
IPI	Intrepid Potash Inc	NYSE
IPL-D	Interstate Power and Light Co	NYSE
IPO.U	Social Capital Hedosophia Holdings Corp	NYSE
IPO.W	Social Capital Hedosophia Warrant	NYSE
IPOA	Social Capital Hedosophia Holdings Corp	NYSE
IQI	Invesco Quality Muni Income Trust	NYSE
IQV	Iqvia Holdings Inc	NYSE
IR	Ingersoll-Rand Plc [Ireland]	NYSE
IRE-C	Investors Real Estate Trust Pfd Ser C	NYSE
IRET	Investors Real Estate Trust	NYSE
IRL	Irish Investment Fund	NYSE
IRM	Iron Mountain Inc	NYSE
IRR	VOYA Risk Managed Natural Resources Fund	NYSE
IRS	Irsa Inversiones Y Representaciones S.A.	NYSE
IRT	Independence Realty Trust Inc	NYSE
ISD	Prudential Short Duration High	NYSE
ISF	VOYA Group N.V.	NYSE
ISG	VOYA Group N.V.	NYSE
IT	Gartner Inc	NYSE
ITCB	Itau Corpbanca	NYSE
ITG	Investment Technology Group	NYSE
ITGR	Integer Holdings Corp	NYSE
ITT	ITT Industries	NYSE
ITUB	Itau Unibanco Banco Holding S.A.	NYSE
ITW	Illinois Tool Works Inc	NYSE
IVC	Invacare Corp	NYSE
IVH	Ivy High Income Opportunities	NYSE
IVR	Invesco Mortgage Capital Inc	NYSE
IVR-A	Invesco Mortgage Capital Inc	NYSE
IVR-B	Invesco Mortgage Capital Inc	NYSE
IVR-C	Invesco Mortgage Capital Inc Pfd Fxd/Fltg Ser C	NYSE
IVZ	Invesco Plc	NYSE
IX	Orix Corp ADR	NYSE
JAG	Jagged Peak Energy Inc	NYSE
JAX	J. Alexander's Holdings Inc C	NYSE
JBGS	Jbg Smith Properties	NYSE
JBK	Lehman Abs Corp	NYSE
JBL	Jabil Circuit	NYSE
JBN	Select Asset Inc	NYSE
JBR	Select Asset Inc	NYSE
JBT	John Bean Technologies Corp	NYSE
JCA-B	Jernigan Capital Inc Pfd Ser B	NYSE
JCAP	Jernigan Capital Inc	NYSE
JCE	Nuveen Core Equity Alpha Fund	NYSE
JCI	Johnson Controls Intl	NYSE
JCO	Nuveen Credit Opportunities 2022 Target Term Fun	NYSE
JCP	J.C. Penney Company Inc	NYSE
JDD	Nuveen Diversified Dividend and	NYSE
JE	Just Energy Group Inc	NYSE
JE-A	Just Energy Group Inc	NYSE
JEC	Jacobs Engineering Group Inc	NYSE
JELD	Jeld-Wen Holding Inc	NYSE
JEMD	Nuveen Emerging Markets Debt 2022 Target Term Fu	NYSE
JEQ	Japan Equity Fund	NYSE
JFR	Nuveen Floating Rate	NYSE
JGH	Nuveen Global High Income Fund	NYSE
JHA	Nuveen High Income December	NYSE
JHB	Nuveen High Income November 2021 Target Term Fun	NYSE
JHD	Nuveen High Income December 2019 Target Term Fun	NYSE
JHG	Janus Henderson Group Plc.	NYSE
JHI	John Hancock Investors Trust	NYSE
JHS	John Hancock Income Securities Trust	NYSE
JHX	James Hardie Industries Se	NYSE
JHY	Nuveen High Income 2020 Target	NYSE
JILL	J. Jill Inc	NYSE
JKS	Jinkosolar Holding Company Ltd	NYSE
JLL	Jones Lang Lasalle Inc	NYSE
JLS	Nuveen Mortgage Opportunity Term Fund	NYSE
JMEI	Jumei International Holding Ltd	NYSE
JMF	Nuveen Energy MLP Total Return Fund	NYSE
JMLP	Nuveen All Cap Energy MLP Oppo	NYSE
JMM	Nuveen Multi-Market Income Fund Inc	NYSE
JMP	JMP Group Inc	NYSE
JMPB	JMP Group Inc	NYSE
JMPD	JMP Group Llc 7.25% Senior Notes Due 2027	NYSE
JMT	Nuven Mortgage Opportunity Term Fund 2	NYSE
JNJ	Johnson & Johnson	NYSE
JNPR	Juniper Networks	NYSE
JOE	St. Joe Company	NYSE
JOF	Japan Smaller Capitalization Fund Inc	NYSE
JONE	Jones Energy Inc	NYSE
JP	Jupai Holdings Ltd	NYSE
JPC	Nuveen Preferred and Convertible	NYSE
JPI	Nuveen Preferred and Income Term Fund	NYSE
JPM	JP Morgan Chase & Co	NYSE
JPM-A	JP Morgan Chase & Co	NYSE
JPM-B	Jpmorgan Chase & Co. 6.70%	NYSE
JPM-E	Jpmorgan Chase & Co	NYSE
JPM-F	J P Morgan Chase & Co Depositar	NYSE
JPM-G	J P Morgan Chase & Co Depositar	NYSE
JPM-H	Jpmorgan Chase & Co	NYSE
JPM.W	JP Morgan Chase & Co	NYSE
JPS	Nuveen Quality Preferred 2	NYSE
JPT	Nuveen Preferred and Income 2022 Term Fund	NYSE
JQC	Nuveen Preferred and Convertible 2	NYSE
JRI	Nuveen Real Asset Income and Gr	NYSE
JRO	Nuveen Floating Rate Income Opportuntiy	NYSE
JRS	Nuveen Real Estate Fund	NYSE
JSD	Nuveen Short Duration Credit O	NYSE
JT	Jianpu Technology Inc	NYSE
JTA	Nuveen Tax-Advantaged Total Return	NYSE
JTD	Nuveen Tax-Advantaged Dividend Growth	NYSE
JW.A	John Wiley Sons Cl A	NYSE
JW.B	John Wiley Sons Cl B	NYSE
JWN	Nordstrom	NYSE
K	Kellogg Company	NYSE
KAI	Kadant Inc	NYSE
KAMN	Kaman Corp	NYSE
KAP	Kcap Financial Inc	NYSE
KAR	Kar Auction Services Inc	NYSE
KB	KB Financial Group Inc	NYSE
KBH	KB Home	NYSE
KBR	KBR Inc	NYSE
KDMN	Kadmon Holdings Llc	NYSE
KED	Kayne Anderson Energy Development Company	NYSE
KEG	Key Energy Services Inc	NYSE
KEM	Kemet Corp	NYSE
KEN	Kenon Holdings Ltd Ordinary Sh	NYSE
KEP	Korea Electric Power Corp	NYSE
KEX	Kirby Corp	NYSE
KEY	Keycorp	NYSE
KEY-I	Keycorp Pref Share	NYSE
KEYS	Keysight Technologies Inc Comm	NYSE
KF	Korea Fund	NYSE
KFS	Kingsway Financial Services	NYSE
KFY	Korn/Ferry International	NYSE
KGC	Kinross Gold Corp	NYSE
KIM	Kimco Realty Corp	NYSE
KIM-I	Kimco Realty Corporation Deposi	NYSE
KIM-J	Kimco Realty Corporation Class	NYSE
KIM-K	Kimco Realty Corporation Class	NYSE
KIM-L	Kimco Realty Corp Dep Shs Repstg 1/1000Th Pfd Cl	NYSE
KIM-M	Kimco Realty Corp Dep Shs Repstg 1/1000 Shs Cl M	NYSE
KIO	KKR Income Opportunities Fund	NYSE
KKR	KKR & Co. LP	NYSE
KKR-A	KKR & Co. LP Prf	NYSE
KKR-B	KKR & Co. LP	NYSE
KL	Kirkland Lake Gold Ltd	NYSE
KMB	Kimberly-Clark Corp	NYSE
KMF	Kayne Anderson Midstream Energy Fund	NYSE
KMG	KMG Chemicals	NYSE
KMI	Kinder Morgan	NYSE
KMI-A	Kinder Morgan Inc	NYSE
KMM	Scudder Multi-Market Income Trust	NYSE
KMPA	Kemper Corporation 7.375% Subor	NYSE
KMPR	Kemper Corp	NYSE
KMT	Kennametal Inc	NYSE
KMX	Carmax Inc	NYSE
KN	Knowles Corp	NYSE
KND	Kindred Healthcare	NYSE
KNL	Knoll Inc	NYSE
KNOP	Knot Offshore Partners LP	NYSE
KNX	Knight-Swift Transporation Inc	NYSE
KO	Coca-Cola Company	NYSE
KOD.W	Eastman Kodak Co. WT	NYSE
KOD.X	Eastman Kodak Co. WT X	NYSE
KODK	Eastman Kodak	NYSE
KOF	Coca Cola Femsa S.A.B. De C.V.	NYSE
KOP	Koppers Holdings Inc	NYSE
KORS	Michael Kors Holdings Ltd	NYSE
KOS	Kosmos Energy Ltd	NYSE
KR	Kroger Company	NYSE
KRA	Kraton Performance Polymers Inc	NYSE
KRC	Kilroy Realty Corp	NYSE
KREF	KKR Real Estate Finance Trust Inc	NYSE
KRG	Kite Realty Group Trust	NYSE
KRO	Kronos Worldwide Inc	NYSE
KRP	Kimbell Royalty Partners	NYSE
KS	Kapstone Paper and Packaging Corp	NYSE
KSM	Scudder Strategic Municiple Income Trust	NYSE
KSS	Kohl's Corp	NYSE
KST	Scudder Strategic Income Trust	NYSE
KSU	Kansas City Southern	NYSE
KSU.P	Kansas Cty Sthn 4%	NYSE
KT	Korea Telecom Corp	NYSE
KTF	Scudder Municiple Income Trust	NYSE
KTH	Lehman Abs Corp	NYSE
KTN	Lehman Abs Corp	NYSE
KTP	Lehman Abs Corp	NYSE
KW	Kennedy-Wilson Holdings Inc	NYSE
KWR	Quaker Chemical Corp	NYSE
KYE	Kayne Anderson Energy Total Return Fund	NYSE
KYN	Kayne Anderson MLP Investment Company	NYSE
KYN-F	Kayne Anderson MLP Investment	NYSE
KYO	Kyocera Corp	NYSE
L	Loews Corp	NYSE
LAC	Lithium Americas Corp	NYSE
LAD	Lithia Motors	NYSE
LADR	Ladder Capital Corp	NYSE
LAZ	Lazard Ltd	NYSE
LB	L Brands Inc	NYSE
LBRT	Liberty Oilfield Services Inc.	NYSE
LC	Lendingclub Corp	NYSE
LCI	Lannett Co Inc	NYSE
LCII	Lci Industries	NYSE
LCM	Advent/Claymore Enhanced Growth &	NYSE
LDF	Latin American Discovery Fund	NYSE
LDL	Lydall Inc	NYSE
LDOS	Leidos Holdings Inc	NYSE
LDP	Cohen & Steers Ltd Duration Prfd Income Fund	NYSE
LEA	Lear Corp	NYSE
LEE	Lee Enterprises Inc	NYSE
LEG	Leggett & Platt Inc	NYSE
LEJU	Leju Holdings Ltd	NYSE
LEN	Lennar Corp	NYSE
LEN.B	Lennar Corp	NYSE
LEO	Dreyfus Strategic Municipals	NYSE
LFC	China Life Insurance Company Ltd	NYSE
LFGR	Leaf Group Ltd	NYSE
LGC	Legacy Acquisition Corp	NYSE
LGC.U	Legacy Acquisition Corp Units	NYSE
LGC.W	Legacy Acquisition Corp. WT	NYSE
LGF.A	Lions Gate Entertainment Corp Cl A	NYSE
LGF.B	Lions Gate Entertainment Corp Cl B	NYSE
LGI	Lazard Global Total Return and	NYSE
LH	Laboratory Corporation of America Holdings	NYSE
LHC.U	Leo Holdings Corp. Units Each Consisting of One	NYSE
LHO	Lasalle Hotel Properties	NYSE
LHO-I	Lasalle Hotel Properties	NYSE
LHO-J	Lasalle Hotel Properties	NYSE
LII	Lennox International	NYSE
LITB	Lightinthebox Holding Co. Ltd	NYSE
LKM	Link Motion Inc.	NYSE
LKSD	Lsc Communications Inc	NYSE
LL	Lumber Liquidators Holdings Inc	NYSE
LLL	L-3 Communications Holdings	NYSE
LLY	Eli Lilly and Company	NYSE
LM	Legg Mason Inc	NYSE
LMHA	Legg Mason Inc	NYSE
LMHB	Legg Mason Inc	NYSE
LMT	Lockheed Martin Corp	NYSE
LN	Line Corp	NYSE
LNC	Lincoln National Corp	NYSE
LNC.W	Lincoln National Corp	NYSE
LND	Brasilagro Brazi ADR	NYSE
LNN	Lindsay Corp	NYSE
LNT	Alliant Energy Corp	NYSE
LOMA	Loma Negra Comp Indu Argentina Sociedad ADR	NYSE
LOR	Lazard World Dividend &	NYSE
LOW	Lowe's Companies	NYSE
LPG	Dorian Lpg Ltd	NYSE
LPI	Laredo Petroleum Holdings Inc	NYSE
LPL	Lg Display Co. Ltd	NYSE
LPT	Liberty Property Trust	NYSE
LPX	Louisiana-Pacific Corp	NYSE
LQ	La Quinta Holdings Inc	NYSE
LRN	K12 Inc	NYSE
LSI	Life Storage	NYSE
LTC	Ltc Properties	NYSE
LTM	Latam Airlines Group S.A.	NYSE
LTN.U	Union Acquisition Corp	NYSE
LUB	Luby's Inc	NYSE
LUK	Leucadia National Corp	NYSE
LUV	Southwest Airlines Company	NYSE
LVS	Las Vegas Sands	NYSE
LW	Lamb Weston Holdings Inc	NYSE
LXFR	Luxfer Holdings Plc	NYSE
LXFT	Luxoft Holding Inc	NYSE
LXP	Lexington Realty Trust	NYSE
LXP-C	Lexington Realty Tru	NYSE
LXU	Lsb Industries Inc	NYSE
LYB	Lyondellbasell Industries Nv	NYSE
LYG	Lloyds Banking Group Plc	NYSE
LYV	Live Nation Entertainment	NYSE
LZB	La-Z-Boy Inc	NYSE
M	Macy's Inc	NYSE
MA	Mastercard Inc	NYSE
MAA	Mid-America Apartment Communities	NYSE
MAA-I	Mid-America Apt Communities Inc	NYSE
MAC	Macerich Company	NYSE
MAIN	Main Street Capital Corp	NYSE
MAN	Manpower Inc	NYSE
MANU	Manchester United Ltd	NYSE
MAS	Masco Corp	NYSE
MATX	Matson Inc	NYSE
MAV	Pioneer Muni High Income Advantage Trust	NYSE
MAXR	Maxar Technologies Ltd	NYSE
MBI	MBIA Inc	NYSE
MBT	Mobile Telesystems	NYSE
MC	Moelis	NYSE
MCA	Blackrock Muniyield California Insured Fund	NYSE
MCB	Metropolitan Bank Holding Corp	NYSE
MCC	Medley Capital Corp	NYSE
MCD	McDonald's Corp	NYSE
MCI	Massmutual Corporate Investors	NYSE
MCK	Mckesson Corp	NYSE
MCN	Madison/Claymore Covered Call & Equity Strategy	NYSE
MCO	Moody's Corp	NYSE
MCR	MFS Charter Income Trust	NYSE
MCRN	Milacron Holdings Corp	NYSE
MCS	Marcus Corp	NYSE
MCV	Medley Capital Corp	NYSE
MCX	Medley Capital Corp	NYSE
MCY	Mercury General Corp	NYSE
MD	Mednax Inc	NYSE
MDC	M.D.C. Holdings	NYSE
MDLQ	Medley Llc 7.25% Notes Due 2024	NYSE
MDLX	Medley Llc	NYSE
MDLY	Medley Management Inc	NYSE
MDP	Meredith Corp	NYSE
MDR	McDermott International	NYSE
MDT	Medtronic Inc	NYSE
MDU	Mdu Res Group Inc	NYSE
MED	Medifast Inc	NYSE
MEI	Methode Electronics	NYSE
MEN	Blackrock Munienhanced Fund	NYSE
MER-K	ML 6.45% Trust Pfd	NYSE
MER-P	ML Cap TR III 7.375%	NYSE
MET	Metlife Inc	NYSE
MET-A	Metlife Pfd A Fltg	NYSE
MFA	MFA Financial Inc	NYSE
MFA-B	MFA Financial Inc	NYSE
MFC	Manulife Financial Corp	NYSE
MFCB	Mfc Industrial Ltd	NYSE
MFD	Macquarie/First Trust Global	NYSE
MFG	Mizuho Financial Group	NYSE
MFGP	Micro Focus Intl Plc	NYSE
MFL	Blackrock Muniholdings Investment Quality Fund	NYSE
MFM	MFS Muni Income Trust	NYSE
MFO	MFA Financial Inc	NYSE
MFT	Blackrock Muniyield Investment Qualityfund	NYSE
MFV	MFS Special Value Trust	NYSE
MG	Mistras Group Inc	NYSE
MGA	Magna International	NYSE
MGF	MFS Government Markets Income Trust	NYSE
MGM	MGM Resorts International	NYSE
MGP	MGM Growth Properties Llc	NYSE
MGU	Macquarie Global Infrastructure Total Return Fun	NYSE
MH-A	Maiden Holdings Ltd 8.25%	NYSE
MH-C	Maiden Holdings North America	NYSE
MH-D	Maiden Holdings Ltd Pref Ser D	NYSE
MHD	Blackrock Muniholdings Fund	NYSE
MHF	Western Asset Muni High	NYSE
MHI	Pioneer Muni High Income Trust	NYSE
MHK	Mohawk Industries	NYSE
MHLA	Maiden Holdings Ltd 6.625% No	NYSE
MHN	Blackrock Muniholdings New York Quality Fund	NYSE
MHNC	Maiden Holdings North America	NYSE
MHO	M/I Homes	NYSE
MIC	Macquarie Infrastructure Company Trust	NYSE
MIE	Cohen & Steers MLP Income and	NYSE
MIN	MFS Intermediate Income Trust	NYSE
MIT-A	Ag Mortgage Investment Trust	NYSE
MIT-B	Ag Mortgage Investment Trust I	NYSE
MITT	Ag Mortgage Investment Trust	NYSE
MIXT	Mix Telematics Ltd	NYSE
MIY	Blackrock Muniyield Michigan Quality Fund	NYSE
MKC	Mccormick & Company Inc	NYSE
MKC.V	Mccormick & Company Inc	NYSE
MKL	Markel Corp	NYSE
MLI	Mueller Industries	NYSE
MLM	Martin Marietta Materials	NYSE
MLP	Maui Land & Pineapple Company	NYSE
MLR	Miller Industries	NYSE
MMC	Marsh & Mclennan Companies	NYSE
MMD	Mainstay Defined Muni Opp Fund	NYSE
MMI	Marcus & Millichap	NYSE
MMM	3M Company	NYSE
MMP	Magellan Midstream Partners LP	NYSE
MMS	Maximus Inc	NYSE
MMT	MFS Multimarket Income Trust	NYSE
MMU	Western Asset Managed Municipals Fund	NYSE
MN	Manning & Napier Inc	NYSE
MNE	Blackrock Muni New York Intermediate Duration Fu	NYSE
MNK	Mallinckrodt Plc Ordinary Share	NYSE
MNP	Western Asset Muni Partners Fund	NYSE
MNR	Monmouth Real Estate Investment Corp	NYSE
MNR-C	Monmouth Real Estate Investment Group	NYSE
MO	Altria Group	NYSE
MOD	Modine Manufacturing Company	NYSE
MODN	Model N Inc	NYSE
MOG.A	Moog Inc	NYSE
MOG.B	Moog Inc	NYSE
MOH	Molina Healthcare Inc	NYSE
MON	Monsanto Company	NYSE
MOS	Mosaic Company	NYSE
MOS.U	Mosaic Acquisition Corp.	NYSE
MOS.W	Mosaic Acquisition Corp. WT	NYSE
MOSC	Mosaic Acquisition Corp	NYSE
MOV	Movado Group Inc	NYSE
MP-D	Mississippi Pr 5.25	NYSE
MPA	Blackrock Muniyield Pennsylvania Quality Fund	NYSE
MPC	Marathon Petroleum Corp	NYSE
MPLX	Mplx LP	NYSE
MPO	Midstates Petroleum Company Inc	NYSE
MPV	Massmutual Participation Investors	NYSE
MPW	Medical Properties Trust	NYSE
MPX	Marine Products Corp	NYSE
MQT	Blackrock Muniyield Quality Fund II	NYSE
MQY	Blackrock Muniyield Quality Fund	NYSE
MRC	Mrc Global Inc	NYSE
MRIN	Marin Sotfware Incorporated	NYSE
MRK	Merck & Company	NYSE
MRO	Marathon Oil Corp	NYSE
MRT	Medequities Realty Trust Inc	NYSE
MS	Morgan Stanley	NYSE
MS-A	Morgan Stanley Prfd 'A'	NYSE
MS-E	Morgan Stanley	NYSE
MS-F	Morgan Stanley	NYSE
MS-G	Morgan Stanley 6.625%	NYSE
MS-I	Morgan Stanley	NYSE
MS-K	Morgan Stanley Dep Shs Repstg 1/1000Th Sh Non-Cu	NYSE
MSA	Msa Safety Inc	NYSE
MSB	Mesabi Trust	NYSE
MSCA	Main Street Capital Corporatio	NYSE
MSCI	MSCI Inc	NYSE
MSD	Morgan Stanley Emerging Markets Debt	NYSE
MSF	Morgan Stanley Emerging Markets Fund Inc	NYSE
MSG	The Madison Square Garden Comp	NYSE
MSGN	Msg Networks Inc	NYSE
MSI	Motorola Solutions	NYSE
MSL	Midsouth Bancorp	NYSE
MSM	Msc Industrial Direct Company	NYSE
MSP	Madison Strategic Sector Premium Fund	NYSE
MT	Arcelormittal	NYSE
MTB	M&T Bank Corp	NYSE
MTB-C	M&T Bank Corporation Fixed Rate	NYSE
MTB.P	M&T Bank Corporation Fixed Rate	NYSE
MTB.W	M&T Bank Corporation Warrants	NYSE
MTD	Mettler-Toledo International	NYSE
MTDR	Matador Resources Company	NYSE
MTG	Mgic Investment Corp	NYSE
MTH	Meritage Corp	NYSE
MTL	Mechel Oao	NYSE
MTL.P	Mechel Steel Group Oao American	NYSE
MTN	Vail Resorts	NYSE
MTOR	Meritor Inc.	NYSE
MTR	Mesa Royalty Trust	NYSE
MTRN	Materion Corp	NYSE
MTT	Western Asset Muni Defined Opportunity Trust Inc	NYSE
MTU	Mitsubishi Ufj Financial Group Inc	NYSE
MTW	Manitowoc Company	NYSE
MTX	Minerals Technologies Inc	NYSE
MTZ	Mastec Inc	NYSE
MUA	Blackrock Muniassets Fund	NYSE
MUC	Blackrock Muniholdings California Quality Fund	NYSE
MUE	Blackrock Muniholdings Quality Fund II	NYSE
MUH	Blackrock Muniholdings Fund II	NYSE
MUI	Blackrock Muni Intermediate Duration Fund Inc	NYSE
MUJ	Blackrock Muniholdings New Jersey Insured Fund	NYSE
MULE	Mulesoft Inc Class A	NYSE
MUR	Murphy Oil Corp	NYSE
MUS	Blackrock Muniholdings Quality Fund	NYSE
MUSA	Murphy USA Inc	NYSE
MUX	Mcewen Mining Inc	NYSE
MVC	MVC Capital	NYSE
MVCD	MVC Capital Inc 6.25% Senior Notes Due 2022	NYSE
MVO	Mv Oil Trust	NYSE
MVT	Blackrock Munivest Fund II	NYSE
MWA	Mueller Water Products	NYSE
MX	Magnachip Semiconductor Corp	NYSE
MXE	Mexico Equity and	NYSE
MXF	Mexico Fund	NYSE
MXL	Maxlinear Inc	NYSE
MYC	Blackrock Muniyield California Fund	NYSE
MYD	Blackrock Muniyield Fund	NYSE
MYE	Myers Industries	NYSE
MYF	Blackrock Muniyield Investment Fund	NYSE
MYI	Blackrock Muniyield Quality Fund III	NYSE
MYJ	Blackrock Muniyield New Jersey Fund	NYSE
MYN	Blackrock Muniyield New York Quality Fund	NYSE
MYOV	Myovant Sciences Ltd	NYSE
MZF	Managed Duration Investment Grade Fund	NYSE
NAC	Nuveen California Divadv Fund	NYSE
NAD	Nuveen Divadv Fund	NYSE
NAN	Nuveen New York Divadv Fund	NYSE
NAO	Nordic American Offshore Ltd	NYSE
NAP	Navios Maritime Midstream Partn	NYSE
NAT	Nordic American Tanker Shipping Ltd	NYSE
NAV	Navistar International Corp	NYSE
NAV-D	Navistar Intl Pfd D	NYSE
NAZ	Nuveen Arizona Premium Fund	NYSE
NBB	Nuveen Build America Bond Fund	NYSE
NBD	Nuveen Build America Bond Opportunity Fund	NYSE
NBHC	National Bank Holdings Corp	NYSE
NBL	Noble Energy Inc	NYSE
NBLX	Noble Midstream Partners LP	NYSE
NBR	Nabors Industries	NYSE
NC	Nacco Industries	NYSE
NCA	Nuveen California Muni Value Fund	NYSE
NCB	Nuveen California Muni Value Fund 2	NYSE
NCI	Navigant Consulting	NYSE
NCLH	Norwegian Cruise Ord	NYSE
NCR	NCR Corp	NYSE
NCS	NCI Building Systems	NYSE
NCV	Agic Convertible &	NYSE
NCZ	Agic Convertible & II	NYSE
NDP	Tortoise Energy Independence F	NYSE
NDRO	Enduro Royalty Trust	NYSE
NE	Noble Corp	NYSE
NEA	Nuveen Insured Tax-Free Advantage Fund	NYSE
NEE	Nextera Energy	NYSE
NEE-I	Nextera Energy Capital Holding	NYSE
NEE-J	Nextera Energy Capital Holding	NYSE
NEE-K	Nextera Energy Inc Series K J	NYSE
NEE-Q	Nextera Energy Inc Corporate	NYSE
NEE-R	Nextera Energy Inc	NYSE
NEM	Newmont Mining Corp	NYSE
NEP	Nextera Energy Partners LP	NYSE
NETS	Netshoes [Cayman] Ltd	NYSE
NEU	Newmarket Corp	NYSE
NEV	Nuveen Enhanced Muni Value Fund	NYSE
NEWM	New Media Investment Group Inc	NYSE
NEWR	New Relic Inc	NYSE
NEXA	Nexa Resources S.A.	NYSE
NFG	National Fuel Gas Company	NYSE
NFJ	Nfj Dividend Interest & Premium Strategy Fund	NYSE
NFX	Newfield Exploration Company	NYSE
NGG	National Grid Transco Plc	NYSE
NGL	Ngl Energy Partners LP	NYSE
NGL-A	Targa Resources 9.00% Series A Perp	NYSE
NGL-B	Ngl Energy Partners LP	NYSE
NGS	Natural Gas Services Group	NYSE
NGVC	Natural Grocers By Vitamin Cottage Inc	NYSE
NGVT	Ingevity Corp	NYSE
NHA	Nuveen Municipal	NYSE
NHF	Nexpoint Credit Strategies Fund	NYSE
NHI	National Health Investors	NYSE
NI	NiSource Inc	NYSE
NID	Nuveen Intermediate Duration M	NYSE
NIE	Agic Equity & Convertible	NYSE
NIM	Nuveen Maturities Fund	NYSE
NINE	Nine Energy Service Inc	NYSE
NIQ	Nuveen Intermediate Duration Q	NYSE
NJR	Newjersey Resources Corp	NYSE
NJV	Nuveen New Jersey Muni Value Fund	NYSE
NKE	Nike Inc	NYSE
NKG	Nuveen Georgia Divadv Fund 2	NYSE
NKX	Nuveen Insured California Tax-Free	NYSE
NL	NL Industries	NYSE
NLS	Nautilus Group	NYSE
NLSN	Nielsen Holdings Plc	NYSE
NLY	Annaly Capital Management Inc	NYSE
NLY-C	Annaly Capital Management Inc	NYSE
NLY-D	Annaly Capital Management Inc	NYSE
NLY-F	Annaly Capital Management Inc Pfd	NYSE
NLY-G	Annaly Capital Management Inc Pfd	NYSE
NM	Navios Maritime Holdings Inc	NYSE
NM-G	Navios Maritime	NYSE
NM-H	Navios Maritime Holdngs Inc	NYSE
NMFC	New Mountain Finance Corporati	NYSE
NMI	Nuveen Muni	NYSE
NMK-B	Niagara Mohawk Holdings Inc P	NYSE
NMK-C	Niagara Mohawk 3.60	NYSE
NMM	Navios Maritime Partners LP	NYSE
NMR	Nomura Holdings Inc ADR	NYSE
NMS	Nuveen Minnesota Municipal Inco	NYSE
NMT	Nuveen Massachusetts Premium Fund	NYSE
NMY	Nuveen Maryland Premium Fund	NYSE
NMZ	Nuveen Muni High Income Opportunity	NYSE
NNA	Navios Maritime Acquisition Corp	NYSE
NNC	Nuveen North Carolina Premium Fund	NYSE
NNI	Nelnet Inc	NYSE
NNN	National Retail Properties	NYSE
NNN-E	National Retail Properties Depo	NYSE
NNN-F	National Retail Properties Inc	NYSE
NNY	Nuveen New York Muni Value Fund	NYSE
NOA	North American Energy Partners	NYSE
NOAH	Noah Holdings Ltd	NYSE
NOC	Northrop Grumman Corp	NYSE
NOK	Nokia Corp	NYSE
NOM	Nuveen Missouri Premium Fund	NYSE
NOMD	Nomad Foods Limited Ordinary Sh	NYSE
NOV	National-Oilwell	NYSE
NOW	Servicenow Inc	NYSE
NP	Neenah Paper	NYSE
NPK	National Presto Industries	NYSE
NPN	Nuveen Pennsylvania Muni Value Fund	NYSE
NPO	Enpro Industries	NYSE
NPTN	Neophotonics Corp	NYSE
NPV	Nuveen Virginia Premium Fund	NYSE
NQ	Netqin Mobile Inc	NYSE
NQP	Nuveen Pennsylvania Investment	NYSE
NR	Newpark Resources	NYSE
NRE	Northstar Realty Europe Corp C	NYSE
NRG	NRG Energy	NYSE
NRK	Nuveen Insured New York Tax-Free	NYSE
NRP	Natural Resource Partners LP	NYSE
NRT	North European Oil Royality Trust	NYSE
NRZ	New Residential Investment Corp	NYSE
NS	Nustar Energy LP	NYSE
NS-A	Nustar Energy LP Pref Share	NYSE
NS-B	Nustar Energy LP Cum Red Perp Pfd Ser B Fixed To	NYSE
NS-C	Nustar Energy LP Cum Red Perp Pfd Ser C	NYSE
NSA	National Storage Affiliates Tru	NYSE
NSA-A	National Storage Affiliates Trust Pfd Cum Red BE	NYSE
NSC	Norfolk Southern Corp	NYSE
NSH	Nustar Gp Holdings Llc	NYSE
NSL	Nuveen Senior	NYSE
NSM	Nationstar Mortgage Holdngs I	NYSE
NSP	Insperity Inc	NYSE
NSS	Nustar Logistics LP	NYSE
NTB	Bank of Butterfield Ltd	NYSE
NTC	Nuveen Connecticut Premium Fund	NYSE
NTG	Tortoise MLP Fund	NYSE
NTP	Nam Tai Electronics	NYSE
NTR	Nutrien Ltd	NYSE
NTX	Nuveen Texas Quality	NYSE
NTZ	Natuzzi S.P.A.	NYSE
NUE	Nucor Corp	NYSE
NUM	Nuveen Michigan Quality	NYSE
NUO	Nuveen Ohio Quality	NYSE
NUS	Nu Skin Enterprises	NYSE
NUV	Nuveen Muni Value Fund	NYSE
NUW	Nuveen Muni Value Fund	NYSE
NVG	Nuveen Insured Divadv Fund	NYSE
NVGS	Navigator Holdings	NYSE
NVO	Novo Nordisk A/S	NYSE
NVR	NVR Inc	NYSE
NVRO	Nevro Corp	NYSE
NVS	Novartis Ag	NYSE
NVTA	Invitae Corp	NYSE
NWE	Northwestern Corp	NYSE
NWHM	New Home Co Llc	NYSE
NWL	Newell Rubbermaid Inc	NYSE
NWN	Northwest Natural Gas Company	NYSE
NWY	New York & Company	NYSE
NX	Quanex Building Products Corp	NYSE
NXC	Nuveen California Tax-Free Income	NYSE
NXJ	Nuveen New Jersey Divadv Fund	NYSE
NXN	Nuveen Insured New York Tax-Free	NYSE
NXP	Nuveen Tax Free Income Portfolio	NYSE
NXQ	Nuveen Tax Free Income Portfolio II	NYSE
NXR	Nuveen Tax Free Income Portfolio III	NYSE
NXRT	Nexpoint Residential Trust Inc	NYSE
NYC-A	New York Community Bancorp Inc	NYSE
NYC-U	New York Community Bancorp Inc	NYSE
NYCB	New York Community Bancorp	NYSE
NYL.A	NRG Yield Inc Class A	NYSE
NYLD	NRG Yield Inc	NYSE
NYRT	New York REIT Inc	NYSE
NYT	New York Times Company	NYSE
NYV	Nuveen New York Muni Value Fund 2	NYSE
NZF	Nuveen Divadv Fund 3	NYSE
O	Realty Income Corp	NYSE
OA	Orbital Atk Inc	NYSE
OAK	Oaktree Capital Group Llc	NYSE
OAK-A	Five Oaks Investment Corp 8.75	NYSE
OAKS	Five Oaks Investment Corp	NYSE
OAS	Oasis Petroleum Inc	NYSE
OBE	Obsidian Energy Ltd	NYSE
OC	Owens Corning Inc	NYSE
OCIP	Oci Partners LP	NYSE
OCN	Ocwen Financial Corp	NYSE
ODC	Oil-Dri Corporation of America	NYSE
OEC	Orion Engineered Carbons S.A R	NYSE
OFC	Corporate Office Properties	NYSE
OFG	Oriental Financial Group	NYSE
OFG-A	Oriental Fin Mips A	NYSE
OFG-B	Oriental Finl Pfd B	NYSE
OFG-D	Oriental Financial Group Inc	NYSE
OGE	Oge Energy Corp	NYSE
OGS	One Gas Inc	NYSE
OHI	Omega Healthcare Investors	NYSE
OI	Owens-Illinois	NYSE
OIA	Invesco Muni Income Trust	NYSE
OIB.C	Oi S.A.	NYSE
OII	Oceaneering International	NYSE
OIS	Oil States International	NYSE
OKE	Oneok Inc	NYSE
OLN	Olin Corp	NYSE
OLP	One Liberty Properties	NYSE
OMA.U	One Madison Group	NYSE
OMAA	Om Asset Management Plc	NYSE
OMAD	One Madison Corporation Class A	NYSE
OMAM	Om Asset Management Ltd	NYSE
OMC	Omnicom Group Inc	NYSE
OMF	Onemain Holdings Inc	NYSE
OMI	Owens & Minor	NYSE
OMN	Omnova Solutions Inc	NYSE
OMP	Oasis Midstream Partners LP	NYSE
ONDK	On Deck Capital Inc	NYSE
OOMA	Ooma Inc	NYSE
OPP	Rivernorth/Doubleline Strategic Opportunity Fund	NYSE
OPY	Oppenheimer Holdings	NYSE
OR	Osisko Gold Royalties Ltd	NYSE
ORA	Ormat Technologies	NYSE
ORAN	Orange ADR	NYSE
ORC	Orchid Island Capital Inc	NYSE
ORCL	Oracle Corp	NYSE
ORI	Old Republic International Corp	NYSE
ORN	Orion Group Holdings Inc	NYSE
OSB	Norbord Inc	NYSE
OSG	Overseas Shipholding Group Inc	NYSE
OSK	Oshkosh Truck Corp	NYSE
OSLE	Oaktree Specialty Lending Corp	NYSE
OUT	Outfront Media Inc	NYSE
OXM	Oxford Industries	NYSE
OXY	Occidental Petroleum Corp	NYSE
OZM	Och-Ziff Capital Management	NYSE
P	Pandora Media Inc	NYSE
PAA	Plains All American Pipeline LP	NYSE
PAC	Grupo Aeroportuario Del Pacifico	NYSE
PAG	Penske Automotive Group	NYSE
PAGP	Plains Gp Holdings LP	NYSE
PAGS	Pagseguro Digital Ltd. Class A	NYSE
PAH	Platform Specialty Products Corp	NYSE
PAI	Pacific American Income Shares	NYSE
PAM	Pampa Energia S.A.	NYSE
PANW	Palo Alto Networks Inc	NYSE
PAR	Par Technology Corp	NYSE
PARR	Par Petroleum Corp	NYSE
PAY	Verifone Systems	NYSE
PAYC	Paycom Software Inc	NYSE
PB	Prosperity Bancshares	NYSE
PBA	Pembina Pipeline Cor	NYSE
PBB	Prospect Capital Corp	NYSE
PBF	PBF Energy Inc	NYSE
PBFX	PBF Logistics LP	NYSE
PBH	Prestige Brand Holdings	NYSE
PBI	Pitney Bowes Inc	NYSE
PBI-B	Pitney Bowes Inc .6.70% Notes	NYSE
PBR	Petroleo Brasileiro S.A. Petrobras	NYSE
PBR.A	Petroleo Brasileiro S.A. Petrobras	NYSE
PBT	Permian Basin Royalty Trust	NYSE
PCF	Putnam High Income Bond Fund	NYSE
PCG	Pacific Gas & Electric Co	NYSE
PCI	Pimco Dynamic Credit Income Fun	NYSE
PCK	Pimco California Muni II	NYSE
PCM	Pimco Commercial Mortgage Securities	NYSE
PCN	Pimco Corporate	NYSE
PCQ	Pimco California Muni	NYSE
PDI	Pimco Dynamic Income Fund	NYSE
PDM	Piedmont Office Realty Trust	NYSE
PDS	Precision Drilling Corp	NYSE
PDT	John Hancock Premium Dividend Fund	NYSE
PE	Parsley Energy	NYSE
PEB	Pebblebrook Hotel Trust	NYSE
PEB-C	Pebblebrook Hotel Trust	NYSE
PEB-D	Pebblebrook Hotel Trust	NYSE
PEG	Public Service Enterprise Group Inc	NYSE
PEI	Pennsylvania Real Estate Investment	NYSE
PEI-B	Pennsylvania Real Estate Inves	NYSE
PEI-C	Pennsylvania Real Estate Investment Trust Red Pe	NYSE
PEI-D	Pennsylvania Real Estate Investment Trust Pfd	NYSE
PEN	Penumbra Inc	NYSE
PEO	Adams Natural Resources Fund Inc.	NYSE
PER	Sandridge Permian Trust	NYSE
PES	Pioneer Energy Services Corp	NYSE
PF	Pinnacle Foods Inc	NYSE
PFD	Flaherty & Crumrine Preferred Inc	NYSE
PFE	Pfizer Inc	NYSE
PFGC	Performance Food Group Co	NYSE
PFH	Cabco TR Jcp 7.625	NYSE
PFK	Prudential Financial Inflation-Linked	NYSE
PFL	Pimco Income Strategy Fund	NYSE
PFN	Pimco Income Strategy Fund II	NYSE
PFO	Flaherty & Crumrine Preferred Fund	NYSE
PFS	Provident Financial Services	NYSE
PFSI	Pennymac Financial Services In	NYSE
PG	Procter & Gamble Company	NYSE
PGEM	Ply Gem Holdings Inc	NYSE
PGH	Pengrowth Energy Corp	NYSE
PGP	Pimco Global Stocksplus & Income	NYSE
PGR	Progressive Corp	NYSE
PGRE	Paramount Group Inc	NYSE
PGTI	Pgt Inc	NYSE
PGZ	Principal Real Estate Income F	NYSE
PH	Parker-Hannifin Corp	NYSE
PHD	Pioneer Floating Rate Trust	NYSE
PHG	Koninklijke Philips Electronics	NYSE
PHH	Phh Corp	NYSE
PHI	Philippine Long Distance Telephone	NYSE
PHK	Pimco High	NYSE
PHM	Pultegroup	NYSE
PHT	Pioneer High Income Trust	NYSE
PHX	Panhandle Royalty Company	NYSE
PII	Polaris Industries Inc	NYSE
PIM	Putnam Master Intermediate Income	NYSE
PIR	Pier 1 Imports	NYSE
PIY	Merrill Lynch Depositor	NYSE
PJC	Piper Jaffray Companies	NYSE
PJH	Prudential Financial Inc	NYSE
PJT	Pjt Partners Inc Class A	NYSE
PK	Park Hotels & Resorts Inc	NYSE
PKD	Parker Drilling Company	NYSE
PKE	Park Electrochemical Corp	NYSE
PKG	Packaging Corporation of America	NYSE
PKI	Perkinelmer	NYSE
PKO	Pimco Income Opportunity Fund	NYSE
PKX	Posco ADR	NYSE
PLD	Prologis Inc	NYSE
PLNT	Planet Fitness	NYSE
PLOW	Douglas Dynamics	NYSE
PLT	Plantronics	NYSE
PM	Philip Morris International Inc	NYSE
PMF	Pimco Muni	NYSE
PML	Pimco Muni II	NYSE
PMM	Putnam Managed Muni Income Trust	NYSE
PMO	Putnam Muni Opportunities Trust	NYSE
PMT	Pennymac Mortgage Investment Trust	NYSE
PMT-A	Pennymac Mortgage Investment Trust	NYSE
PMT-B	Pennymac Mortgage Investment Trust Pfd	NYSE
PMX	Pimco Muni Income Fund III	NYSE
PNC	PNC Bank	NYSE
PNC-P	PNC Financial Services Group I	NYSE
PNC-Q	The PNC Financial Services Gro	NYSE
PNC.W	The PNC Financial Services Group	NYSE
PNF	Pimco New York Muni	NYSE
PNI	Pimco New York Muni II	NYSE
PNM	PNM Resources Inc	NYSE
PNR	Pentair Ltd	NYSE
PNW	Pinnacle West Capital Corp	NYSE
POL	Polyone Corp	NYSE
POR	Portland General Electric Company	NYSE
POST	Post Holdings Inc	NYSE
PPDF	Ppdai Group Inc	NYSE
PPG	PPG Industries	NYSE
PPL	PPL Corp	NYSE
PPR	VOYA Prime Rate Trust	NYSE
PPT	Putnam Premier Income Trust	NYSE
PPX	PPL Capital Funding Inc	NYSE
PQ	Petroquest Energy Inc	NYSE
PQG	Pq Group Holdings Inc	NYSE
PRA	Pro-Assurance Corp	NYSE
PRE-F	Partnerre Ltd	NYSE
PRE-G	Partnerre Ltd 6.50% Series G C	NYSE
PRE-H	Partnerre Ltd 7.25% Series H C	NYSE
PRE-I	Partnerre Ltd 5.875% Series I	NYSE
PRGO	Perrigo Company	NYSE
PRH	Prudential Financial Inc	NYSE
PRI	Primerica Inc	NYSE
PRLB	Proto Labs Inc	NYSE
PRO	Pros Holdings	NYSE
PRTY	Party City Holdco Inc	NYSE
PRU	Prudential Financial Inflation Retail	NYSE
PSA	Public Storage	NYSE
PSA-A	Public Storage 5.875%	NYSE
PSA-B	Public Storage	NYSE
PSA-C	Public Storage	NYSE
PSA-D	Public Storage	NYSE
PSA-E	Public Storage Prf	NYSE
PSA-F	Public Storage Depositary 5.15% Series F Pfd	NYSE
PSA-G	Public Storage Dep Shs Repstg 1/1000Th Cum Pfd B	NYSE
PSA-U	Public Storage	NYSE
PSA-V	Public Storage	NYSE
PSA-W	Public Storage	NYSE
PSA-X	Public Storage	NYSE
PSA-Y	Public Storagedepositary Share	NYSE
PSA-Z	Public Storage	NYSE
PSB	Business Parks	NYSE
PSB-U	PS Business Parks Inc	NYSE
PSB-V	PS Business Pks Inc Calif Dep	NYSE
PSB-W	PS Business Parks Inc	NYSE
PSB-X	PS Business Parks Inc Pfd	NYSE
PSB-Y	PS Business Parks Inc Dep Shs Repstg 1/1000Th Pf	NYSE
PSF	Cohen & Steers Preferred Fund	NYSE
PSO	Pearson Plc	NYSE
PSTG	Pure Storage Inc	NYSE
PSX	Phillips 66	NYSE
PSXP	Phillips 66 Partners LP	NYSE
PTR	Petrochina Company Ltd	NYSE
PTY	Pimco Corporate Opportunity Fund	NYSE
PUK	Prudential Public Limited Company	NYSE
PUK-A	Pru Plc Perp Sub Cap	NYSE
PUK.P	Prudential 6.75%	NYSE
PUMP	Propetro Holding Corp	NYSE
PVG	Pretium Res Inc	NYSE
PVH	Phillips-Van Heusen Corp	NYSE
PWR	Quanta Services	NYSE
PX	Praxair	NYSE
PXD	Pioneer Natural Resources Co	NYSE
PYN	Pimco New York Muni Income Fund III	NYSE
PYS	Pplus Trust	NYSE
PYT	Pplus Trust	NYSE
PZC	Pimco California Muni Income Fund III	NYSE
PZE	Petrobras Argentina S.A.	NYSE
PZN	Pzena Investment Management Inc	NYSE
QCP	Quality Care Properties Inc	NYSE
QD	Qudian Inc ADR	NYSE
QEP	Qep Resources	NYSE
QES	Quintana Energy Services Inc.	NYSE
QGEN	Qiagen N.V.	NYSE
QHC	Quorum Health Corp	NYSE
QSR	Restaurant Brands International	NYSE
QTM	Quantum Corp	NYSE
QTS	Qts Realty Trust Inc	NYSE
QTS-A	Qts Realty Trust Inc. Pfd A	NYSE
QTWO	Q2 Holdings Inc	NYSE
QUAD	Quad Graphics Inc	NYSE
QUOT	Quotient Technology Inc	NYSE
R	Ryder System	NYSE
RA	Brookfield Real Assets Income Fund Inc	NYSE
RACE	Ferrari N.V.	NYSE
RAD	Rite Aid Corp	NYSE
RAS	Rait Financial Trust	NYSE
RAS-A	Rait Financial TR Pf	NYSE
RAS-B	Rait Financial TR Pf	NYSE
RAS-C	Rait Fin TR Pfd C	NYSE
RBA	Ritchie Bros. Auctioneers Inc	NYSE
RBC	Regal-Beloit Corp	NYSE
RBS	Royal Bank Scotland Group Plc	NYSE
RBS-S	Royal Bank Scotland	NYSE
RCI	Rogers Communication	NYSE
RCL	Royal Caribbean Cruises Ltd	NYSE
RCS	Rcm Strategic Global Government Fund	NYSE
RCUS	Arcus Biosciences Inc.	NYSE
RDC	Rowan Companies	NYSE
RDN	Radian Group Inc	NYSE
RDS.A	Royal Dutch Shell Plc	NYSE
RDS.B	Royal Dutch Shell	NYSE
RDY	Dr. Reddy's Laboratories Ltd	NYSE
RE	Everest Re Group	NYSE
REG	Regency Centers Corp	NYSE
RELX	Relx Plc	NYSE
REN	Resolute Energy Corp	NYSE
RENN	Renren Inc	NYSE
RENX	Relx N.V.	NYSE
RES	RPC Inc	NYSE
RESI	Altisource Residential Corporat	NYSE
REV	Revlon Inc	NYSE
REVG	Rev Group Inc	NYSE
REX	Rex American Resources Corp	NYSE
REX-A	Rexford Industrial Realty Inc	NYSE
REX-B	Rexford Industrial Realty Inc Pfd B	NYSE
REXR	Rexford Industrial Realty Inc	NYSE
RF	Regions Financial Corp	NYSE
RF-A	Regions Financial Corp	NYSE
RF-B	Regions Financial Corp	NYSE
RFI	Cohen & Steers Total Return Realty Fund	NYSE
RFP	Resolute Forest Products Inc	NYSE
RFT	Rait Financial Trust	NYSE
RFTA	Rait Financial Trust	NYSE
RGA	Reinsurance Group of America Inc	NYSE
RGC	Regal Entertainment Group	NYSE
RGR	Sturm Ruger & Company	NYSE
RGS	Regis Corp	NYSE
RGT	Royce Global Value Trust Inc	NYSE
RH	Restoration Hardware Holdings	NYSE
RHI	Robert Half International Inc	NYSE
RHP	Gaylord Entertainment Company	NYSE
RHT	Red Hat Inc	NYSE
RIG	Transocean Inc	NYSE
RIO	Rio Tinto Plc	NYSE
RIV	Rivernorth Opportunities Fund	NYSE
RJF	Raymond James Financial	NYSE
RL	Ralph Lauren Corp	NYSE
RLGY	Realogy Holdings Corp	NYSE
RLH	Red Lion Hotels Corp	NYSE
RLI	Rli Corp	NYSE
RLJ	Rlj Lodging Trust	NYSE
RLJ-A	Rlj Lodging Trust $1.95 Series A	NYSE
RM	Regional Managment Corp	NYSE
RMAX	Re/Max Holdings Inc	NYSE
RMD	Resmed Inc	NYSE
RMP	Rice Midstream Partners LP	NYSE
RMP.P	Rivernorth Marketplace Lending Corp Term Pfd Ser	NYSE
RMT	Royce Micro-Cap Trust	NYSE
RNG	Ringcentral Inc	NYSE
RNGR	Ranger Energy Services Inc Class A	NYSE
RNP	Cohen & Steers REIT and Preferred	NYSE
RNR	Renaissancere Holdings Ltd	NYSE
RNR-C	Renaissancere 6.08 C	NYSE
RNR-E	Renaissancere Holdings Ltd	NYSE
ROG	Rogers Corp	NYSE
ROK	Rockwell Automation Inc	NYSE
ROL	Rollins Inc	NYSE
ROP	Roper Industries	NYSE
ROYT	Pacific Coast Oil Trust	NYSE
RPAI	Retail Properties of America	NYSE
RPM	RPM International Inc	NYSE
RPT	Ramco-Gershenson Properties Trust	NYSE
RPT-D	Ramco-Gershenson Properties Tru	NYSE
RQI	Cohen & Steers Quality Income Realty Fund Inc	NYSE
RRC	Range Resources Corp	NYSE
RRD	Donnelley [R.R.] & Sons Co	NYSE
RRTS	Roadrunner Transportation Systems Inc	NYSE
RS	Reliance Steel & Aluminum Company	NYSE
RSG	Republic Services	NYSE
RSO	Resource Capital	NYSE
RSO-C	Resource Capital Corp Preferre	NYSE
RSPP	Rsp Permian Inc	NYSE
RST	Rosetta Stone	NYSE
RTEC	Rudolph Technologies	NYSE
RTN	Raytheon Company	NYSE
RUBI	The Rubicon Project Inc	NYSE
RVT	Royce Value Trust	NYSE
RWG.U	Regalwood Global Energy	NYSE
RWG.W	Regalwood Global Energy Ws	NYSE
RWGE	Regalwood Global Energy Ltd. Class A Ordinary Sh	NYSE
RWT	Redwood Trust	NYSE
RXN	Rexnord Corp	NYSE
RXN-A	Rexnord Corp	NYSE
RY	Royal Bank of Canada	NYSE
RY-T	Royal Bank of Canada	NYSE
RYA-A	Rayonier Advanced Materials Inc Pfd. Series A	NYSE
RYAM	Rayonier Advanced Materials Inc	NYSE
RYB	Ryb Education Inc Aps	NYSE
RYI	Ryerson Holding Corp	NYSE
RYN	Rayonier Inc REIT	NYSE
RZA	Reinsurance Group of America I	NYSE
RZB	Reinsurance Group of America I	NYSE
S	Sprint Corp	NYSE
SA	Seabridge Gold	NYSE
SAB	Saratoga Investment Corp 6.75% Notes Due 2023	NYSE
SAFE	Safety Income and Growth Inc	NYSE
SAH	Sonic Automotive	NYSE
SAIC	Science Applications Internatio	NYSE
SAIL	Sailpoint Technologies Holdings Inc	NYSE
SALT	Scorpio Bulkers Inc	NYSE
SAM	Boston Beer Company	NYSE
SAN	Banco Santander	NYSE
SAN-A	Banco Santander S.A. 6.80% Non	NYSE
SAN-B	Santander Finance Preferred S.A.	NYSE
SAN-C	Banco Santander S.A. 6.50% Non	NYSE
SAN-I	Banco Santander Central Hispano	NYSE
SAP	SAP Ag	NYSE
SAR	Saratoga Investment Corp	NYSE
SAVE	Spirit Airlines Inc	NYSE
SB	Safe Bulkers Inc	NYSE
SB-C	Safe Bulkers Inc	NYSE
SB-D	Safe Bulkers Inc	NYSE
SBBC	Scorpio Tankers Inc 8.25% Senior Notes Due 2019	NYSE
SBGL	Sibanye Gold Limited American D	NYSE
SBH	Sally Beauty Holdings	NYSE
SBI	Western Asset Intermediate Fund Inc	NYSE
SBNA	Scorpio Tankers Inc	NYSE
SBOW	Silverbow Resources Inc	NYSE
SBR	Sabine Royalty Trust	NYSE
SBS	Cia De Saneamento Basico Do Estado	NYSE
SC	Santander Consumer USA Holdings	NYSE
SCA	Stellus Capital Investment 5.75% Notes Due 2022	NYSE
SCCO	Southern Peru Copper Corp	NYSE
SCD	Lmp Capital and Income Fund Inc	NYSE
SCE-G	Sce Trust II	NYSE
SCE-H	Sce Trust III 5.75%	NYSE
SCE-J	Sce Trust IV	NYSE
SCE-K	Scr TR V Fxd/Fltg Rate	NYSE
SCE-L	Sce Trust Vi TR Pref Secs	NYSE
SCG	Scana Corp	NYSE
SCH-C	Charles Schwab Corp Pref Share	NYSE
SCH-D	Charles Schwab Corp Dep Pfd.	NYSE
SCHW	The Charles Schwab Corp	NYSE
SCI	Service Corporation International	NYSE
SCL	Stepan Company	NYSE
SCM	Stellus Capital Investment Cor	NYSE
SCS	Steelcase Inc	NYSE
SCX	L.S. Starrett Company	NYSE
SD	Sandridge Energy Inc	NYSE
SDLP	Seadrill Partners Llc	NYSE
SDR	Sandridge Mississippian Trust	NYSE
SDRL	Seadrill Ltd	NYSE
SDT	Sandridge Mississippian Trust I	NYSE
SE	Sea Limited ADR	NYSE
SEAS	Seaworld Entertainment Inc Co	NYSE
SEE	Sealed Air Corp	NYSE
SEM	Select Medical Holdings Corp	NYSE
SEMG	Semgroup Corp	NYSE
SEND	Sendgrid Inc	NYSE
SEP	Spectra Energy Partners LP	NYSE
SERV	Servicemaster Global Holdings I	NYSE
SF	Stifel Financial Corp	NYSE
SF-A	Stifel Financial Corp	NYSE
SFB	Stifel Financial Corporation 5.20% Senior Notes	NYSE
SFE	Safeguard Scientifics	NYSE
SFL	Ship Finance International	NYSE
SFS	Smart	NYSE
SFUN	Soufun Holdings	NYSE
SGF	Singapore Fund	NYSE
SGU	Star Gas Partners LP	NYSE
SGY	Stone Energy Corp	NYSE
SGZA	Selective Insurance Group Inc	NYSE
SHAK	Shake Shack Inc	NYSE
SHG	Shinhan Financial Group Co Ltd	NYSE
SHI	Sinopec Shangai Petrochemical Company Ltd	NYSE
SHLX	Shell Midstream Partners LP	NYSE
SHO	Sunstone Hotel Investors	NYSE
SHO-E	Sunstone Hotel Investors Inc	NYSE
SHO-F	Sunstone Hotel Investors Inc	NYSE
SHOP	Shopify Inc	NYSE
SHW	Sherwin-Williams Company	NYSE
SID	Companhia Siderurgica Nacional	NYSE
SIG	Signet Jewelers Ltd	NYSE
SITE	Siteone Landscape Supply	NYSE
SIX	Six Flags Entertainment Corp	NYSE
SJI	South Jersey Industries	NYSE
SJM	J.M. Smucker Company	NYSE
SJR	Shaw Communications Inc	NYSE
SJT	San Juan Basin Royalty Trust	NYSE
SJW	SJW Corp	NYSE
SKM	Sk Telecom Corp	NYSE
SKT	Tanger Factory Outlet Centers	NYSE
SKX	Skechers U.S.A.	NYSE
SLB	Schlumberger N.V.	NYSE
SLCA	U.S. Silica Holdings Inc	NYSE
SLD	Sutherland Asset Management Corp MD	NYSE
SLDA	Sutherland Asset Management Corporation 7.00% Co	NYSE
SLF	Sun Life Financial Inc	NYSE
SLG	SL Green Realty Corp	NYSE
SLG-I	SL Green Realty Corp	NYSE
SLTB	Scorpio Bulkers Inc 7.50% Seni	NYSE
SM	Sm Energy Company	NYSE
SMFG	Sumitomo Mitsui Financial Group Inc	NYSE
SMG	Scotts Miracle-Gro Company	NYSE
SMHI	Seacor Marine Holdings Inc	NYSE
SMI	Semiconductor Manufacturing International	NYSE
SMLP	Summit Midstream Partners LP	NYSE
SMM	Salient Midstream & MLP Fund	NYSE
SMP	Standard Motor Products	NYSE
SN	Sanchez Energy Corp	NYSE
SNA	Snap-On Inc	NYSE
SNAP	Snap Inc	NYSE
SNDR	Schneider National Inc	NYSE
SNE	Sony Corp	NYSE
SNN	Smith & Nephew Snats	NYSE
SNP	China Petroleum & Chemical Corp	NYSE
SNR	New Senior Investment Group Inc	NYSE
SNV	Synovus Financial Corp	NYSE
SNV-C	Synovus Financial Corp Fixed-	NYSE
SNX	Synnex Corp	NYSE
SNY	Sanofi-Aventis S.A.	NYSE
SO	Southern Company	NYSE
SOGO	Sogou Inc	NYSE
SOI	Solaris Oilfield Infrastructure Inc Class A	NYSE
SOJA	The Southern Co. Series	NYSE
SOJB	Southern Co	NYSE
SOJC	Southern Company Series 2017B 5.25% Junior Subor	NYSE
SOL	Renesola Ltd	NYSE
SON	Sonoco Products Company	NYSE
SOR	Source Capital	NYSE
SOV-C	Sovereign Banc Dep S	NYSE
SPA	Sparton Corp	NYSE
SPB	Spectrum Brands Holdings	NYSE
SPE	Special Opportunities Fund Inc	NYSE
SPE-B	Special Opportunities 3.5% Conv. Pfd. Series B	NYSE
SPG	Simon Property Group	NYSE
SPG-J	Simon Prop Grp Pfd J	NYSE
SPGI	S&P Global Inc	NYSE
SPH	Suburban Propane Partners LP	NYSE
SPL-A	Steel Partners Holdings LP 6.0% Series A	NYSE
SPLP	Steel Partners Hldgs	NYSE
SPN	Superior Energy Services	NYSE
SPR	Spirit Aerosystems Holdings	NYSE
SPXC	SPX Corp	NYSE
SPXX	Nuveen Equity Premium and Growth Fund	NYSE
SQ	Square	NYSE
SQM	Sociedad Quimica Y Minera S.A.	NYSE
SQNS	Sequans Communications S A	NYSE
SR	Spire Inc	NYSE
SRC	Spirit Realty Capital Inc	NYSE
SRC-A	Spirit Realty Capital Inc Pfd Ser A	NYSE
SRE	Sempra Energy	NYSE
SRE-A	Sempra Energy Pfd Conv Ser A	NYSE
SRF	The Cushing Royalty & Income Fund	NYSE
SRG	Seritage Growth Properties Cla	NYSE
SRG-A	Seritage Growth Properties 7.00% Cum Red Pfd Ser	NYSE
SRI	Stoneridge Inc	NYSE
SRLP	Sprague Resources LP	NYSE
SRT	Startek Inc	NYSE
SRV	The Cushing MLP Total Return Fund	NYSE
SSD	Simpson Manufacturing Company	NYSE
SSI	Stage Stores	NYSE
SSL	Sasol Ltd	NYSE
SSP	E.W. Scripps Company	NYSE
SSTK	Shutterstock Inc	NYSE
SSW	Seaspan Corp	NYSE
SSW-D	Seaspan Corp	NYSE
SSW-E	Seaspan Corp	NYSE
SSW-G	Seaspan Corp	NYSE
SSW-H	Seaspan Corp	NYSE
SSWA	Seaspan Corporation 7.125% Notes Due 2027	NYSE
SSWN	Seaspan Corp	NYSE
ST	Sensata Technologies Holding N.V.	NYSE
STA-B	Stag Industrial Inc Cum Pfd S	NYSE
STA-C	Stag Industrial Inc Prf C	NYSE
STA-D	Istar Financial Inc Preferred	NYSE
STA-G	Istar Financial Inc Preferred	NYSE
STA-I	Istar Financial Inc Preferred	NYSE
STAG	STI Inc	NYSE
STAR	Istar Financial Inc	NYSE
STAY	Extended Stay America Inc	NYSE
STC	Stewart Information Services Corp	NYSE
STE	Steris Corp	NYSE
STI	Suntrust Banks	NYSE
STI-A	Suntrust Bks Dep Sh	NYSE
STI-E	Suntrust Banks Inc Series E	NYSE
STI.A	Suntrust Banks Inc Class A	NYSE
STI.B	Suntrust Banks Inc Class B	NYSE
STK	Columbia Seligman Premium Technology	NYSE
STL	Sterling Bancorp	NYSE
STL-A	Sterling Bancorp Series A	NYSE
STM	Stmicroelectronics N.V.	NYSE
STN	Stantec Inc	NYSE
STNG	Scorpio Tankers Inc	NYSE
STO	Statoil ASA	NYSE
STON	Stonemor Partners LP	NYSE
STOR	Store Capital Corpstore Capital	NYSE
STT	State Street Corp	NYSE
STT-C	State Street Corporation Dep Sh	NYSE
STT-D	State Street Corporation Serie	NYSE
STT-E	State Street Corporation Depos	NYSE
STT-G	State Street Corp	NYSE
STWD	Starwood Property Trust	NYSE
STZ	Constellation Brands Inc	NYSE
STZ.B	Constellation Brd B	NYSE
SU	Suncor Energy Inc	NYSE
SUI	Sun Communities	NYSE
SUM	Summit Materials Inc	NYSE
SUN	Sunoco LP	NYSE
SUP	Superior Industries International	NYSE
SUPV	Grupo Supervielle S.A.	NYSE
SVU	Supervalu Inc	NYSE
SWCH	Switch Inc	NYSE
SWJ	Stanley Black & Decker Inc	NYSE
SWK	Stanley Black & Decker Inc	NYSE
SWM	Schweitzer-Mauduit International	NYSE
SWN	Southwestern Energy Company	NYSE
SWP	Stanley Black & Decker Inc	NYSE
SWX	Southwest Gas Corp	NYSE
SWZ	Swiss Helvetia Fund	NYSE
SXC	Suncoke Energy Inc	NYSE
SXCP	Suncoke Energy Partners LP	NYSE
SXE	Southcross Energy Partners L	NYSE
SXI	Standex International Corp	NYSE
SXT	Sensient Technologies Corp	NYSE
SYF	Synchrony Financial	NYSE
SYK	Stryker Corp	NYSE
SYX	Systemax Inc	NYSE
SYY	Sysco Corp	NYSE
SZC	The Cushing Renaissance Fund	NYSE
T	AT&T Inc	NYSE
TAC	Transalta Corp	NYSE
TAHO	Tahoe Res Inc	NYSE
TAL	Tal Education Group	NYSE
TAP	Molson Coors Brewing Company	NYSE
TAP.A	Molson Coors Brewing Company	NYSE
TARO	Taro Pharm Inds	NYSE
TBB	AT&T Inc 5.350% Global Notes Due 2066	NYSE
TBI	Trueblue Inc	NYSE
TCAP	Triangle Capital Corp	NYSE
TCCA	Triangle Capital Corp	NYSE
TCCB	Triangle Capital Corp	NYSE
TCF	TCF Financial Corp	NYSE
TCF-C	TCF Financial Corp	NYSE
TCF-D	TCF Financial Corp	NYSE
TCF.W	TCF Financial Corp	NYSE
TCI	Transcontinental Realty Investors	NYSE
TCO	Taubman Centers	NYSE
TCO-J	Taubman Centers Inc Preferred	NYSE
TCO-K	Taubman Centers Inc	NYSE
TCP	TCP Pipelines	NYSE
TCRX	THL Credit Inc	NYSE
TCRZ	THL Credit Inc	NYSE
TCS	The Container Store Group Inc	NYSE
TD	Toronto Dominion Bank	NYSE
TDA	Telephone and Data Systems Inc	NYSE
TDC	Teradata Corp	NYSE
TDE	Telephone and Data Systems	NYSE
TDF	Templeton Dragon Fund	NYSE
TDG	Transdigm Group Inc	NYSE
TDI	Telephone and Data Systems	NYSE
TDJ	Telephone and Data Systems Inc	NYSE
TDOC	Teladoc Inc	NYSE
TDS	Telephone and Data Systems	NYSE
TDW	Tidewater Inc	NYSE
TDW.A	Tidewater Inc Series A Warrants	NYSE
TDW.B	Tidewater Inc Series B Warrants	NYSE
TDY	Teledyne Technologies Inc	NYSE
TECK	Teck Resources Ltd	NYSE
TEF	Telefonica S.A.	NYSE
TEGP	Tallgrass Energy Gp LP	NYSE
TEI	Templeton Emerging Markets	NYSE
TEL	Te Connectivity Ltd	NYSE
TEN	Tenneco Automotive	NYSE
TEO	Telecom Argentina Stet - France Telecom S.A.	NYSE
TEP	Tallgrass Energy Partners LP	NYSE
TER	Teradyne Inc	NYSE
TEVA	Teva Pharmaceutical Industries Ltd	NYSE
TEX	Terex Corp	NYSE
TFX	Teleflex Inc	NYSE
TG	Tredegar Corp	NYSE
TGH	Textainer Group Holdings	NYSE
TGI	Triumph Group	NYSE
TGNA	Tegna Inc	NYSE
TGP	Teekay Lng Partners LP	NYSE
TGP-A	Teekay Lng Partners LP Pref Share	NYSE
TGP-B	Teekay Lng Partners LP Perp Pfd Unit Ser B Fixed	NYSE
TGS	Transportadora De Gas Sa Ord B	NYSE
TGT	Target Corp	NYSE
THC	Tenet Healthcare Corp	NYSE
THG	The Hanover Insurance Group	NYSE
THGA	The Hanover Insurance Group I	NYSE
THO	Thor Industries	NYSE
THQ	Tekla Healthcare Opportunities	NYSE
THR	Thermon Group Holdings Inc	NYSE
THS	Treehouse Foods	NYSE
THW	Tekla World Healthcare Fund	NYSE
TI	Telecom Italia S.P.A.	NYSE
TI.A	Telecom Italia S.P.A.	NYSE
TIER	Tier REIT	NYSE
TIF	Tiffany & Co	NYSE
TISI	Team Inc	NYSE
TJX	TJX Companies	NYSE
TK	Teekay Shipping Corp	NYSE
TKC	Turkcell Iletisim Hizmetleri As	NYSE
TKR	Timken Company	NYSE
TLI	Lmp Corporate Loan Fund Inc	NYSE
TLK	P.T. Telekomunikasi Indonesia Tbk	NYSE
TLP	Transmontaigne Partners LP	NYSE
TLRA	Telaria Inc	NYSE
TLRD	Tailored Brands Inc	NYSE
TLYS	Tilly's Inc	NYSE
TM	Toyota Motor Corp Ltd Ord	NYSE
TMHC	Taylor Morrison Home Corporatio	NYSE
TMK	Torchmark Corp	NYSE
TMK-C	Torchmark Corporation 6.125% Ju	NYSE
TMO	Thermo Fisher Scientific Inc	NYSE
TMST	Timken Steel Corp	NYSE
TNC	Tennant Company	NYSE
TNET	Trinet Group Inc	NYSE
TNH	Terra Nitrogen Company LP	NYSE
TNK	Teekay Tankers Ltd	NYSE
TNP	Tsakos Energy Navigation Ltd	NYSE
TNP-B	Tsakos Energy Navigation Limit	NYSE
TNP-C	Tsakos Energy Navigation Limit	NYSE
TNP-D	Tsakos Energy Navigation Limit	NYSE
TNP-E	Tsakos Energy Navigation Ltd	NYSE
TOL	Toll Brothers Inc	NYSE
TOO	Teekay Offshore Partners LP	NYSE
TOO-A	Teekay Offshore Partners LP	NYSE
TOO-B	Teekay Offshore Partners LP	NYSE
TOO-E	Teekay Offshore Partners LP 8.875% Cum Red Perp	NYSE
TOT	Totalfinaelf S.A.	NYSE
TOWR	Tower International	NYSE
TPB	Turning Point Brands	NYSE
TPC	Tutor Perini Corp	NYSE
TPG.E	Tpg Pace Energy Holdings Corp	NYSE
TPG.F	Tpg Pace Energy Holdings Corp Warrant	NYSE
TPG.H	Tpg Pace Holdings Corp	NYSE
TPG.I	Tpg Pace Holdings Corp Warrants	NYSE
TPGE	Tpg Pace Energy Holdings Corp Class A	NYSE
TPGH	Tpg Pace Holdings Corp Class A Ordinary Shares	NYSE
TPH	Tri Pointe Homes Inc	NYSE
TPL	Texas Pacific Land Trust	NYSE
TPR	Tapestry Inc	NYSE
TPRE	Third Point Reinsurance Ltd Co	NYSE
TPVG	Triplepoint Venture Growth Bdc	NYSE
TPVY	Triplepoint Venture Growth Bdc Corp 5.75% Notes	NYSE
TPX	Tempur-Pedic International Inc	NYSE
TPZ	Tortoise Power and Energy	NYSE
TR	Tootsie Roll Industries	NYSE
TRC	Tejon Ranch Company	NYSE
TRCO	Tribune Media Corp	NYSE
TREC	Trecora Resources	NYSE
TREX	Trex Company	NYSE
TRGP	Targa Resources	NYSE
TRI	Thomson Reuters Corp	NYSE
TRK	Speedway Motorsports	NYSE
TRN	Trinity Industries	NYSE
TRNO	Terreno Realty Corp	NYSE
TROX	Tronox Inc	NYSE
TRP	Transcananda Pipelines	NYSE
TRQ	Turquoise Hill Resources Ltd	NYSE
TRTN	Triton International Ltd	NYSE
TRTX	Tpg Re Finance Trust Inc	NYSE
TRU	Transunion	NYSE
TRV	The Travelers Companies Inc	NYSE
TS	Tenaris S.A.	NYSE
TSE	Trinseo S.A.	NYSE
TSI	Tcw Strategic	NYSE
TSLF	THL Credit Senior Loan Fund	NYSE
TSLX	Tpg Specialty Lending Inc	NYSE
TSM	Taiwan Semiconductor Manufacturing	NYSE
TSN	Tyson Foods	NYSE
TSQ	Townsquare Media Llc	NYSE
TSS	Total System Services	NYSE
TSU	Tim Participacoes S.A.	NYSE
TTC	Toro Company	NYSE
TTI	Tetra Technologies	NYSE
TTM	Tata Motors Ltd	NYSE
TTP	Tortoise Pipeline & Energy Fund	NYSE
TU	Telus Corp Non Voting Shares	NYSE
TUP	Tupperware Corp	NYSE
TV	Grupo Televisa S.A.	NYSE
TVC	Tennessee Valley Authority	NYSE
TVE	Tennessee Valley Authority	NYSE
TVPT	Travelport Worldwide Ltd	NYSE
TWI	Titan International	NYSE
TWLO	Twilio	NYSE
TWN	Taiwan Fund	NYSE
TWO	Two Harbors Investments Corp	NYSE
TWO-A	Two Harbors Investment Corp	NYSE
TWO-B	Two Harbors Investment Corp	NYSE
TWO-C	Two Harbors Investment Corp Cum Red Pfd Ser C FI	NYSE
TWTR	Twitter Inc	NYSE
TWX	Time Warner Inc	NYSE
TX	Ternium S.A.	NYSE
TXT	Textron Inc	NYSE
TY	Tri Continental Corp	NYSE
TY.P	Tri Contl Cp 2.50 Pr	NYSE
TYG	Tortoise Energy Infrastructure Corp	NYSE
TYL	Tyler Technologies	NYSE
UA	Under Armour Inc Class C Comm	NYSE
UAA	Under Armour	NYSE
UAL	United Continental Holdings	NYSE
UAN	Cvr Partners LP	NYSE
UBA	Urstadt Biddle Properties Inc	NYSE
UBP	Urstadt Biddle Properties Inc	NYSE
UBP-G	Urstadt Biddle Properties Inc	NYSE
UBP-H	Urstadt Biddle Properties Inc Pfd.	NYSE
UBS	UBS Group Ag	NYSE
UDR	United Dominion Realty Trust	NYSE
UE	Urban Edge Properties	NYSE
UFI	Unifi Inc	NYSE
UFS	Domtar Corp	NYSE
UGI	Ugi Corp	NYSE
UGP	Ultrapar Participacoes S.A.	NYSE
UHS	Universal Health Services	NYSE
UHT	Universal Health Realty Income Trust	NYSE
UIS	Unisys Corp	NYSE
UL	Unilever Plc	NYSE
UMC	United Microelectronics Corp	NYSE
UMH	Umh Properties	NYSE
UMH-B	Umh Properties Inc	NYSE
UMH-C	Umh Properties Inc	NYSE
UMH-D	Umh Properties Inc Cum Red Pfd Ser D	NYSE
UN	Unilever Nv	NYSE
UNF	Unifirst Corp	NYSE
UNH	Unitedhealth Group Inc	NYSE
UNM	Unumprovident Corp	NYSE
UNP	Union Pacific Corp	NYSE
UNT	Unit Corp	NYSE
UNVR	Univar Inc	NYSE
UPS	United Parcel Service	NYSE
URI	United Rentals	NYSE
USA	Liberty All-Star Equity Fund	NYSE
USAC	USA Compression Partners LP	NYSE
USB	U.S. Bancorp	NYSE
USB-A	U.S. Bancorp Depositary Shares	NYSE
USB-H	U.S. Bancorp Dep Sh	NYSE
USB-M	U.S. Bancorp	NYSE
USB-O	U.S. Bancorp	NYSE
USDP	USD Partners LP	NYSE
USFD	US Foods Holding	NYSE
USG	USG Corp	NYSE
USM	United States Cellular Corp	NYSE
USNA	Usana Health Sciences Inc	NYSE
USPH	U.S. Physical Therapy	NYSE
UTF	Cohen & Steers Infrastructure Fund	NYSE
UTI	Universal Technical Institute Inc	NYSE
UTL	Unitil Corp	NYSE
UTX	United Technologies Corp	NYSE
UVE	Universal Insurance Holdings Inc	NYSE
UVV	Universal Corp	NYSE
UZA	United States Cellular Corp	NYSE
UZB	United States Cellular Corpora	NYSE
UZC	United States Cellular Corpora	NYSE
V	Visa Inc	NYSE
VAC	Marriot Vacations Worldwide Cor	NYSE
VALE	Vale S.A.	NYSE
VAR	Varian Medical Systems	NYSE
VBF	Invesco Van Kampen Bond Fund	NYSE
VCO	Vina Concha Y Toro	NYSE
VCRA	Vocera Communications Inc	NYSE
VCV	Invesco California Value Muni Income Trust	NYSE
VEC	Vectrus Inc	NYSE
VEDL	Vedanta Ltd	NYSE
VEEV	Veeva Systems Inc	NYSE
VER	Vereit Inc	NYSE
VER-F	Vereit Inc	NYSE
VET	Vermilion Energy Inc	NYSE
VFC	V.F. Corp	NYSE
VG	Vonage Holdings	NYSE
VGI	Virtus Global Multi-Sector Inc	NYSE
VGM	Invesco Trust For Investment Grade Municipals	NYSE
VGR	Vector Group Ltd	NYSE
VHI	Valhi Inc	NYSE
VICI	Vici Properties Inc	NYSE
VIPS	Vipshop Holdings Ltd	NYSE
VIV	Telecomunicacoes De Sao Paulo ADR	NYSE
VJET	Voxeljet Ag	NYSE
VKQ	Invesco Muni Trust	NYSE
VLO	Valero Energy Corp	NYSE
VLP	Valero Energy Partners LP	NYSE
VLRS	Controladora Vuela Compaia De	NYSE
VLT	Invesco High	NYSE
VLY	Valley National Bancorp	NYSE
VLY-A	Valley National Bancorp	NYSE
VLY-B	Valley National Bancorp [Nj] Non Cum Perp Pfd Se	NYSE
VLY.W	Valley National Bancorp	NYSE
VMC	Vulcan Materials Company	NYSE
VMI	Valmont Industries	NYSE
VMO	Invesco Muni Opportunity Trust	NYSE
VMW	Vmware Inc	NYSE
VNCE	Vince Holding Corp	NYSE
VNO	Vornado Realty Trust	NYSE
VNO-K	Vornado Realty Trust	NYSE
VNO-L	Vornado Realty Trust	NYSE
VNO-M	Vornado Realty Trust Redeemable Pfd Ser M	NYSE
VNTR	Venator Materials Plc Ordinary Shares	NYSE
VOC	Voc Energy Trust	NYSE
VOYA	VOYA Financial Inc	NYSE
VPG	Vishay Precision Group	NYSE
VPV	Invesco Pennsylvania Muni	NYSE
VR	Validus Holdings	NYSE
VR-A	Validus Holdings Ltd	NYSE
VR-B	Validus Holdings Ltd	NYSE
VRS	Verso Corp	NYSE
VRTV	Veritiv Corp	NYSE
VRX	Valeant Pharmaceuticals Intl	NYSE
VSH	Vishay Intertechnology	NYSE
VSI	Vitamin Shoppe Inc	NYSE
VSLR	Vivint Solar Inc	NYSE
VSM	Versum Materials Inc	NYSE
VST	Vistra Energy Corp	NYSE
VSTO	Vista Outdoor Inc	NYSE
VTA	Invesco Dynamic Credit Fund	NYSE
VTN	Invesco Trust New York Muni	NYSE
VTR	Ventas Inc	NYSE
VTRB	Ventas Realty Limited Partner	NYSE
VVC	Vectren Corp	NYSE
VVI	Viad Corp	NYSE
VVR	Invesco Senior Income Trust	NYSE
VVV	Valvoline Inc	NYSE
VZ	Verizon Communications Inc	NYSE
VZA	Verizon Communications Inc 5.9	NYSE
W	Wayfair Inc	NYSE
WAAS	Aquaventure Holdings Ltd	NYSE
WAB	Wabtec Corp	NYSE
WAGE	Wageworks Inc	NYSE
WAIR	Wesco Aircraft Holdings Inc	NYSE
WAL	Western Alliance Bancorporation	NYSE
WALA	Western Alliance Bancorporation	NYSE
WAT	Waters Corp	NYSE
WBAI	500Wan.Com Ltd	NYSE
WBC	Wabco Holdings Inc	NYSE
WBK	Westpac Banking Corp	NYSE
WBS	Webster Financial Corp	NYSE
WBS-F	Webster Financial Corp Pfd	NYSE
WBT	Welbilt Inc	NYSE
WCC	Wesco International	NYSE
WCG	Wellcare Group	NYSE
WCN	Waste Connections Inc	NYSE
WD	Walker & Dunlop	NYSE
WDR	Waddell & Reed Financial	NYSE
WEA	Western Asset Bond Fund	NYSE
WEC	Wisconsin Energy Corp	NYSE
WEL-I	Welltower Inc. Pfd Series I	NYSE
WELL	Welltower Inc	NYSE
WES	Western Gas Partners LP	NYSE
WEX	Wex Inc	NYSE
WF	Woori Finance Holdings Co Ltd	NYSE
WFC	Wells Fargo & Company	NYSE
WFC-J	Wells Fargo Pfd J	NYSE
WFC-L	Wells Fargo Pfd L	NYSE
WFC-N	Wells Fargo & Company Dep Shs R	NYSE
WFC-O	Wells Fargo & Company	NYSE
WFC-P	Wells Fargo & Company Ser P	NYSE
WFC-Q	Wells Fargo & Co	NYSE
WFC-R	Wells Fargo	NYSE
WFC-T	Wells Fargo & Company Series T	NYSE
WFC-V	Wells Fargo & Company Depositar	NYSE
WFC-W	Wells Fargo & Company	NYSE
WFC-X	Wells Fargo & Company	NYSE
WFC-Y	Wells Fargo & Co. Dep Shs Repstg 1/1000Th Int No	NYSE
WFC.W	Wells Fargo and Co	NYSE
WFE-A	Wells Fargo Real Estate Invest	NYSE
WFT	Weatherford International Ltd	NYSE
WG	Willbros Group	NYSE
WGL	WGL Holdings Inc	NYSE
WGO	Winnebago Industries	NYSE
WGP	Western Gas Eqty Partners LP	NYSE
WHD	Cactus Inc. Class A	NYSE
WHG	Westwood Holdings Group Inc	NYSE
WHR	Whirlpool Corp	NYSE
WIA	U.S. Treasury Inflation Prot Secs Fd	NYSE
WIT	Wipro Ltd	NYSE
WIW	U.S Treasury Inflation Prot Secs Fd 2	NYSE
WK	Workiva Llc	NYSE
WLH	William Lyon Homes	NYSE
WLK	Westlake Chemical Corp	NYSE
WLKP	Westlake Chemical Partners LP	NYSE
WLL	Whiting Petroleum Corp	NYSE
WM	Waste Management	NYSE
WMB	Williams Companies	NYSE
WMC	Western Asset Mortgage Capital	NYSE
WMK	Weis Markets	NYSE
WMLP	Westmoreland Resource Partners LP	NYSE
WMS	Advanced Drainage Systems Inc	NYSE
WMT	Wal-Mart Stores	NYSE
WNC	Wabash National Corp	NYSE
WNS	Wns Ltd	NYSE
WOR	Worthington Industries	NYSE
WOW	Wideopenwest Inc	NYSE
WP	Worldpay Inc.	NYSE
WPC	W.P. Carey & Co. Llc	NYSE
WPG	Washington Prime Group Inc	NYSE
WPG-H	Washington Prime Group Inc 7.5	NYSE
WPG-I	Wp Glimcher Inc	NYSE
WPM	Wheaton Precious Metals	NYSE
WPP	Wpp Plc ADR	NYSE
WPX	Wpx Energy Inc	NYSE
WPXP	Wpx Energy Inc	NYSE
WPZ	Williams Partners LP	NYSE
WR	Westar Energy	NYSE
WRB	W.R. Berkley Corp	NYSE
WRB-B	W.R. Berkley Corp	NYSE
WRB-C	W.R. Berkley Corp	NYSE
WRB-D	W.R. Berkley Corporation 5.75%	NYSE
WRD	Wildhorse Resour	NYSE
WRE	Washington Real Estate Investment	NYSE
WRI	Weingarten Realty Investors	NYSE
WRK	Westrock Company	NYSE
WSM	Williams-Sonoma	NYSE
WSO	Watsco Inc	NYSE
WSO.B	Watsco Inc Cl B	NYSE
WSR	Whitestone REIT	NYSE
WST	West Pharmaceutical Services	NYSE
WTI	W&T Offshore	NYSE
WTM	White Mountains Insurance Group	NYSE
WTR	Aqua America	NYSE
WTS	Watts Water Technologies	NYSE
WTTR	Select Energy Services Inc	NYSE
WTW	Weight Watchers International Inc	NYSE
WU	Western Union Company	NYSE
WUBA	58.Com Inc	NYSE
WWE	World Wrestling Entertainment	NYSE
WWW	Wolverine World Wide	NYSE
WY	Weyerhaeuser Company	NYSE
WYN	Wyndham Worldwide Corp	NYSE
X	United States Steel Corp	NYSE
XEC	Cimarex Energy Co	NYSE
XFLT	Xai Octagon Floating Alt Income Term Trust Co	NYSE
XHR	Xenia Hotels & Resorts Inc	NYSE
XIN	Xinyuan Real Estate Co Ltd	NYSE
XL	XL Company Switzerland Gmbh	NYSE
XOM	Exxon Mobil Corp	NYSE
XON	Intrexon Corp	NYSE
XOXO	Xoxo Group Inc	NYSE
XPO	Xpo Logistics Inc	NYSE
XRF	China Rapid Finance Limited ADR	NYSE
XRM	Xerium Technologies	NYSE
XRX	Xerox Corp	NYSE
XYL	Xylem Inc	NYSE
Y	Alleghany Corp	NYSE
YELP	Yelp Inc	NYSE
YEXT	Yext Inc	NYSE
YGE	Yingli Green Energy Holding Company	NYSE
YPF	Ypf Sociedad Anonima	NYSE
YRD	Yirendai Ltd	NYSE
YUM	Yum! Brands	NYSE
YUMC	Yum China Holdings Inc	NYSE
ZAYO	Zayo Group Holdings Inc	NYSE
ZB-A	Zions Bc Dp Shs A	NYSE
ZB-G	Zions Bancorporation	NYSE
ZB-H	Zions Bancorporation	NYSE
ZBH	Zimmer Biomet Holdings	NYSE
ZBK	Zion Bancorporation	NYSE
ZEN	Zendesk Inc	NYSE
ZF	Zweig Fund	NYSE
ZNH	China Southern Airlines Company	NYSE
ZOES	Zoe's Kitchen Inc	NYSE
ZTO	Zto Express [Cayman] Inc	NYSE
ZTR	Zweig Total Return Fund	NYSE
ZTS	Zoetis Inc Class A	NYSE
ZX	China Zenix Auto International	NYSE
ZYME	Zymeworks Inc	NYSE
