AB        	AB SCIENCE                                        	PAR       
ABCA      	ABC ARBITRAGE                                     	PAR       
ABIO      	                                                  	PAR       
AC        	ACCOR                                             	PAR       
ACA       	CREDIT AGRICOLE                                   	PAR       
ACAN      	ACANTHE DEV.                                      	PAR       
ADOC      	                                                  	PAR       
ADP       	ADP                                               	PAR       
ADVI      	ADVINI                                            	PAR       
AF        	AIR FRANCE -KLM                                   	PAR       
AFO       	AFONE                                             	PAR       
AGTA      	AGTA RECORD                                       	PAR       
AI        	AIR LIQUIDE                                       	PAR       
AIR       	Airbus Group                                      	PAR       
AKA       	AKKA TECHNOLOGIES                                 	PAR       
AKE       	ARKEMA                                            	PAR       
ALA2M     	A2MICILE EUROPE                                   	PAR       
ALACI     	ACCES INDUSTRIE                                   	PAR       
ALADA     	ADA                                               	PAR       
ALADM     	ADTHINK MEDIA                                     	PAR       
ALADO     	ADOMOS                                            	PAR       
ALAGR     	AGROGENERATION                                    	PAR       
ALALO     	ACHETER-LOUER.FR                                  	PAR       
ALANT     	ANTEVENIO                                         	PAR       
ALAST     	ASTELLIA                                          	PAR       
ALAUP     	AUPLATA                                           	PAR       
ALBDM     	BD MULTI MEDIA                                    	PAR       
ALBFR     	SIDETRADE                                         	PAR       
ALBIO     	BIOSYNEX EUR0.10                                  	PAR       
ALBRI     	BRICORAMA                                         	PAR       
ALBUD     	BUDGET TELECOM                                    	PAR       
ALCAR     	CARMAT                                            	PAR       
ALCLA     	CLASQUIN                                          	PAR       
ALCLS     	CELLECTIS                                         	PAR       
ALDAR     	DAMARTEX                                          	PAR       
ALDBL     	BERNARD LOISEAU                                   	PAR       
ALDEI     	DEINOVE                                           	PAR       
ALDLS     	D.L.S.I.                                          	PAR       
ALDMO     	DEMOS                                             	PAR       
ALDV      	ADC SIIC                                          	PAR       
ALEHT     	EXONHIT                                           	PAR       
ALENT     	ENTREPARTICULIERS                                 	PAR       
ALESK     	ESKER                                             	PAR       
ALFBA     	FASHION B AIR                                     	PAR       
ALFPC     	FOUNTAINE PAJOT                                   	PAR       
ALGAU     	GAUSSIN                                           	PAR       
ALGBE     	GLOBAL BIOENERGIES EUR0.05                        	PAR       
ALGCM     	GROUPE CONCOURSMANIA EUR0.20                      	PAR       
ALGEM     	EUROGERM                                          	PAR       
ALGEN     	GENOWAY                                           	PAR       
ALGIL     	GROUPE GUILLIN                                    	PAR       
ALHEO     	H2O INNOVATION INC                                	PAR       
ALHIT     	HITECHPROS                                        	PAR       
ALHOL     	HOLOSFIND                                         	PAR       
ALHPC     	HEURTEY PETROCHEM                                 	PAR       
ALHYG     	HYBRIGENICS                                       	PAR       
ALI2S     	I2S                                               	PAR       
ALIDS     	IDSUD                                             	PAR       
ALIMO     	GROUPIMO                                          	PAR       
ALINN     	MILLET INNOVATION                                 	PAR       
ALINT     	INTEGRAGEN                                        	PAR       
ALKEY     	KEYYO                                             	PAR       
ALLOG     	LOGIC INSTRUMENT                                  	PAR       
ALM       	ALPHA MOS                                         	PAR       
ALMAS     	MASTRAD                                           	PAR       
ALMDG     	MGI DIGITAL GRAPHI                                	PAR       
ALMDT     	MEDIANTECHNOLOGIES                                	PAR       
ALMED     	MEDICREA INTERNAT.                                	PAR       
ALMGI     	MG INTERNATIONAL                                  	PAR       
ALMIC     	MICROWAVE VISION                                  	PAR       
ALMIL     	1000MERCIS                                        	PAR       
ALNBT     	NETBOOSTER                                        	PAR       
ALNEV     	NEOVACS                                           	PAR       
ALO       	ALSTOM                                            	PAR       
ALOBR     	OBER                                              	PAR       
ALOCT     	OCTO TECHNOLOGY                                   	PAR       
ALODI     	O2I                                               	PAR       
ALORO     	OROLIA                                            	PAR       
ALP       	ADL PARTNER                                       	PAR       
ALPDX     	PISCINES DESJOYAUX                                	PAR       
ALPHX     	PHENIX SYSTEMS EUR1.00                            	PAR       
ALPHY     	ALES GROUPE                                       	PAR       
ALPRO     	PRODWARE                                          	PAR       
ALS30     	SOLUTIONS 30                                      	PAR       
ALSDL     	DL SOFTWARE                                       	PAR       
ALSIP     	SIPAREX CROISSANCE                                	PAR       
ALSOL     	CUSTOM SOLUTIONS                                  	PAR       
ALSPO     	SPOREVER                                          	PAR       
ALSTW     	STREAMWIDE                                        	PAR       
ALT       	ALTRAN TECHN.                                     	PAR       
ALTA      	ALTAREA                                           	PAR       
ALTEV     	ENVIRONNEMENT SA                                  	PAR       
ALTRI     	TRILOGIQ                                          	PAR       
ALTUR     	TURENNE INV                                       	PAR       
ALTVO     	EVOLIS                                            	PAR       
ALU       	ALCATEL-LUCENT                                    	PAR       
ALUCR     	UCAR EUR2.70                                      	PAR       
ALVDI     	VDI GROUP                                         	PAR       
ALVDM     	VOYAGEURS DU MONDE                                	PAR       
ALVEL     	VELCAN ENERGY                                     	PAR       
ALVER     	VERGNET                                           	PAR       
ALVMG     	VISIOMED GROUP EUR4                               	PAR       
ALWEB     	WEBORAMA                                          	PAR       
ALWED     	WEDIA                                             	PAR       
AM        	DASSAULT AVIATION                                 	PAR       
ANF       	ANF IMMOBILIER                                    	PAR       
APAM      	                                                  	PAR       
APR       	APRIL                                             	PAR       
AREIT     	ALTAREIT                                          	PAR       
AREVA     	AREVA                                             	PAR       
ARG       	ARGAN                                             	PAR       
ARTO      	ARTOIS NOM.                                       	PAR       
ASK       	                                                  	PAR       
ASP       	A.S.T. GROUPE                                     	PAR       
ASY       	ASSYSTEM                                          	PAR       
ATA       	ATARI                                             	PAR       
ATE       	ALTEN                                             	PAR       
ATEME     	                                                  	PAR       
ATI       	ACTIA GROUP                                       	PAR       
ATO       	ATOS                                              	PAR       
AUB       	AUBAY                                             	PAR       
AUGR      	AUGROS COSMETICS                                  	PAR       
AURE      	AUREA                                             	PAR       
AURS      	AURES TECHNOLOGIES                                	PAR       
AVQ       	AVANQUEST SOFTWARE                                	PAR       
AVT       	AVENIR TELECOM                                    	PAR       
AWOX      	                                                  	PAR       
AXW       	AXWAY SOFTWARE                                    	PAR       
BAIN      	BAINS MER MONACO                                  	PAR       
BB        	BIC                                               	PAR       
BCAM      	                                                  	PAR       
BCRA      	                                                  	PAR       
BELI      	BELIER                                            	PAR       
BEN       	BENETEAU                                          	PAR       
BIG       	BIGBEN INTERACTIVE                                	PAR       
BIGBS     	                                                  	PAR       
BIM       	BIOMERIEUX                                        	PAR       
BLC       	BASTIDE LE CONFORT                                	PAR       
BLUE      	                                                  	PAR       
BN        	DANONE                                            	PAR       
BND       	BUSINESS ET DECIS.                                	PAR       
BNP       	BNP PARIBAS ACT.A                                 	PAR       
BNS       	BENI STABILI                                      	PAR       
BOI       	BOIRON                                            	PAR       
BOL       	BOLLORE                                           	PAR       
BON       	BONDUELLE                                         	PAR       
BSD       	BOURSE DIRECT                                     	PAR       
BUI       	BARBARA BUI                                       	PAR       
BUR       	BURELLE                                           	PAR       
BVI       	BUREAU VERITAS                                    	PAR       
CA        	CARREFOUR                                         	PAR       
CAF       	CRCAM PARIS ET IDF                                	PAR       
CAFO      	CAFOM                                             	PAR       
CAP       	CAP GEMINI                                        	PAR       
CAPBS     	                                                  	PAR       
CAPLI     	CAPELLI                                           	PAR       
CARPD     	                                                  	PAR       
CAS       	CAST                                              	PAR       
CAT31     	CA TOULOUSE 31 CCI                                	PAR       
CATG      	                                                  	PAR       
CATR      	CATERPILLAR INC                                   	PAR       
CBOT      	                                                  	PAR       
CBSM      	SCBSM                                             	PAR       
CC        	CIC                                               	PAR       
CCE       	COCA-COLA ENTER                                   	PAR       
CCN       	CRCAM NORM.SEINE                                  	PAR       
CDA       	ALPES (COMPAGNIE)                                 	PAR       
CDI       	CHRISTIAN DIOR                                    	PAR       
CEN       	GROUPE CRIT                                       	PAR       
CFAO      	CFAO                                              	PAR       
CGD       	CEGID GROUP                                       	PAR       
CGG       	                                                  	PAR       
CGM       	CEGEDIM                                           	PAR       
CGR       	CEGEREAL                                          	PAR       
CIB       	CIBOX INTER A CTIV                                	PAR       
CIEM      	CIE MAROCAINE                                     	PAR       
CIV       	CRCAM ILLE-VIL.CCI                                	PAR       
CMO       	CRCAM MORBIHAN CCI                                	PAR       
CNF       	CRCAM NORD CCI                                    	PAR       
CNP       	CNP ASSURANCES                                    	PAR       
CO        	CASINO GUICHARD                                   	PAR       
COFA      	                                                  	PAR       
COH       	COHERIS                                           	PAR       
COM       	CNIM CONSTR.FRF 10                                	PAR       
COUR      	COURTOIS                                          	PAR       
COX       	NICOX                                             	PAR       
CRAP      	CRCAM ALP.PROV.CCI                                	PAR       
CRAV      	CRCAM ATL.VEND.CCI                                	PAR       
CRBP2     	CRCAM BRIE PIC2CCI                                	PAR       
CRI       	CHARGEURS                                         	PAR       
CRLA      	CRCAM LANGUED CCI                                 	PAR       
CRLO      	CRCAM LOIRE HTE L.                                	PAR       
CRSU      	CRCAM SUD R.A.CCI                                 	PAR       
CRTO      	CRCAM TOURAINE CCI                                	PAR       
CS        	AXA                                               	PAR       
CTRG      	CATERING INTL SCES                                	PAR       
DBG       	DERICHEBOURG                                      	PAR       
DBT       	ENCRES DUBUIT                                     	PAR       
DBV       	                                                  	PAR       
DEC       	JC DECAUX SA.                                     	PAR       
DEXB      	                                                  	PAR       
DG        	VINCI                                             	PAR       
DGE       	DIAGEO                                            	PAR       
DGM       	DIAGNOSTIC MEDICAL                                	PAR       
DGMBS     	                                                  	PAR       
DIG       	DIGIGRAM                                          	PAR       
DIM       	SARTORIUS STED BIO                                	PAR       
DLTA      	DELTA PLUS GROUP                                  	PAR       
DNX       	DNXCORP                                           	PAR       
DP        	IRDNORDPASDECALAIS                                	PAR       
DPT       	ST DUPONT                                         	PAR       
DSY       	DASSAULT SYSTEMES                                 	PAR       
DUC       	                                                  	PAR       
DVT       	DEVOTEAM                                          	PAR       
EC        	TOTAL GABON                                       	PAR       
ECASA     	ECA                                               	PAR       
ECP       	EUROPACORP                                        	PAR       
EDEN      	EDENRED                                           	PAR       
EDF       	EDF                                               	PAR       
EDI       	MEDIA 6                                           	PAR       
EDL       	EURO DISNEY                                       	PAR       
EEM       	ELEC.MADAGASCAR                                   	PAR       
EI        	ESSILOR INTL.                                     	PAR       
EIFF      	TOUR EIFFEL                                       	PAR       
EKI       	                                                  	PAR       
ELE       	EULER HERMES                                      	PAR       
ELEC      	ELEC.STRASBOURG                                   	PAR       
ELIOR     	                                                  	PAR       
ELIS      	SA Elis                                           	PAR       
EMG       	EUROMEDIS GROUPE                                  	PAR       
EN        	BOUYGUES                                          	PAR       
ENX       	                                                  	PAR       
EO        	FAURECIA                                          	PAR       
EOS       	ACTEOS                                            	PAR       
EOSI      	                                                  	PAR       
EPCP      	                                                  	PAR       
ERA       	ERAMET                                            	PAR       
ERF       	EUROFINS SCIENT.                                  	PAR       
ERSC      	                                                  	PAR       
ERYP      	                                                  	PAR       
ES        	ESSO                                              	PAR       
ESI       	ESI GROUP                                         	PAR       
ESP       	                                                  	PAR       
ETL       	EUTELSAT COMMUNIC.                                	PAR       
EUR       	EURO RESSOURCES                                   	PAR       
EURS      	FONCIERE EURIS                                    	PAR       
EXAC      	EXACOMPTA CLAIREF.                                	PAR       
EXE       	EXEL INDUSTRIES                                   	PAR       
EXPL      	EXPLOSIFS PROD.CHI                                	PAR       
FALG      	                                                  	PAR       
FATL      	FONCIERE ATLAND                                   	PAR       
FBEL      	FROMAGERIES BEL                                   	PAR       
FDL       	FDL                                               	PAR       
FDPA      	                                                  	PAR       
FDR       	FONC.DES REGIONS                                  	PAR       
FED       	GIORGIO FEDON                                     	PAR       
FEM       	AUFEMININ.COM                                     	PAR       
FFP       	FFP                                               	PAR       
FGR       	EIFFAGE                                           	PAR       
FII       	LISI                                              	PAR       
FIM       	FIMALAC                                           	PAR       
FIPP      	                                                  	PAR       
FLE       	FLEURY MICHON                                     	PAR       
FLO       	GROUPE FLO                                        	PAR       
FLY       	FONCIERE LYONNAISE                                	PAR       
FMU       	FONCIERE DES MURS                                 	PAR       
FNAC      	                                                  	PAR       
FNTS      	FINATIS                                           	PAR       
FORDP     	FORD MOTOR                                        	PAR       
FP        	TOTAL                                             	PAR       
FPG       	UNION TECH.INFOR.                                 	PAR       
FPN       	                                                  	PAR       
FR        	VALEO                                             	PAR       
FREY      	FREY                                              	PAR       
GAM       	GAUMONT                                           	PAR       
GBB       	BOURBON                                           	PAR       
GBT       	GUERBET                                           	PAR       
GDS       	GENERALE DE SANTE                                 	PAR       
GEA       	GEA GRENOBL.ELECT.                                	PAR       
GECP      	GECI INTL                                         	PAR       
GENX      	GENERIX                                           	PAR       
GET       	GROUPE EUROTUNNEL                                 	PAR       
GFC       	GECINA NOM.                                       	PAR       
GFI       	GFI INFORMATIQUE                                  	PAR       
GFT       	GAMELOFT                                          	PAR       
GID       	EGIDE                                             	PAR       
GIRO      	                                                  	PAR       
GJAJ      	                                                  	PAR       
GLE       	SOCIETE GENERALE                                  	PAR       
GLO       	GL EVENTS                                         	PAR       
GNE       	GENERAL ELECTRIC                                  	PAR       
GNFT      	                                                  	PAR       
GOE       	GROUPE GORGE                                      	PAR       
GPE       	GPE GROUP PIZZORNO                                	PAR       
GTCL      	                                                  	PAR       
GTO       	GEMALTO                                           	PAR       
GTT       	                                                  	PAR       
GUI       	GUILLEMOT                                         	PAR       
GUYD      	GUY DEGRENNE                                      	PAR       
GV        	                                                  	PAR       
HAV       	HAVAS                                             	PAR       
HBW       	HUBWOO                                            	PAR       
HCO       	HIGH CO                                           	PAR       
HF        	HF                                                	PAR       
HIM       	HI-MEDIA                                          	PAR       
HO        	THALES                                            	PAR       
HSB       	HSBC HOLDINGS                                     	PAR       
IAM       	MAROC TELECOM                                     	PAR       
ICAD      	ICADE                                             	PAR       
IDIP      	IDI                                               	PAR       
IDL       	                                                  	PAR       
IGE       	IGE + XAO                                         	PAR       
ILD       	ILIAD                                             	PAR       
IMDA      	IMMOB.DASSAULT                                    	PAR       
IML       	AFFINE                                            	PAR       
IMPL      	                                                  	PAR       
INEA      	FONCIERE INEA                                     	PAR       
INF       	INFOTEL                                           	PAR       
INFE      	INDLE FIN.ENTREPR.                                	PAR       
ING       	INGENICO                                          	PAR       
INN       	INNELEC MULTIMEDIA                                	PAR       
INSD      	                                                  	PAR       
IPH       	INNATE PHARMA                                     	PAR       
IPN       	IPSEN                                             	PAR       
IPS       	IPSOS                                             	PAR       
ITE       	ITESOFT                                           	PAR       
ITL       	IT LINK                                           	PAR       
ITP       	INTERPARFUMS                                      	PAR       
ITS       	ITS GROUP                                         	PAR       
JCQ       	JACQUET METAL SCE                                 	PAR       
JXR       	ARCHOS                                            	PAR       
KAZI      	ORCH.KAZIBAO REGRT                                	PAR       
KER       	Kering                                            	PAR       
KEY       	KEYRUS                                            	PAR       
KN        	NATIXIS                                           	PAR       
KOF       	KAUFMAN ET BROAD                                  	PAR       
KORI      	KORIAN                                            	PAR       
LACR      	LACROIX SA                                        	PAR       
LAF       	LAFUMA                                            	PAR       
LAN       	LANSON-BCC                                        	PAR       
LAT       	AVIATION LATECOERE                                	PAR       
LBON      	LEBON                                             	PAR       
LCO       	SOLUCOM                                           	PAR       
LD        	LOCINDUS                                          	PAR       
LDL       	LDLC.COM                                          	PAR       
LEY       	FAIVELEY TRANSPORT                                	PAR       
LI        	KLEPIERRE                                         	PAR       
LIN       	LINEDATA SERVICES                                 	PAR       
LNA       	LE NOBLE AGE                                      	PAR       
LNC       	LESNXCONSTRUCTEURS                                	PAR       
LOCAL     	                                                  	PAR       
LOUP      	LDC                                               	PAR       
LPE       	LAURENT-PERRIER                                   	PAR       
LR        	LEGRAND                                           	PAR       
LSS       	LECTRA                                            	PAR       
LTA       	ALTAMIR AMBOISE                                   	PAR       
LTAN      	LE TANNEUR                                        	PAR       
LTE       	VALTECH                                           	PAR       
MAGIS     	                                                  	PAR       
MALA      	GRAND MARNIER                                     	PAR       
MAN       	MANUTAN INTL                                      	PAR       
MAU       	MAUREL ET PROM                                    	PAR       
MC        	LVMH                                              	PAR       
MCLC      	MECELEC                                           	PAR       
MCPHY     	                                                  	PAR       
MED       	MEDASYS                                           	PAR       
MEMS      	MEMSCAP REGPT                                     	PAR       
MERY      	MERCIALYS                                         	PAR       
METEX     	METABOLIC EXPLORER                                	PAR       
MF        	WENDEL                                            	PAR       
MFC       	MAISONS FRANCE                                    	PAR       
MGIC      	MGI COUTIER                                       	PAR       
MKEA      	MAUNA KEA TECHNOLOGIES EUR0.04                    	PAR       
ML        	MICHELIN                                          	PAR       
MLCMB     	CIE DU MONT BLANC                                 	PAR       
MLLEM     	LECTEURS MONDE                                    	PAR       
MLNMA     	MIGUET ET ASSOCIES                                	PAR       
MLPGO     	P.G.O. AUTOMOBILES                                	PAR       
MLSBT     	SBT                                               	PAR       
MLSML     	SMALTO                                            	PAR       
MMB       	LAGARDERE S.C.A.                                  	PAR       
MMT       	METROPOLE TV                                      	PAR       
MND       	                                                  	PAR       
MONT      	                                                  	PAR       
MRB       	MR BRICOLAGE                                      	PAR       
MRK       	MERCK AND CO INC                                  	PAR       
MRM       	M.R.M                                             	PAR       
MRN       	MERSEN                                            	PAR       
MT        	                                                  	PAR       
MTU       	MANITOU BF                                        	PAR       
MUN       	MICROPOLE                                         	PAR       
NANO      	                                                  	PAR       
NEO       	NEOPOST                                           	PAR       
NEX       	NEXANS                                            	PAR       
NK        	IMERYS                                            	PAR       
NRG       	NRJ GROUP                                         	PAR       
NRO       	NEURONES                                          	PAR       
NRX       	NATUREX                                           	PAR       
NSGP      	                                                  	PAR       
NTG       	NETGEM                                            	PAR       
NUM       	                                                  	PAR       
NXI       	NEXITY                                            	PAR       
ODET      	FINANCIERE ODET                                   	PAR       
OLG       	OL GROUPE                                         	PAR       
ONXEO     	                                                  	PAR       
OPN       	GROUPE OPEN                                       	PAR       
OR        	L'OREAL                                           	PAR       
ORA       	Orange                                            	PAR       
ORAP      	ORAPI                                             	PAR       
OREGE     	                                                  	PAR       
ORIA      	                                                  	PAR       
ORP       	ORPEA                                             	PAR       
OSI       	AUSY                                              	PAR       
OXI       	OXIS INTL                                         	PAR       
PAR       	PAREF                                             	PAR       
PARP      	GROUPE PARTOUCHE                                  	PAR       
PARRO     	PARROT                                            	PAR       
PAT       	                                                  	PAR       
PCA       	PCAS                                              	PAR       
PERR      	PERRIER (GERARD)                                  	PAR       
PGP       	PROCTER GAMBLE                                    	PAR       
PHA       	PHARMAGEST INTER.                                 	PAR       
PIG       	HAULOTTE GROUP                                    	PAR       
PIX       	                                                  	PAR       
PM        	                                                  	PAR       
POM       	PLASTIC OMNIUM                                    	PAR       
PRC       	ARTPRICE COM                                      	PAR       
PREC      	PRECIA                                            	PAR       
PROL      	PROLOGUE                                          	PAR       
PSAT      	PASSAT                                            	PAR       
PSB       	PSB INDUSTRIES                                    	PAR       
PUB       	PUBLICIS GROUPE SA                                	PAR       
PUBBS     	                                                  	PAR       
PVL       	PLAST.VAL LOIRE                                   	PAR       
QUA       	QUANTEL                                           	PAR       
RAL       	RALLYE                                            	PAR       
RBT       	ROBERTET                                          	PAR       
RCF       	TELEPERFORMANCE                                   	PAR       
RCO       	REMY COINTREAU                                    	PAR       
RE        	COLAS                                             	PAR       
RF        	EURAZEO                                           	PAR       
RI        	PERNOD RICARD                                     	PAR       
RIB       	RIBER                                             	PAR       
RIN       	                                                  	PAR       
RLL       	RADIALL                                           	PAR       
RMS       	HERMES INTL                                       	PAR       
RNO       	RENAULT                                           	PAR       
ROBP      	ROBECO                                            	PAR       
ROLP      	ROLINCO                                           	PAR       
RORP      	                                                  	PAR       
ROSA      	                                                  	PAR       
RUI       	RUBIS                                             	PAR       
RUSAL     	GDS (S) RUSAL                                     	PAR       
RX        	RECYLEX S.A.                                      	PAR       
RXL       	REXEL                                             	PAR       
SABE      	                                                  	PAR       
SACI      	FIDUCIAL OFF.SOL.                                 	PAR       
SAF       	SAFRAN                                            	PAR       
SAFT      	SAFT                                              	PAR       
SAMS      	SAMSE                                             	PAR       
SAN       	SANOFI                                            	PAR       
SBT       	OENEO                                             	PAR       
SCHP      	SECHE ENVIRONNEM.                                 	PAR       
SCR       	SCOR SE                                           	PAR       
SDG       	SYNERGIE                                          	PAR       
SDT       	VISIODENT                                         	PAR       
SEC       	SODITECH ING.                                     	PAR       
SEFER     	                                                  	PAR       
SELER     	SELECTIRENTE                                      	PAR       
SEQ       	SEQUANA                                           	PAR       
SESG      	SES                                               	PAR       
SESL      	STORE ELECTRONICS                                 	PAR       
SEV       	SUEZ ENVIRONNEMENT                                	PAR       
SFCA      	SOC FRANC CASINOS                                 	PAR       
SFT       	SOFT COMPUTING                                    	PAR       
SGO       	SAINT GOBAIN                                      	PAR       
SII       	SII                                               	PAR       
SIPH      	INTLE PLANT.HEVEAS                                	PAR       
SK        	S.E.B.                                            	PAR       
SLB       	SCHLUMBERGER                                      	PAR       
SMTPC     	SMTPC                                             	PAR       
SO        	SOMFY SA                                          	PAR       
SOA       	                                                  	PAR       
SOFR      	                                                  	PAR       
SOG       	SOGECLAIR                                         	PAR       
SOI       	SOITEC                                            	PAR       
SOLB      	                                                  	PAR       
SOP       	SOPRA GROUP                                       	PAR       
SPEL      	FONCIERE VOLTA                                    	PAR       
SPI       	SPIR COMMUNICATION                                	PAR       
SQI       	SQLI                                              	PAR       
SQIBS     	                                                  	PAR       
SSI       	                                                  	PAR       
STAL      	                                                  	PAR       
STF       	STEF TFE                                          	PAR       
STM       	STMICROELECTRONICS                                	PAR       
STNT      	STENTYS                                           	PAR       
SU        	SCHNEIDER ELECTRIC                                	PAR       
SW        	SODEXO                                            	PAR       
SWP       	SWORD GROUP                                       	PAR       
SX        	CS (COMM.SYSTEMES)                                	PAR       
SY        	SALVEPAR                                          	PAR       
TAM       	ETAM DEVELOPPEMENT                                	PAR       
TCH       	TECHNICOLOR                                       	PAR       
TEC       	TECHNIP                                           	PAR       
TER       	TERREIS                                           	PAR       
TES       	TESSI                                             	PAR       
TFF       	TONN.FRANCOIS FRES                                	PAR       
TFI       	TF1                                               	PAR       
THEP      	THERMADOR GROUPE                                  	PAR       
THER      	THERMOCOMPACT                                     	PAR       
TIPI      	TIPIAK                                            	PAR       
TKTT      	                                                  	PAR       
TNFN      	                                                  	PAR       
TNG       	TRANSGENE                                         	PAR       
TONN      	TONNA ELECTRONIQUE                                	PAR       
TOU       	TOUPARGEL GROUPE                                  	PAR       
TOUP      	TOUAX                                             	PAR       
TRI       	TRIGANO                                           	PAR       
TVLY      	TIVOLY                                            	PAR       
TXCL      	                                                  	PAR       
UBI       	UBISOFT ENTERTAIN                                 	PAR       
UDIS      	U10                                               	PAR       
UFF       	UNION FIN.FRANCE                                  	PAR       
UG        	PEUGEOT                                           	PAR       
UGBS      	                                                  	PAR       
UL        	UNIBAIL-RODAMCO                                   	PAR       
ULDV      	ULRIC DE VARENS                                   	PAR       
VAC       	PIERRE VACANCES                                   	PAR       
VALE3     	VALE                                              	PAR       
VCT       	VICAT                                             	PAR       
VDLO      	                                                  	PAR       
VET       	VET AFFAIRES                                      	PAR       
VETO      	VETOQUINOL                                        	PAR       
VIAD      	                                                  	PAR       
VIE       	VEOLIA ENVIRON.                                   	PAR       
VIL       	VIEL ET COMPAGNIE                                 	PAR       
VIRP      	VIRBAC                                            	PAR       
VIV       	VIVENDI                                           	PAR       
VK        	VALLOUREC                                         	PAR       
VLA       	                                                  	PAR       
VLAP      	                                                  	PAR       
VLTSA     	                                                  	PAR       
VRAP      	VRANKEN-POMMERY                                   	PAR       
WLN       	                                                  	PAR       
XIL       	XILAM ANIMATION                                   	PAR       
ZC        	ZODIAC AEROSPACE                                  	PAR       
ZIF       	ZUBLIN IMMOBILIERE                                	PAR       
