A         	Armor Minerals Inc                                	TSXV      
AA        	Alba Minerals Inc                                 	TSXV      
AAD       	Added Capital Inc                                 	TSXV      
AAL       	Advantage Lithium Corp                            	TSXV      
AAN       	Alexander Nubia Internat                          	TSXV      
AAO       	Augusta Industries Inc                            	TSXV      
AAT       	Ati Airtest Technologies                          	TSXV      
AAX       	Advance Gold Corp                                 	TSXV      
AAZ       	Azincourt Uranium Inc                             	TSXV      
AB.H      	Asbestos Corporation Lim                          	TSXV      
ABCN      	Abcann Global Corp.                               	TSXV      
ABE       	Abe Resources Inc                                 	TSXV      
ABI       	Abcourt Mines Inc.                                	TSXV      
ABM       	Athabasca Minerals Inc.                           	TSXV      
ABN       	Aben Resources Ltd.                               	TSXV      
ABR       	Ashburton Ventures Inc.                           	TSXV      
ABRA      	Abraplata Resource Corp                           	TSXV      
ABZ       	Asiabasemetals Inc.                               	TSXV      
ACB       	Aurora Cannabis Inc                               	TSXV      
ACE.H     	Ace Aviation Holdings In                          	TSXV      
ACP       	Arcpacific Resources Corp.                        	TSXV      
ACS       	Archon Minerals Limited                           	TSXV      
ACST      	Acasti Pharma Inc                                 	TSXV      
ACU       	Aurora Solar Technologie                          	TSXV      
ADD       	Arctic Star Exploration                           	TSXV      
ADE       	Adex Mining Inc.                                  	TSXV      
ADG       	Arcus Development Group                           	TSXV      
ADK       	Diagnos Inc.                                      	TSXV      
ADYA      	Adya Inc.                                         	TSXV      
ADZ       	Adamera Minerals Corp                             	TSXV      
ADZN      	Adventus Zinc Corporation                         	TSXV      
AFCC      	Automotive Finco Corp.                            	TSXV      
AFE       	Africa Energy Corp                                	TSXV      
AFF       	Affinity Metals Corp.                             	TSXV      
AFM       	Alphamin Resources Corp.                          	TSXV      
AGB       	Atlantic Gold Corporatio                          	TSXV      
AGB.WT    	Atlantic Gold Corp Wts                            	TSXV      
AGC       	Amarillo Gold Corp.                               	TSXV      
AGD       	Antioquia Gold Inc.                               	TSXV      
AGG       	African Gold Group Inc.                           	TSXV      
AGH.H     	Canadian Silver Hunter Inc                        	TSXV      
AGL       	Aguila American Gold Ltd                          	TSXV      
AGLD      	Austral Gold Limited                              	TSXV      
AGM       	Aldridge Minerals Inc.                            	TSXV      
AGO       	Aurcrest Gold Inc                                 	TSXV      
AGX.H     	Amador Gold Corp                                  	TSXV      
AGY.H     	Atom Energy Inc                                   	TSXV      
AGZ       	Ashanti Gold Corp                                 	TSXV      
AHI       	Agility Health Inc                                	TSXV      
AHP       	Allied Hotel Properties Inc                       	TSXV      
AHR       	Amarc Resources Ltd.                              	TSXV      
AHS       	Alta Natural Herbs and S                          	TSXV      
AHU       	Arctic Hunter Energy Inc                          	TSXV      
AII       	Almonty Industries Inc                            	TSXV      
AIN.H     	Aintree Resources Inc                             	TSXV      
AIS.H     	Ais Resources Limited                             	TSXV      
AIX       	Alix Resources Corp.                              	TSXV      
AKH       	Alaska Hydro Corporation                          	TSXV      
AKR       	Ackroo Inc                                        	TSXV      
AL        	Alx Uranium Corp                                  	TSXV      
ALD       	Aldever Resources Inc                             	TSXV      
ALG       	Algold Resources Ltd                              	TSXV      
ALI       	Altitude Resources Inc                            	TSXV      
ALK.H     	Alkali3 Resources Inc                             	TSXV      
ALL.H     	Allante Resources Ltd                             	TSXV      
ALT       	Alturas Minerals Corp.                            	TSXV      
ALTA      	Altamira Gold Corp.                               	TSXV      
ALV       	Alvopetro Energy Ltd                              	TSXV      
ALY       	Analytixinsight Inc                               	TSXV      
ALZ       	Aldershot Resources Ltd                           	TSXV      
AM.H      	Automodular Corporation                           	TSXV      
AME       	Abacus Mining & Explorat                          	TSXV      
AMK       	American Creek Resources                          	TSXV      
AML       	Argus Metals Corp.                                	TSXV      
AMO       	Altan Rio Minerals Limit                          	TSXV      
AMT.H     	Amato Exploration Ltd.                            	TSXV      
AMX       	AMEX Exploration Inc                              	TSXV      
AMY       	American Manganese Inc.                           	TSXV      
AMZ       	Almadex Minerals Limited                          	TSXV      
AN        	Arena Minerals Inc                                	TSXV      
ANB       	Anglo-Bomarc Mines Ltd                            	TSXV      
ANE       	Altan Nevada Minerals Li                          	TSXV      
ANF       	Anfield Gold Corp.                                	TSXV      
ANG       	Angel Gold Corp                                   	TSXV      
ANK       	Angkor Gold Corp                                  	TSXV      
ANL.H     	Atlantic Industrial Minerals Inc.                 	TSXV      
ANTL      	Antler Gold Inc.                                  	TSXV      
ANZ       	Alianza Minerals Ltd                              	TSXV      
AOT       	Ascot Resources Ltd.                              	TSXV      
APC       	Advanced Proteome Therap                          	TSXV      
APE       	Apogee Silver Ltd                                 	TSXV      
APL       	Appulse Corp.                                     	TSXV      
APN       	Altiplano Minerals Ltd                            	TSXV      
APV       	Apivio Systems Inc                                	TSXV      
APX       	Apex Resources Inc                                	TSXV      
AQ        	African Queen Mines Ltd.                          	TSXV      
AQS       	Aequus Pharmaceuticals I                          	TSXV      
ARA       	Anconia Resources Corp                            	TSXV      
ARCH      	Arch Biopartners Inc                              	TSXV      
ARD       	Armada Data Corp.                                 	TSXV      
ARH       	Altima Resources Ltd.                             	TSXV      
ARK.H     	Archer Petroleum Corp                             	TSXV      
ART       	Arht Media Inc                                    	TSXV      
ARU       	Aurania Resources Ltd                             	TSXV      
ARY       	Anfield Resources Inc                             	TSXV      
ASG       	Aurora Spine Corporation                          	TSXV      
ASI       	Ashanti Sankofa Inc.                              	TSXV      
ASL       	Argentum Silver Corp.                             	TSXV      
ASM       	Avino Silver and Gold Mi                          	TSXV      
ASM.WT    	Avino Silver and Gold Mines Ltd Wts               	TSXV      
ASN       	Asian Mineral Res Ltd.                            	TSXV      
ASND      	Ascendant Resources Inc.                          	TSXV      
ASND.WT   	Ascendant Resources Inc Wts                       	TSXV      
ASQ       	Astorius Resources Ltd.                           	TSXV      
AT        	Acuityads Holdings Inc                            	TSXV      
ATC       	Atac Resources Ltd.                               	TSXV      
ATE       	Antibe Therapeutics Inc                           	TSXV      
ATG       	Atlanta Gold Inc.                                 	TSXV      
ATI       	Altai Resources Inc                               	TSXV      
ATM       	Atacama Pacific Gold Cor                          	TSXV      
ATU       	Altura Energy Inc                                 	TSXV      
ATV       	Alto Ventures Ltd                                 	TSXV      
ATW       	Atmanco Inc                                       	TSXV      
ATY       	Atico Mining Corporation                          	TSXV      
AU        	Aurion Resources Ltd.                             	TSXV      
AUL       	Aurelius Minerals Inc.                            	TSXV      
AUN       	Aurcana Corporation                               	TSXV      
AUS.H     	Austpro Energy Corporation                        	TSXV      
AUT       	Austin Resources Ltd                              	TSXV      
AUU       	Aura Silver Resources In                          	TSXV      
AUX       	Auramex Resource Corp                             	TSXV      
AVA       	Aurvista Gold Corporatio                          	TSXV      
AVC       	American Vanadium Corp.                           	TSXV      
AVE       	Aveda Transport and Ener                          	TSXV      
AVN       	Avanti Energy Inc                                 	TSXV      
AVU       	Avrupa Minerals Ltd.                              	TSXV      
AVX       	Altair Gold Inc                                   	TSXV      
AWE       	Thunderstruck Resources                           	TSXV      
AWI       	Advent-Awi Holdings Inc.                          	TSXV      
AWS       	Arrowstar Resources Ltd                           	TSXV      
AXE       	Acceleware Ltd                                    	TSXV      
AXIS      	Axis Auto Finance Inc                             	TSXV      
AXM       	Axmin Inc                                         	TSXV      
AXQ       	Axe Exploration Inc                               	TSXV      
AXV       	Axion Ventures Inc.                               	TSXV      
AZM       	Azimut Exploration Inc.                           	TSXV      
AZN.H     	Arcturus Ventures Inc                             	TSXV      
AZR       	Azarga Metals Corp                                	TSXV      
AZS       	Arizona Silver Exploration Inc                    	TSXV      
AZT       	Aztec Minerals Corp                               	TSXV      
AZX       	Alexandria Minerals Corp                          	TSXV      
B         	Bcm Resources Corporatio                          	TSXV      
BAL.H     	Balto Resources Ltd.                              	TSXV      
BAT       	Batero Gold Corp.                                 	TSXV      
BAV.H     	Bravern Ventures Ltd                              	TSXV      
BAY       	Aston Bay Holdings Ltd                            	TSXV      
BBB       	Brixton Metals Corporati                          	TSXV      
BBC.H     	Black Birch Capital Acq III Corp                  	TSXV      
BBI       	Blackbird Energy Inc                              	TSXV      
BBI.WT    	Blackbird Energy Inc Wts                          	TSXV      
BBLS      	Bow Energy Ltd.                                   	TSXV      
BBS.H     	Black Bull Resources Inc                          	TSXV      
BCF       	Builders Capital Mortgag                          	TSXV      
BCK       	Blind Creek Resources Lt                          	TSXV      
BCM       	Bear Creek Mining Corp.                           	TSXV      
BCN       	Bacanora Minerals Ltd                             	TSXV      
BCP       	Broome Capital Corp                               	TSXV      
BCR.H     	Bluerock Ventures Corp                            	TSXV      
BCT       	Briacell Therapeutics Co                          	TSXV      
BCU.H     	Bell Copper Corporation                           	TSXV      
BDG       	Black Dragon Gold Corp                            	TSXV      
BEA       	Belmont Resources Inc                             	TSXV      
BEAN      	Peekaboo Beans Inc                                	TSXV      
BEE       	Bee Vectoring Technologi                          	TSXV      
BEL       	Belvedere Resources Ltd.                          	TSXV      
BER       	BE Resources Inc.                                 	TSXV      
BEW       	Bewhere Holdings Inc                              	TSXV      
BEX       	Benton Resources Inc                              	TSXV      
BEY       	Blacksteel Energy Inc.                            	TSXV      
BFD       	Beaufield Resources Inc.                          	TSXV      
BFF       	Nevada Energy Metals Inc                          	TSXV      
BG        	Barisan Gold Corporation                          	TSXV      
BGA       	Bioneutra Global Corporation                      	TSXV      
BGD       	Bullion Gold Resources C                          	TSXV      
BGE       	Bison Gold Resources Inc                          	TSXV      
BGG       	Buccaneer Gold Corp                               	TSXV      
BGL       	Bandera Gold Ltd.                                 	TSXV      
BGM       	Barkerville Gold Mines L                          	TSXV      
BGS       	Baroyeca Gold and Silver                          	TSXV      
BHK       	Bhk Mining Corp.                                  	TSXV      
BHR       	Blackheath Resources Inc                          	TSXV      
BHS       	Bayhorse Silver Inc                               	TSXV      
BHT       	Braveheart Resources Inc                          	TSXV      
BHV       	Bellhaven Copper and Gol                          	TSXV      
BKD       	Breaking Data Corp                                	TSXV      
BKM       	Pacific Booker Minerals                           	TSXV      
BKR       	Berkwood Resources Ltd                            	TSXV      
BLC.P     	Black Lion Capital Corp                           	TSXV      
BLM       	Blumetric Environmental                           	TSXV      
BLN       	Blackline Safety Corp.                            	TSXV      
BLR       	Blackhawk Resource Corp                           	TSXV      
BLS       	Black Sea Copper and Gold Corp                    	TSXV      
BM        	Bc Moly Ltd                                       	TSXV      
BME       	Barsele Minerals Corp                             	TSXV      
BMG       	Battle Mountain Gold Inc                          	TSXV      
BMK       	Macdonald Mines Expl Ltd                          	TSXV      
BML       	Barker Minerals Ltd                               	TSXV      
BMM       	Black Mammoth Metals Corp                         	TSXV      
BMR.H     	Bradmer Pharmaceuticals                           	TSXV      
BN.H      	Bluenose Gold Corp                                	TSXV      
BNR       	Brionor Resources Inc.                            	TSXV      
BOC       	Blueocean Nutrasciences                           	TSXV      
BOL       	Bold Ventures Inc.                                	TSXV      
BOR       	Border Petroleum Limited                          	TSXV      
BOW       	Bowmore Exploration Ltd.                          	TSXV      
BP.H      	Backstageplay Inc                                 	TSXV      
BPE       	Brightpath Early Learnin                          	TSXV      
BPLI      	Bluedrop Performance Learning Inc.                	TSXV      
BQE       	Bqe Water Inc.                                    	TSXV      
BRC       	Blackrock Gold Corp                               	TSXV      
BRD       	Broadway Gold Mining Ltd                          	TSXV      
BRG.H     	Brigadier Gold Limited                            	TSXV      
BRL       	Bearclaw Capital Corp                             	TSXV      
BRM       	Biorem Inc.                                       	TSXV      
BRN.PR.A  	Brookfield Investments C                          	TSXV      
BRO.H     	Barksdale Capital Corp                            	TSXV      
BRS       	Brs Resources Ltd                                 	TSXV      
BRU       	Brunswick Resources Inc                           	TSXV      
BRZ       	Bearing Lithium Corp.                             	TSXV      
BSH       	Bayshore Petroleum Corp.                          	TSXV      
BSI       	Blue Sky Energy Inc                               	TSXV      
BSK       	Blue Sky Uranium Corp                             	TSXV      
BTI       	Bioasis Technologies Inc                          	TSXV      
BTL       	Btl Group Ltd                                     	TSXV      
BTR       	Bonterra Resources Inc.                           	TSXV      
BTRU      	Betteru Education Corp                            	TSXV      
BTT       	Bitterroot Resources Ltd                          	TSXV      
BTV       	Bluerush Media Group Cor                          	TSXV      
BUD       	Satori Resources Inc                              	TSXV      
BUF       	Buffalo Coal Corp                                 	TSXV      
BUFF.P    	Buffalo Capital Inc                               	TSXV      
BUS       	Grande West Transportati                          	TSXV      
BVA       	Bravada Gold Corporation                          	TSXV      
BVO       	Bevo Agro Inc.                                    	TSXV      
BWR       	Black Widow Resources In                          	TSXV      
BXR       	Blue River Resources Ltd                          	TSXV      
BYM.H     	Baymount Incorporated                             	TSXV      
BYN       	Banyan Gold Corp                                  	TSXV      
BYU       	Bayswater Uranium Corpor                          	TSXV      
BZ        	Benz Mining Corp                                  	TSXV      
BZ.H      	Benz Mining Corp                                  	TSXV      
CAD       	Colonial Coal Internatio                          	TSXV      
CAF       	Canaf Group Inc.                                  	TSXV      
CAK.H     	Capricorn Business Acquisitions Inc               	TSXV      
CANB.P    	Canadabis Capital Inc                             	TSXV      
CAND      	Candelaria Mining Corp                            	TSXV      
CANX      	Canex Metals Inc.                                 	TSXV      
CAP       	Castle Peak Mining Ltd                            	TSXV      
CAT       	Chimata Gold Corp                                 	TSXV      
CAU.H     	China Goldcorp Ltd                                	TSXV      
CAV       	Camrova Resources Inc                             	TSXV      
CAY       	Cache Exploration Inc.                            	TSXV      
CBA       	Champion Bear Res Ltd                             	TSXV      
CBE       	Cabo Drilling Corp.                               	TSXV      
CBG       	Chibougamau Independent                           	TSXV      
CBI       	Colibri Resource Corp.                            	TSXV      
CBM.H     	Cbd Med Research Corp                             	TSXV      
CBS       	Bard Ventures Ltd                                 	TSXV      
CBV       	Cobra Venture Corporatio                          	TSXV      
CBW       	Cannabis Wheaton Income Corp.                     	TSXV      
CBX       	Cortex Business Solution                          	TSXV      
CCB       	Canada Carbon Inc                                 	TSXV      
CCC       	Cornerstone Metals Inc                            	TSXV      
CCD       	Cascadero Copper Corpora                          	TSXV      
CCE       	Commerce Resources Corp.                          	TSXV      
CCK       	Canada Coal Inc                                   	TSXV      
CD        	Cantex Mine Development                           	TSXV      
CDA       	Canuc Resources Corporation                       	TSXV      
CDB       	Cordoba Minerals Corp                             	TSXV      
CDC       	Cadillac Ventures Inc.                            	TSXV      
CDG       	Candente Gold Corp                                	TSXV      
CDN       	Canadream Corporation                             	TSXV      
CDU       	Cardero Resource Corp                             	TSXV      
CE        	Canada Energy Partners I                          	TSXV      
CEA       	Cerus Energy Group Ltd                            	TSXV      
CEB       	Ceiba Energy Services In                          	TSXV      
CEI       	Crystal Exploration Inc                           	TSXV      
CEL.H     	Columbus Energy Limited                           	TSXV      
CEM       	Constantine Metal Resour                          	TSXV      
CEN       	Claren Energy Corp                                	TSXV      
CEP       	Cliffside Capital Ltd                             	TSXV      
CFL       	Cerf Incorporated                                 	TSXV      
CFM       	Confederation Minerals L                          	TSXV      
CFY       	Changfeng Energy Inc.                             	TSXV      
CGD       	Carlin Gold Corp.                                 	TSXV      
CGE       	Corex Gold Corp                                   	TSXV      
CGM       	California Gold Mining I                          	TSXV      
CGP       	Cornerstone Capital Reso                          	TSXV      
CGP.WT.S  	Cornerstone Capital Res Inc Wts                   	TSXV      
CHC       	Chc Student Housing Corp                          	TSXV      
CHN       	China Education Resource                          	TSXV      
CHQ       	Carrus Capital Corporati                          	TSXV      
CHY.H     	Cypress Hills Resource C                          	TSXV      
CII.H     	Corporate Catalyst Acquisition Inc                	TSXV      
CIN       	Canadian Intl Minerals I                          	TSXV      
CIO       	Central Iron Ore Limited                          	TSXV      
CIP.H     	Canadian International P                          	TSXV      
CIT.H     	Cr Capital Corp                                   	TSXV      
CJC       	Canada Strategic Metals                           	TSXV      
CKC.H     	Cricket Resources Inc                             	TSXV      
CKG       	Chesapeake Gold Corp.                             	TSXV      
CKK       	Cordy Oilfield Services                           	TSXV      
CKR       	Caribou King Resources L                          	TSXV      
CKZ.H     	Caspian Energy Inc                                	TSXV      
CLB       	Colombia Crest Gold Corp                          	TSXV      
CLE       	Clean Commodities Corp                            	TSXV      
CLH       	Coral Gold Resources Ltd                          	TSXV      
CLI       	Clearford Water Systems                           	TSXV      
CLM       	Crystal Lake Mining Corp                          	TSXV      
CLV       	Canoe Mining Ventures Co                          	TSXV      
CLY       	Clarocity Corporation                             	TSXV      
CLZ       	Canasil Resources Inc.                            	TSXV      
CMB       	Cmc Metals Ltd.                                   	TSXV      
CMD       	Commander Resources Ltd                           	TSXV      
CMI       	C-Com Satellite Systems                           	TSXV      
CML       	Canickel Mining Limited                           	TSXV      
CMM       	Canabo Medical Inc                                	TSXV      
CMU       	Comet Industries Ltd.                             	TSXV      
CMV       	China Minerals Mining Co                          	TSXV      
CMX       	Chilean Metals Inc                                	TSXV      
CN        	Condor Resources Inc.                             	TSXV      
CNC       	Canyon Copper Corp                                	TSXV      
CNH       	Crownia Holdings Ltd                              	TSXV      
CNO       	California Nanotechnolog                          	TSXV      
CNS       	Contagious Gaming Inc                             	TSXV      
CNX       	Callinex Mines Inc                                	TSXV      
CNZ       	Canadian Zeolite Corp                             	TSXV      
COB.U     	Cohbar Inc                                        	TSXV      
COL       	Copper North Mining Corp                          	TSXV      
COO       	Offsetters Climate Solut                          	TSXV      
COQ       	Rooster Energy Ltd                                	TSXV      
COR       	Camino Minerals Corporat                          	TSXV      
CORE      	Canadian Orebodies Inc                            	TSXV      
COT       	Critical Outcome Technol                          	TSXV      
COV       	Covalon Technologies Ltd                          	TSXV      
CPC       	Canadian Platinum Corp                            	TSXV      
CPE.H     	Capital Pro Egaux Inc                             	TSXV      
CPL       	Copper Lake Resources Lt                          	TSXV      
CPM       	Crystal Peak Minerals In                          	TSXV      
CPO       	Cobalt Power Group Inc                            	TSXV      
CPS       	Claim Post Resources Inc                          	TSXV      
CPV       	Copper Creek Gold Corp.                           	TSXV      
CQR       	Conquest Resources Ltd.                           	TSXV      
CQV.H     	Canadian Imperial Venture Corp                    	TSXV      
CRB       	Cariboo Rose Resources L                          	TSXV      
CRD.H     	Coronado Resources Ltd                            	TSXV      
CRE       	Critical Elements Corpor                          	TSXV      
CRF       	Coronet Metals Inc                                	TSXV      
CRO       	Canadian Arrow Mines Ltd                          	TSXV      
CRS       	Cardiff Energy Corp                               	TSXV      
CRU       	Cameo Resources Corp                              	TSXV      
CRV       	Cresval Capital Corp.                             	TSXV      
CRX.H     	Cerro Mining Corp                                 	TSXV      
CSC       	Canex Energy Corp                                 	TSXV      
CSK       	Cobaltech Mining Inc                              	TSXV      
CSL       	Comstock Metals Ltd                               	TSXV      
CSO       	Corsa Coal Corp                                   	TSXV      
CSPG      	Alabama Graphite Corp                             	TSXV      
CSQ       	Canamex Resources Corp                            	TSXV      
CSR       	Castle Silver Resources Inc                       	TSXV      
CST       	Co2 Solutions Inc.                                	TSXV      
CSV.H     	Caracara Silver Inc                               	TSXV      
CSX       	Clean Seed Capital Group                          	TSXV      
CT        	Centenara Mining Corpora                          	TSXV      
CTD.H     	Courtland Capital Inc                             	TSXV      
CTI       	Caiterra International E                          	TSXV      
CTM       	Canterra Minerals Corpor                          	TSXV      
CTN       	Centurion Minerals Ltd.                           	TSXV      
CTO       	Circa Enterprises Inc.                            	TSXV      
CTZ       	Cencotech Inc.                                    	TSXV      
CUC       	Carube Copper Corp                                	TSXV      
CUI       	Currie Rose Resources In                          	TSXV      
CUO       	Copper One Inc.                                   	TSXV      
CUU       	Copper Fox Minerals Inc.                          	TSXV      
CUV       	Cuba Ventures Corp                                	TSXV      
CUZ       	Cruz Cobalt Corp.                                 	TSXV      
CV.H      	Chantrell Ventures Corp.                          	TSXV      
CVA       	Cava Resources Inc                                	TSXV      
CVB.H     	Compass Gold Corporation                          	TSXV      
CVM       	Cvr Medical Corp                                  	TSXV      
CVR       	CDN Oil Recovery & Remed                          	TSXV      
CVV       	Canalaska Uranium Ltd                             	TSXV      
CVX       	Cematrix Corporation                              	TSXV      
CWC       	Cwc Energy Services Corp                          	TSXV      
CWM       	Crown Mining Corp                                 	TSXV      
CWQ.H     	Curlew Lake Resources Inc                         	TSXV      
CWS.H     	Cons Westview Res Corp                            	TSXV      
CWV       	Crown Point Energy Inc                            	TSXV      
CXB       	Calibre Mining Corp.                              	TSXV      
CXM       	Carmax Mining Corp                                	TSXV      
CXO       	Colorado Resources Ltd                            	TSXV      
CXV       	Convalo Health Internati                          	TSXV      
CYF       	Canyon Creek Food Co Ltd                          	TSXV      
CYL       	Ceylon Graphite Corp                              	TSXV      
CYM       	Cymat Technologies Ltd                            	TSXV      
CYP       	Cypress Development Corp                          	TSXV      
CYX       	Calyx Bio-Venture Inc.                            	TSXV      
CZH       	Crazy Horse Resources In                          	TSXV      
CZO       	Ceapro Inc                                        	TSXV      
CZX       	Canada Zinc Metals Corp.                          	TSXV      
CZY       	Caza Gold Corp.                                   	TSXV      
DAL       	Dalmac Energy Inc.                                	TSXV      
DAN       	Arianne Phosphate Inc                             	TSXV      
DAP.U     	Xpel Technologies Corp                            	TSXV      
DAR       	Darelle Online Solutions Inc                      	TSXV      
DAU       	Desert Gold Ventures Inc                          	TSXV      
DBD.H     	Darien Business Development Corp                  	TSXV      
DBL       	Darnley Bay Resources Li                          	TSXV      
DBV       	Doubleview Capital Corp                           	TSXV      
DCY       	Discovery-Corp. Enterpri                          	TSXV      
DE        	Decisive Dividend Corpor                          	TSXV      
DEC       	Decade Resources Ltd.                             	TSXV      
DEF       	Defiance Silver Corp                              	TSXV      
DEV.H     	Ct Developers Ltd                                 	TSXV      
DFI       	Diamond Field In J                                	TSXV      
DFS       	Global Daily Fantasy Sports Inc                   	TSXV      
DGO       	Durango Resources Inc                             	TSXV      
DHR       	Discovery Harbour Resour                          	TSXV      
DIA       	Margaret Lake Diamonds I                          	TSXV      
DJI       	Dajin Resources Corp.                             	TSXV      
DLS       	Dealnet Capital Corp                              	TSXV      
DLV.H     	Dv Resources Ltd                                  	TSXV      
DMA       	Diamedica Inc.                                    	TSXV      
DMC.H     	Dataminers Capital Corp                           	TSXV      
DMG.H     	Dmd Digital Health Conne                          	TSXV      
DMI       	Diamcor Mining Inc.                               	TSXV      
DMM       	Dynasty Metals and Mining Inc                     	TSXV      
DMR       	Damara Gold Corp                                  	TSXV      
DNX       	Dynex Power Inc.                                  	TSXV      
DOS       	Dios Exploration Inc                              	TSXV      
DOX       	Dorex Minerals Inc.                               	TSXV      
DPH       	Duncan Park Holdings Cor                          	TSXV      
DRV       	Duran Ventures Inc.                               	TSXV      
DSF       	Dusolo Fertilizers Inc                            	TSXV      
DSM       	Deep South Resources Inc                          	TSXV      
DSR       	Desert Star Resources Lt                          	TSXV      
DSY       	Destiny Media Technologi                          	TSXV      
DUG       	Distinct Infrastructure                           	TSXV      
DV        	Dolly Varden Silver Corp                          	TSXV      
DVA       	0Nedelivra Corp                                   	TSXV      
DVC.H     	Devin Energy Corporation                          	TSXV      
DVG       	Divergent Energy Service                          	TSXV      
DVI       	Dunnedin Ventures Inc                             	TSXV      
DVT       	Divestco Inc.                                     	TSXV      
DWS       	Diamond Estates Wines An                          	TSXV      
DXA       	Doxa Energy Ltd.                                  	TSXV      
DXD       	3D Signatures Inc                                 	TSXV      
DYA       	Dynacert Inc                                      	TSXV      
DYG       	Dynasty Gold Corp.                                	TSXV      
EAM       	East Africa Metals Inc                            	TSXV      
EAS       	East Asia Minerals Corp.                          	TSXV      
EBM       	Eastwood Bio Medical Can                          	TSXV      
EBN       	Epicore Bionetworks Inc.                          	TSXV      
EBY       	Emerald Bay Energy Inc.                           	TSXV      
ECC       	Ethos Gold Corp                                   	TSXV      
ECR       	Cartier Resources Inc.                            	TSXV      
ECT       	Ellipsiz Communications Ltd                       	TSXV      
ECX.H     	Eastcoal Inc                                      	TSXV      
EDG       	Endurance Gold Corp.                              	TSXV      
EDW.H     	Edgewater Exploration Ltd                         	TSXV      
EEL       	Esrey Energy Ltd                                  	TSXV      
EEV       	E-Energy Ventures Inc.                            	TSXV      
EGA       	Eagle Graphite Incorpora                          	TSXV      
EGD       	Energold Drilling Corp.                           	TSXV      
EGM       	Engold Mines Ltd                                  	TSXV      
EGT       	Eguana Technologies Inc                           	TSXV      
EHT       	Enerdynamic Hybrid Tech                           	TSXV      
EIL       	Empire Industries Ltd.                            	TSXV      
EKG       	Cardiocomm Solutions In                           	TSXV      
EL        	Engagement Labs Inc                               	TSXV      
ELC       	Elysee Development Corp                           	TSXV      
ELM       	Element Lifestyle Retirement Inc                  	TSXV      
ELN       	El Nino Ventures Inc                              	TSXV      
ELO       	Eloro Resources Ltd.                              	TSXV      
ELT       	Electra Stone Ltd.                                	TSXV      
ELY       	Ely Gold & Minerals Inc.                          	TSXV      
EMC       	Emblem Corp                                       	TSXV      
EMC.WT    	Emblem Corp Wts                                   	TSXV      
EMH       	Emerald Health Therapeut                          	TSXV      
EMO       	Emerita Resources Corp                            	TSXV      
EMR       	Emgold Mining Corporatio                          	TSXV      
EMS.H     	Element 79 Capital Inc                            	TSXV      
EMX       	Eurasian Minerals Inc                             	TSXV      
ENA       	Enablence Technologies I                          	TSXV      
ENER      	Enerspar Corp                                     	TSXV      
ENG       	Energulf Resources Inc.                           	TSXV      
ENP       	Enpar Tech Inc.                                   	TSXV      
ENW       	Enwave Corp                                       	TSXV      
EOG       	Eco Atlantic Oil and Gas                          	TSXV      
EP        	Empire Metals Corp.                               	TSXV      
EPL       	Eagle Plains Resources L                          	TSXV      
EPO       	Encanto Potash Corp.                              	TSXV      
EQ        	Eq Inc                                            	TSXV      
EQG       	Eqube Gaming Limited                              	TSXV      
ERA       	Elcora Resources Corp                             	TSXV      
ERC       	Eros Resources Corp                               	TSXV      
ERE       	European Commercial Real Estate Ltd               	TSXV      
ERE.UN    	European Commercial Real Estate Investment Trust  	TSXV      
ERG       	Ergoresearch Ltd                                  	TSXV      
ERL.H     	Earl Resources Limited                            	TSXV      
ERN.H     	Earny Resources Ltd                               	TSXV      
ERX       	Era Resources Inc                                 	TSXV      
ES        	Eight Solutions Inc.                              	TSXV      
ESK       	Eskay Mining Corp.                                	TSXV      
ESS       	Esstra Industries Inc.                            	TSXV      
ESU       	Eestor Corporation                                	TSXV      
ESV       	Esi Environmental Sensor                          	TSXV      
ESX       	Essex Minerals Inc                                	TSXV      
ETF       	Eastfield Resources Ltd.                          	TSXV      
EU        	Encore Energy Corp                                	TSXV      
EUK       	Eureka Resources Inc.                             	TSXV      
EUO       	Eurocontrol Technics Gro                          	TSXV      
EV        	Erin Ventures Inc.                                	TSXV      
EVM       	Evrim Resources Corp                              	TSXV      
EVR       	Everton Resources Inc.                            	TSXV      
EW        	East West Petroleum Corp                          	TSXV      
EWK       	Earthworks Industries In                          	TSXV      
EWS       	Environment Waste Intl                            	TSXV      
EXC       	Essex Angel Capital Inc                           	TSXV      
EXG       	Exgen Resources Inc                               	TSXV      
EXS       	Explor Resources Inc.                             	TSXV      
EXX       	Equitorial Exploration C                          	TSXV      
EYC       	Eyecarrot Innovations Co                          	TSXV      
F         	Fiore Exploration Ltd                             	TSXV      
FA        	Fountain Asset Corp                               	TSXV      
FAM       	Family Memorials Inc.                             	TSXV      
FAN       	Gaming Nation Inc                                 	TSXV      
FBF       	Fab-Form Industries Ltd.                          	TSXV      
FBX       	First Bauxite Corporatio                          	TSXV      
FCA.U     	Firm Capital American Realty Part Corp            	TSXV      
FCC       	First Cobalt Corp                                 	TSXV      
FCD.UN    	Firm Capital Property TR                          	TSXV      
FCF       	Fcf Capital Inc                                   	TSXV      
FCV       	Focus Ventures Ltd.                               	TSXV      
FDC       	Forum Uranium Corp                                	TSXV      
FDI       	Findev Inc                                        	TSXV      
FE        	First Energy Metals Limited                       	TSXV      
FEN       	Forent Energy Ltd.                                	TSXV      
FEO       	Oceanic Iron Ore Corp                             	TSXV      
FEX       	Fjordland Exploration In                          	TSXV      
FF        	First Mining Finance Cor                          	TSXV      
FG        	Falcon Gold Corp                                  	TSXV      
FGC       	Frontline Gold Corporati                          	TSXV      
FGD       	First Global Data Limite                          	TSXV      
FGF       	Capital Dgmc Inc                                  	TSXV      
FGH       	First Growth Holdings Lt                          	TSXV      
FIL       	Filo Mining Corp                                  	TSXV      
FIX       	Firebird Resources Inc                            	TSXV      
FL        	Frontier Lithium Inc                              	TSXV      
FLGC      	Fanlogic Interactive Inc.                         	TSXV      
FLX       	Fieldex Exploration Inc.                          	TSXV      
FLY       	Flyht Aerospace Solution                          	TSXV      
FMG       	First Mexican Gold Corp                           	TSXV      
FMM       	Full Metal Minerals Ltd                           	TSXV      
FMR       	Fairmont Resources Inc                            	TSXV      
FMS       	Focus Graphite Inc                                	TSXV      
FNC       	Fancamp Exploration Ltd.                          	TSXV      
FNR       	49 North Resources Inc.                           	TSXV      
FO        	Falcon Oil & Gas Ltd                              	TSXV      
FOM       	Foran Mining Corporation                          	TSXV      
FOR       	Fortune Bay Corp                                  	TSXV      
FP        	Fp Newspapers Inc                                 	TSXV      
FPC       	Falco Resources Ltd                               	TSXV      
FPX       	First Point Minerals Corp                         	TSXV      
FRI       	Freeport Resources Inc.                           	TSXV      
FRK       	Front Range Resources Ltd                         	TSXV      
FRN       	Feronia Inc                                       	TSXV      
FSW       	Fireswirl  Technologies                           	TSXV      
FTI       	Fti Foodtech Internation                          	TSXV      
FTJ.H     	Fort ST James Nickel Corp                         	TSXV      
FTR       	Firesteel Resources Inc                           	TSXV      
FUR       	Fura GEMS Inc.                                    	TSXV      
FUU       	Fission 3.0 Corp                                  	TSXV      
FV        	Firestone Ventures Inc                            	TSXV      
FYL       	Finlay Minerals Ltd.                              	TSXV      
GAL       	Galantas Gold Corp.                               	TSXV      
GAME      	Millennial Esports Corp                           	TSXV      
GAR       	Green Arrow Resources In                          	TSXV      
GAZ.UN    	Fronsac Capital REIT Uni                          	TSXV      
GB        	Ginger Beef Corp.                                 	TSXV      
GBE       	Goldbelt Empires Limited                          	TSXV      
GBL       	Gb Minerals Ltd                                   	TSXV      
GBR       	Great Bear Resources Ltd                          	TSXV      
GCC.H     	Golden Cariboo Resources                          	TSXV      
GCN       	Goldcliff Resources Corp                          	TSXV      
GCR       	Gespeg Copper Resources                           	TSXV      
GCX       	Granite Creek Gold Ltd                            	TSXV      
GDM       	Goldstar Minerals Inc                             	TSXV      
GDX       	Goldex Resources Corp                             	TSXV      
GEA.H     	Gold Ridge Exploration Corp                       	TSXV      
GEL       	Tangelo Games Corp                                	TSXV      
GEM       	Pele Mountain Resources                           	TSXV      
GEMC      	Global Energy Metals Corp                         	TSXV      
GER       	Glen Eagle Resources Inc                          	TSXV      
GFG       	Gfg Resources Inc                                 	TSXV      
GFK       	Gfk Resources                                     	TSXV      
GFL.H     	Gulfstream Acquisition 1 Corp                     	TSXV      
GFM.H     	Gfm Resources Ltd.                                	TSXV      
GFN.H     	Gold Finder Explorations Ltd                      	TSXV      
GG        	Galane Gold Ltd                                   	TSXV      
GGG       	Graphene 3D Lab Inc                               	TSXV      
GGI       	Garibaldi Resources Corp                          	TSXV      
GGL       	Ggl Resources Corp.                               	TSXV      
GGM       	Granada Gold Mine Inc.                            	TSXV      
GGS       	Golden Secret Ventures L                          	TSXV      
GGX       	Ggx Gold Corp                                     	TSXV      
GHE.P     	Gold Horn Intl Enterprises Group Ltd              	TSXV      
GHR.H     	Golden Harp Resources Inc                         	TSXV      
GI        	Gem International Resour                          	TSXV      
GIII      	Gen III Oil Corp.                                 	TSXV      
GIS       	Genesis Metals Corp                               	TSXV      
GIT       	Gitennes Exploration Inc                          	TSXV      
GIX       	Geologix Explorations In                          	TSXV      
GKX       	Gemini Corporation                                	TSXV      
GLB       	Goldbank Mining Corporat                          	TSXV      
GLD       	Goldon Resources Ltd                              	TSXV      
GLI       	Glacier Lake Resources Inc                        	TSXV      
GLK       	Great Lakes Graphite Inc                          	TSXV      
GLW       	Galway Gold Inc                                   	TSXV      
GMA       	Geomega Resources Inc                             	TSXV      
GMN       	Gobimin Inc                                       	TSXV      
GMV       	Gmv Minerals Inc.                                 	TSXV      
GNC       	Gainey Capital Corp                               	TSXV      
GNF       	Greenfields Petroleum Co                          	TSXV      
GNG       	Golden Goliath Resources                          	TSXV      
GNH       	Golden Hope Mines Ltd                             	TSXV      
GNT       	Gentor Resources Inc                              	TSXV      
GOE       	Goldeneye Resources Corp                          	TSXV      
GOG       	Golden Tag Resources Ltd                          	TSXV      
GOK       	Ginsms Inc.                                       	TSXV      
GOLD      	Goldmining Inc.                                   	TSXV      
GOLD.WT   	Goldmining Inc Wts                                	TSXV      
GOM       	Golden Dawn Minerals Inc                          	TSXV      
GOP       	Gourmet Ocean Products I                          	TSXV      
GP        	Golden Peak Minerals Inc                          	TSXV      
GPG       	Grande Portage Resources                          	TSXV      
GPH       	Graphite One Resources I                          	TSXV      
GPM       	Gpm Metals Inc                                    	TSXV      
GPV       	Greenpower Motor Company                          	TSXV      
GPY       	Golden Predator Mining C                          	TSXV      
GQ        	Great Quest Fertilizer L                          	TSXV      
GQC       	Goldquest Mining Corp.                            	TSXV      
GR        	Great Atlantic Resources                          	TSXV      
GRA.H     	Graniz Mondal Inc                                 	TSXV      
GRB       	Greenbriar Capital Corp                           	TSXV      
GRC       	Grenville Strategic Roya                          	TSXV      
GRC.DB    	Grenville Strategic Roya                          	TSXV      
GRG       	Golden Arrow Res Corp.                            	TSXV      
GRI       	Galore Resources Inc                              	TSXV      
GRK       	Gray Rock Resources Ltd.                          	TSXV      
GRO       	Growmax Resources Corp                            	TSXV      
GRR       	Golden Reign Resources L                          	TSXV      
GRV       	Gold Reach Resources Ltd                          	TSXV      
GRX.H     	Greenshield Explorations                          	TSXV      
GRZ       	Gold Reserve Inc                                  	TSXV      
GSA       	Groundstar Resources Ltd                          	TSXV      
GSD       	Devonian Health Group Inc                         	TSXV      
GSH       	Golden Share Mining Corp                          	TSXV      
GSI       	Gatekeeper Systems Inc                            	TSXV      
GSP       	Gensource Potash Corpora                          	TSXV      
GSR       	Goldstrike Resources Ltd                          	TSXV      
GSS       	Gossan Resources Limited                          	TSXV      
GSV       	Gold Standard Ventures C                          	TSXV      
GSW       	Green Swan Captial Corp                           	TSXV      
GSX.H     	Goldstream Minerals Inc                           	TSXV      
GTA       	Gta Resources and Mining                          	TSXV      
GTB       	Greatbanks Resources Ltd                          	TSXV      
GTC       	Getty Copper Inc.                                 	TSXV      
GTG       	Great Thunder Gold Corp                           	TSXV      
GTT       	GT Gold Corp                                      	TSXV      
GUF       	Gulf & Pacific Equities                           	TSXV      
GUG       	Gungnir Resources Inc                             	TSXV      
GUN       	Gunpoint Exploration Ltd                          	TSXV      
GV        	Guerrero Ventures Inc                             	TSXV      
GVG       	Grenville Gold Corp.                              	TSXV      
GVR       	Grosvenor Resources Corporation                   	TSXV      
GVY       	Green Valley Mine Incorp                          	TSXV      
GWA       	Gowest Gold Ltd                                   	TSXV      
GWM       	Galway Metals Inc                                 	TSXV      
GXL       	Galileo Exploration Ltd                           	TSXV      
GXM       	Geodex Minerals Ltd                               	TSXV      
GXR       	Georox  Resources Inc.                            	TSXV      
GXS       	Goldsource Mines Inc                              	TSXV      
GXU       	Goviex Uranium Inc                                	TSXV      
GYA       	Guyana Goldstrike Inc                             	TSXV      
GZD       	Grizzly Discoveries Inc.                          	TSXV      
GZZ       	Golden Valley Mines Ltd.                          	TSXV      
HAN       	Hannan Metals Ltd                                 	TSXV      
HAW.P     	Haw Capital Corp                                  	TSXV      
HBE       	Hornby Bay Mineral Explo                          	TSXV      
HBK       	Highbank Resources Ltd.                           	TSXV      
HEC       	Handa Copper Corporation                          	TSXV      
HEI       	Huntington Exploration I                          	TSXV      
HEM       	Hemostemix Inc                                    	TSXV      
HEMP      	Hempco Food and Fiber Inc                         	TSXV      
HEO       	H2O Innovation Inc.                               	TSXV      
HFC       	Hampton Financial Corporation                     	TSXV      
HGO       	Hawkeye Gold and Diamond                          	TSXV      
HI        	Highland Copper Company                           	TSXV      
HIT       	Hit Technologies Inc                              	TSXV      
HJI       	Helijet International In                          	TSXV      
HME       	Hemisphere Energy Corpor                          	TSXV      
HMI       	Hinterland Metals Inc.                            	TSXV      
HMT       	Halmont Properties Corp                           	TSXV      
HMX       	Hunt Mining Corp.                                 	TSXV      
HNC       	Hard Creek Nickel Corpor                          	TSXV      
HOC       	Hunter Oil Corp                                   	TSXV      
HOIL      	Halio Energy Inc                                  	TSXV      
HOPE.P    	Hope Well Capital Corp                            	TSXV      
HPI       	Highbury Projects Inc.                            	TSXV      
HPL       	Horizon Petroleum Plc                             	TSXV      
HPQ       	Hpq Silicon Resources Inc                         	TSXV      
HPY       	Happy Creek Minerals Ltd                          	TSXV      
HRC       	Helio Res Corp.                                   	TSXV      
HRE       	Stans Energy Corp                                 	TSXV      
HRH       	Hillcrest Petroleum Ltd                           	TSXV      
HRL       	Hansa Resources Limited                           	TSXV      
HSC.P     	Harbour Star Capital Inc                          	TSXV      
HSI       	H Source Holdings Ltd                             	TSXV      
HTC       	Htc Purenergy Inc.                                	TSXV      
HTL       	Hamilton Thorne Ltd                               	TSXV      
HTR       	Heatherdale Resources Lt                          	TSXV      
HUD       	Hudson Resources Inc.                             	TSXV      
HVG       	Harvest Gold Corp                                 	TSXV      
HVST      	Harvest One Cannabis Inc                          	TSXV      
HWY       	Highway 50 Gold Corp                              	TSXV      
HXC       	Hfx Holding Corp                                  	TSXV      
IB        	Ibc Advanced Alloys Corp                          	TSXV      
IBC       	International Bethlehem                           	TSXV      
IBH       	International Barrier Te                          	TSXV      
IBT       	Ibex Technologies Inc.                            	TSXV      
IC        	International Corona Capital Corp.                	TSXV      
ICC       	Icc International Cannabis Corp                   	TSXV      
ICG       	Integra Gold Corp.                                	TSXV      
ICL       	Itasca Capital Ltd                                	TSXV      
ICM       	Iconic Minerals Ltd                               	TSXV      
ICO       	Ico Therapeutics Inc.                             	TSXV      
ID        	Identillect Technologies Corp                     	TSXV      
IDH.H     	Idg Holdings Inc.                                 	TSXV      
IDI       	Indico Resources Ltd.                             	TSXV      
IDL       	Imaging Dynamics Company                          	TSXV      
IDM       	Idm Mining Ltd                                    	TSXV      
IDW       	Id Watchdog Inc.                                  	TSXV      
IEI       	Imperial Equities Inc.                            	TSXV      
IES       	Intercept Energy Service                          	TSXV      
IEX.H     	Icon Exploration Inc                              	TSXV      
IFD       	Intrinsic4D Inc                                   	TSXV      
IFD.H     	Intrinsic4D Inc                                   	TSXV      
IFOS      	Itafos Inc.                                       	TSXV      
IFR       	International Frontier R                          	TSXV      
IFX       	Imaflex Inc                                       	TSXV      
IGC.H     	Igc Resources Inc                                 	TSXV      
IGO       	Independence Gold Corp                            	TSXV      
IGP       	Imperial Ginseng Product                          	TSXV      
IGX       	Intelgenx Technologies C                          	TSXV      
IKM       	Ikkuma Resources Corp                             	TSXV      
ILA       	Ilookabout Corp.                                  	TSXV      
ILC       	International Lithium Co                          	TSXV      
IMA       	I-Minerals Inc.                                   	TSXV      
IMEX      	Imex Systems Inc                                  	TSXV      
IMH       	Invictus MD Strategies Corp                       	TSXV      
IMI       	International Millennium Mining                   	TSXV      
IML       	Iberian Minerals Ltd                              	TSXV      
IMM       	Immunotec Inc.                                    	TSXV      
IMR       	Imetal Resources Inc                              	TSXV      
IMT       	International Montoro Re                          	TSXV      
INP       	Input Capital Corp                                	TSXV      
INX       	In-Touch Survey Systems                           	TSXV      
IO        	Inca One Gold Corp                                	TSXV      
IOG       	Ironhorse Oil & Gas Inc.                          	TSXV      
ION       	Alset Minerals Corp.                              	TSXV      
IOT       	Innovotech Inc.                                   	TSXV      
IOU       	Iou Financial Inc                                 	TSXV      
IPA       	Immunoprecise Antibodies Ltd                      	TSXV      
IPC       	Iplayco Corporation Ltd.                          	TSXV      
IPT       	Impact Silver Corp.                               	TSXV      
IQ        	Airiq Inc.                                        	TSXV      
IRC       	Ironside Resources Inc                            	TSXV      
IRI       	Iemr Resources Inc                                	TSXV      
IRO       	Inter-Rock Minerals Inc.                          	TSXV      
ISD       	Isign Media Solutions In                          	TSXV      
ISO       	Isoenergy Ltd                                     	TSXV      
ISS       	International Samuel Exploration Corp             	TSXV      
ITG       	Intact Gold Corp                                  	TSXV      
ITM       	Intema Solutions Inc                              	TSXV      
ITT       	Internet of Things Inc                            	TSXV      
IVF.H     	Invictus Financial Inc                            	TSXV      
IVI       	Ivrnet Inc.                                       	TSXV      
IVS       	Inventus Mining Corp                              	TSXV      
IVX       	Inventronics Limited                              	TSXV      
IXI       	Indigo Exploration Inc.                           	TSXV      
IZN       	Inzinc Mining Ltd                                 	TSXV      
JAX       	Jaxon Minerals Inc.                               	TSXV      
JCO       	Jericho Oil Corporation                           	TSXV      
JDN       	Jayden Resources Inc                              	TSXV      
JEC       	Jura Energy Corporation                           	TSXV      
JEN.H     	The Jenex Corporation                             	TSXV      
JET       	Jet Metal Corp                                    	TSXV      
JET.WT    	Canada Jetlines Ltd Wts                           	TSXV      
JET.WT.A  	Canada Jetlines Ltd Wts A                         	TSXV      
JFC       	Jaguar Financial Corp                             	TSXV      
JG        	Japan Gold Corp                                   	TSXV      
JHC.H     	Jinhua Capital Corp                               	TSXV      
JNX       	Junex Inc.                                        	TSXV      
JOR.H     	Jourdan Resources Inc                             	TSXV      
JP        	Jackpot Digital Inc                               	TSXV      
JP.WT     	Jackpot Digital Inc Wts                           	TSXV      
JRI       	Jaguar Resources Inc                              	TSXV      
JSE       	Jadestone Energy Inc                              	TSXV      
JSP       	Jasper Mining Corporatio                          	TSXV      
JTC       	Jemtec Inc                                        	TSXV      
JTR       	Greenspace Brands Inc                             	TSXV      
JTR.WT    	Greenspace Brands Inc Wts                         	TSXV      
JZR       	Jazz Resources Inc.                               	TSXV      
JZZ       	Cleghorn Minerals Ltd                             	TSXV      
KALY      	Kalytera Therapeutics Inc.                        	TSXV      
KAP       	Kapuskasing Gold Corp                             	TSXV      
KAR       	Karmin Exploration Inc                            	TSXV      
KAS       	Khalkos Exploration Inc                           	TSXV      
KAY.H     	Karsten Energy Corp                               	TSXV      
KBG       	King S Bay Gold Corp.                             	TSXV      
KBY       	Kona Bay Technologies Inc                         	TSXV      
KCC       	Kincora Copper Limited                            	TSXV      
KDA       	Kda Group Inc.                                    	TSXV      
KDI       	Kennady Diamonds Inc                              	TSXV      
KE.H      	Karoo Exploration Corp                            	TSXV      
KEN       	Kenadyr Mining Holdings Corp                      	TSXV      
KES       	Kesselrun Resources Ltd                           	TSXV      
KFG       	Kfg Resources Ltd.                                	TSXV      
KG        	Klondike Gold Corp                                	TSXV      
KGC       	Kestrel Gold Inc                                  	TSXV      
KGF       	King George Financial Corp                        	TSXV      
KGL       	Kilo Goldmines Ltd.                               	TSXV      
KHA.H     	Knighthawk Inc                                    	TSXV      
KIV       	Kivalliq Energy Corporat                          	TSXV      
KLM       	Kermode Resources Ltd.                            	TSXV      
KMT       	Komet Resources Inc                               	TSXV      
KNE       	Kane Biotech Inc                                  	TSXV      
KNG       	Kingsmen Resources Ltd                            	TSXV      
KNT       	K92 Mining Inc                                    	TSXV      
KNX       	Knick Exploration Inc.                            	TSXV      
KR        	Kr Investment Ltd                                 	TSXV      
KRS       	Kairos Capital Corporati                          	TSXV      
KS        	Klondike Silver Corp                              	TSXV      
KSI       	Kneat.Com Inc                                     	TSXV      
KTN       	Kootenay Silver Inc                               	TSXV      
KTN.WT    	Kootenay Silver Inc Wts                           	TSXV      
KTO       	K2 Gold Corporation                               	TSXV      
KTR       	Kintavar Exploration Inc                          	TSXV      
KUB       	Cub Energy Inc                                    	TSXV      
KUR.H     	Kure Technologies Inc                             	TSXV      
KUT       	Redishred Capital Corp.                           	TSXV      
KWF       	Knightswood Financial Corp.                       	TSXV      
KYS.H     	Kaymus Resources Inc                              	TSXV      
KYU       	Kaiyue International Inc                          	TSXV      
KZD       	Kaizen Discovery Inc                              	TSXV      
KZZ       	Nunavik Nickel Mines Ltd                          	TSXV      
LA        	Los Andes Copper Limited                          	TSXV      
LAD       	New Carolin Gold Corp                             	TSXV      
LAT       	Latin American Minerals                           	TSXV      
LBC       	Libero Mining Corporation                         	TSXV      
LBL       	Lattice Biologics Ltd                             	TSXV      
LBY       	Liberty One Lithium Corp                          	TSXV      
LBY.H     	Liberty One Lithium Corp                          	TSXV      
LEM       	Leading Edge Materials Corp                       	TSXV      
LEN       	Lund Enterprises Corp                             	TSXV      
LEP       	Lithium Energy Products Inc                       	TSXV      
LEQ.H     	Leo Acquisitions Corp                             	TSXV      
LES       	Leis Industries Limited                           	TSXV      
LET       	Letho Resources Corp                              	TSXV      
LEXI      	Lithium Energi Exploration Inc.                   	TSXV      
LFC.P     	22 Capital Corp                                   	TSXV      
LGN       	Legend Gold Corp                                  	TSXV      
LGR       	Logan Resources Ltd                               	TSXV      
LHR       	Lakeview Hotel Invest Co                          	TSXV      
LHR.DB.C  	Lakeview Hotel Invest Co                          	TSXV      
LHR.DB.D  	Lakeview Hotel Invest Co                          	TSXV      
LI        	American Lithium Corp                             	TSXV      
LIC       	Lico Energy Metals Inc                            	TSXV      
LIO       	Lion One Metals Limited                           	TSXV      
LIR       	Lamelee Iron Ore Ltd                              	TSXV      
LIT       	Argentina Lithium and Energy Corp                 	TSXV      
LIX       	Lithium X Energy Corp                             	TSXV      
LJ        	Lucky Minerals Inc.                               	TSXV      
LL        	Canada Rare Earth Corp                            	TSXV      
LLC       	Lorraine Copper Corp.                             	TSXV      
LLG       	Mason Graphite Inc                                	TSXV      
LM        	Lingo Media Corporation                           	TSXV      
LMC       	Leagold Mining Corporation                        	TSXV      
LMD       	Led Medical Diagnostics                           	TSXV      
LME       	Laurion Mineral Explorat                          	TSXV      
LMG       	Lincoln Mining Corporati                          	TSXV      
LMR       	Lomiko Metals Inc.                                	TSXV      
LMT       	Luminor Medical Technologies Inc                  	TSXV      
LNC       	Lithion Energy Corp                               	TSXV      
LND       	Inspira Financial Inc                             	TSXV      
LND.DB    	Inspira Financial Inc 4.00 Pct Debs               	TSXV      
LNE.H     	Loon Energy Corporation                           	TSXV      
LOOP      	Loopshare Ltd                                     	TSXV      
LOT       	Tomagold Corporation                              	TSXV      
LPC       	Lorne Park Capital Partn                          	TSXV      
LPK       	Lupaka Gold Corp                                  	TSXV      
LPS       	Legend Power Systems Inc                          	TSXV      
LRA       	Lara Exploration Ltd                              	TSXV      
LRC.H     	Lovitt Resources Inc                              	TSXV      
LSC       	Lsc Lithium Corporation                           	TSXV      
LSI       	Lonestar West Inc.                                	TSXV      
LTA.H     	Leeta Gold Corp                                   	TSXV      
LTE       	Lite Access Technologies Inc                      	TSXV      
LTV       	Leonovus Inc                                      	TSXV      
LTX       	Labrador Technologies In                          	TSXV      
LTY       	Liberty Biopharma Inc.                            	TSXV      
LUM       	Lumina Gold Corp                                  	TSXV      
LXE       	Leucrotta Exploration In                          	TSXV      
LXG       	Lexagene Holdings Inc                             	TSXV      
M         	Mosaic Capital Corporati                          	TSXV      
M.DB      	Mosaic Capital Corp 7.0 Pct Debs                  	TSXV      
MAD       	Miranda Gold Corp.                                	TSXV      
MAE       	Maritime Resources Corp.                          	TSXV      
MAH       	Marksmen Energy Inc.                              	TSXV      
MAI       	Minera Alamos Inc                                 	TSXV      
MAP       	Maple Peak Investments Inc                        	TSXV      
MARL      	Mariana Resources Ltd                             	TSXV      
MAS       	Masuparia Gold Corp.                              	TSXV      
MAT       	Matamec Explorations Inc                          	TSXV      
MAZ.H     	Mazarin Inc.                                      	TSXV      
MBG       	Malbex Resources Inc.                             	TSXV      
MBI       	Med Biogene Inc.                                  	TSXV      
MBO       	Mobio Technologies Inc                            	TSXV      
MCE       	Minecorp Energy Ltd                               	TSXV      
MCG       	Mountain China Resorts H                          	TSXV      
MCI       	Minnova Corp                                      	TSXV      
MCK       	Manson Creek Resources L                          	TSXV      
MCM.A     	Matachewan Cons Mines                             	TSXV      
MCR       	Macro Enterprises Inc.                            	TSXV      
MCW       	Mcw Energy Group Limited                          	TSXV      
MD        	Midland Exploration Inc.                          	TSXV      
MDE.H     	Madeira Minerals Ltd                              	TSXV      
MDL       	Medallion Resources Ltd.                          	TSXV      
MDNA      	Medicenna Therapeutics Corp.                      	TSXV      
MDO       	Manado Gold Corp                                  	TSXV      
MDV       	Megastar Development Cor                          	TSXV      
MDX       	Medx Health Corp                                  	TSXV      
MED       	Medgold Resources Corp                            	TSXV      
MEI       	Manitok Energy Inc.                               	TSXV      
MEI.DB    	Manitok Energy Inc 10.5 Pct Debs                  	TSXV      
MEI.WT    	Manitok Energy Inc Wts                            	TSXV      
MEK       	Metals Creek Resources C                          	TSXV      
MET       	Metalore Resources Limited                        	TSXV      
MEX       	Mexican Gold Corp.                                	TSXV      
MEZ       	Mezzotin Minerals Inc.                            	TSXV      
MFM       	Marifil Mines Ltd.                                	TSXV      
MFS       	Medifocus Inc                                     	TSXV      
MFX       	Minfocus Exploration Cor                          	TSXV      
MGC.H     	Midasco Capital Corp                              	TSXV      
MGG       	Minaurum Gold Inc.                                	TSXV      
MGI       	Magnum Goldcorp Inc                               	TSXV      
MGW       	Maple Leaf Green World I                          	TSXV      
MGZ.H     	Mangazeya Mining Ltd                              	TSXV      
MHI       	Mineral Hill Industries Inc                       	TSXV      
MIA.P     	Mira Ix Acquisition Corp                          	TSXV      
MINE      	Inomin Mines Inc                                  	TSXV      
MIR       	Medmira Inc                                       	TSXV      
MIT       	The Mint Corporation                              	TSXV      
MIX       	Micrex Development Corp                           	TSXV      
MJN       	Cronos Group Inc.                                 	TSXV      
MJS       	Majestic Gold Corp.                               	TSXV      
MJX       	Majescor Resources Inc.                           	TSXV      
MK.H      	Mk2 Ventures Ltd                                  	TSXV      
MKA       	Mkango Resources Ltd.                             	TSXV      
MKNA      	Makena Resources Inc                              	TSXV      
MKR       	Melkior Resources Inc                             	TSXV      
MKT       	Deepmarkit Corp                                   	TSXV      
MKU.H     	Mukuba Resources Limited                          	TSXV      
ML        	Millennial Lithium Corp                           	TSXV      
MLG       	ML Gold Corp                                      	TSXV      
MLN       	Marlin Gold Mining Ltd                            	TSXV      
MLR       	Melior Resources Inc                              	TSXV      
MLY       	American Cumo Mining Cor                          	TSXV      
MMA       	Midnight Sun Mining Corp                          	TSXV      
MMG       	Metallic Minerals Corp                            	TSXV      
MMM       	Minco Gold Corporation                            	TSXV      
MMN       	Monarca Minerals Inc                              	TSXV      
MMS       	Macarthur Minerals Limit                          	TSXV      
MMV       	Mineral Mountain Resourc                          	TSXV      
MMX       	Macmillan Minerals Inc                            	TSXV      
MMY       	Monument Mining Limited                           	TSXV      
MN        	Manganese X Energy Corp                           	TSXV      
MNO       	Meridian Mining Societas Europaea                 	TSXV      
MNX       	Manitex Capital Inc.                              	TSXV      
MNY       	Montan Mining Corp                                	TSXV      
MOE.H     	Metropolitan Energy Corp                          	TSXV      
MOL       	Molori Energy Inc.                                	TSXV      
MON       	Montero Mining and Explo                          	TSXV      
MOO       	Mooncor Oil and Gas Corp                          	TSXV      
MOR.H     	Morgan Resources Corp                             	TSXV      
MOX       	Morien Resources Corp                             	TSXV      
MPH       	Medicure Inc                                      	TSXV      
MPT       	Midpoint Holdings Ltd                             	TSXV      
MQR       	Monarques Gold Corporati                          	TSXV      
MQR.WT.A  	Monarques Gold Corporati                          	TSXV      
MQX       	Marquee Energy Ltd                                	TSXV      
MRB       	Morro Bay Resources Ltd                           	TSXV      
MRL       	Margaux Resources Ltd                             	TSXV      
MRO       	Millrock Resources Inc.                           	TSXV      
MRS       	Mission Ready Services I                          	TSXV      
MRZ       	Mirasol Resources Ltd.                            	TSXV      
MSA       	Mesa Exploration Corp                             	TSXV      
MSP       	Minaean SP Construction                           	TSXV      
MSR       	Minsud Resources Corp.                            	TSXV      
MTB       	Mountain Boy Minerals Lt                          	TSXV      
MTC       	Metalcorp Ltd.                                    	TSXV      
MTH       	Mammoth Resources Corp                            	TSXV      
MTO       	Metanor Res Inc.                                  	TSXV      
MTS       	Metallis Resources Inc                            	TSXV      
MTU       	Manitou Gold Inc                                  	TSXV      
MTX       	Metalex Ventures Ltd.                             	TSXV      
MTZ       	Montana Exploration Corp                          	TSXV      
MU.H      	0Nemonster Uranium Corp                           	TSXV      
MUM       	Mustang Minerals Corp.                            	TSXV      
MUN       	Mundoro Capital Inc                               	TSXV      
MV        	Movit Media Corp                                  	TSXV      
MVE.H     	Marchwell Ventures Ltd                            	TSXV      
MVN       	Madalena Energy Inc                               	TSXV      
MVP       	Mediavalet Inc                                    	TSXV      
MVY       	Moovly Media Inc                                  	TSXV      
MWI.UN    	Maplewood International                           	TSXV      
MXL       	Mx Gold Corp                                      	TSXV      
MXR       	Max Resource Corp                                 	TSXV      
MXX       	Matrrix Energy Technolog                          	TSXV      
MYA       	Maya Gold & Silver Inc.                           	TSXV      
MZI       	Mezzi Holdings Inc                                	TSXV      
NAM       	New Age Metals Inc.                               	TSXV      
NAN       	North American Nickel In                          	TSXV      
NAP       	Napier Ventures Inc                               	TSXV      
NAR       	North Arrow Minerals Inc                          	TSXV      
NBL.P     	Nobelium Tech Corp                                	TSXV      
NBR       	Nubian Resources Ltd                              	TSXV      
NBU       	Nebu Resources Inc.                               	TSXV      
NBY       	Niobay Metals Inc                                 	TSXV      
NCI       	Ntg Clarity Networks Inc                          	TSXV      
NCX       	Northisle Copper and Gol                          	TSXV      
NDR       	New Dimension Resources                           	TSXV      
NEE       	Northern Vertex Mining C                          	TSXV      
NEM       	New Era Minerals Inc                              	TSXV      
NER       	Newmac Resources Inc                              	TSXV      
NEV       	Nevada Sunrise Gold Corp                          	TSXV      
NFD.A     	Northfield Capital Corp.                          	TSXV      
NFK.H     	Africa Hydrocarbons Inc                           	TSXV      
NGC       	Northern Graphite Corpor                          	TSXV      
NGE       	Nevada Exploration Inc.                           	TSXV      
NGH.H     	Nightingale Informatix Corporation                	TSXV      
NGY.H     	Newcastle Energy Corp                             	TSXV      
NGZ       	0Nenrg Metals Inc                                 	TSXV      
NHK       	Nighthawk Gold Corp                               	TSXV      
NIC       	Pure Nickel Inc                                   	TSXV      
NIK       	Nikos Explorations Ltd.                           	TSXV      
NIM       	Nicola Mining Inc                                 	TSXV      
NIO       	Niocan Inc                                        	TSXV      
NIP       	Nippon Dragon Resources                           	TSXV      
NIR       	Noble Iron Inc                                    	TSXV      
NKW       	Naikun Wind Energy Group                          	TSXV      
NL        	Northern Lion Gold Corp                           	TSXV      
NLC       	Neo Lithium Corp                                  	TSXV      
NMD       	Nomad Ventures Inc                                	TSXV      
NMG       	Noble Metal Group Inc                             	TSXV      
NNA       	New Nadina Explorations                           	TSXV      
NNN       	Nickel One Resources Inc                          	TSXV      
NNO       	Nano One Materials Corp                           	TSXV      
NNP       	Newnorth Projects Ltd.                            	TSXV      
NNX       	Nickel North Exploration                          	TSXV      
NOB       	Noble Mineral Exploratio                          	TSXV      
NOL.H     	Knol Resources Corp                               	TSXV      
NOT       	Noront Resources Ltd.                             	TSXV      
NOU       	Nouveau Monde Graphite Inc.                       	TSXV      
NPA       	Alphinat Inc.                                     	TSXV      
NQE       	Nq Exploration Inc.                               	TSXV      
NRG       	Newrange Gold Corp                                	TSXV      
NRM       	Noram Ventures Inc                                	TSXV      
NRN       	Northern Shield Resource                          	TSXV      
NSP       	Naturally Splendid Enter                          	TSXV      
NSX       	Nsgold Corporation                                	TSXV      
NTE       	Network Media Group Inc                           	TSXV      
NTQ       	Novateqni Corporation                             	TSXV      
NTS       	Nanotech Security Corp                            	TSXV      
NTY       	92 Resources Corp                                 	TSXV      
NU        	Neutrisci International                           	TSXV      
NUG       	Nulegacy Gold Coporation                          	TSXV      
NUK       	North Sea Energy Inc                              	TSXV      
NVI       	Novra Technologies Inc.                           	TSXV      
NVM       	Nevada Clean Magnesium I                          	TSXV      
NVO       	Novo Resources Corp                               	TSXV      
NVT       	Nortec Minerals Corp.                             	TSXV      
NVV       	Norvista Capital Corp                             	TSXV      
NVX       	Nv Gold Corporation                               	TSXV      
NW        	New World Resources Corp                          	TSXV      
NWE       	New West Energy Services                          	TSXV      
NWX       	Newport Exloration Ltd                            	TSXV      
NXG       	Nexgenrx Inc.                                     	TSXV      
NXN       	Nxgold Ltd                                        	TSXV      
NXO       	Nexoptic Technology Corp                          	TSXV      
NXR.UN    	Nexus Real Estate Investment Trust                	TSXV      
NXS       	Nexus Gold Corp                                   	TSXV      
NXT       	Natcore Technology Inc.                           	TSXV      
NYX       	Nyx Gaming Group Limited                          	TSXV      
NYX.DB    	Nyx Gaming Group Ltd 9.0 Pct De                   	TSXV      
NZ        	New Zealand Energy Corp                           	TSXV      
NZN       	Nevada Zinc Corporation                           	TSXV      
NZP       	Chatham Rock Phosphate Ltd                        	TSXV      
NZZ       	Nitinat Minerals Corpora                          	TSXV      
OCN       	Oceanus Resources Corp                            	TSXV      
OCO       	Oroco Resource Corp.                              	TSXV      
ODX.H     	Odyssey Resources Ltd                             	TSXV      
OEE       	Memex Inc.                                        	TSXV      
OG        	Organic Garage Ltd                                	TSXV      
OGI       	Organigram Holdings Inc                           	TSXV      
OGI.WT    	Organigram Holdings Inc Wts                       	TSXV      
OGO       	0Neorganto Foods Inc                              	TSXV      
OK        	Ok2 Minerals Ltd                                  	TSXV      
OLA       	Orla Mining Ltd                                   	TSXV      
OLV       	Olivut Resources Ltd.                             	TSXV      
OML       	Omni-Lite Industries Can                          	TSXV      
OMM       	Omineca Mining and Metal                          	TSXV      
ON.H      	Oneroof Energy Group Inc                          	TSXV      
ONE       	01 Communique Laboratory                          	TSXV      
OOO       	Otis Gold Corp.                                   	TSXV      
OPW       	Opawica Explorations Inc                          	TSXV      
ORC.B     	Orca Exploration Group I                          	TSXV      
ORE       	0Neorezone Gold Corporation                       	TSXV      
ORG       	Orca Gold Inc                                     	TSXV      
ORO       	New Oroperu Resources In                          	TSXV      
ORS       	Orestone Mining Corp                              	TSXV      
ORX       	Orefinders Resources Inc                          	TSXV      
OS        	Osprey Gold Development Ltd.                      	TSXV      
OSS       	Onesoft Solutions Inc                             	TSXV      
OSU       	Orsu Metals Corporation                           	TSXV      
OUP.H     	Oriana Resources Corporation                      	TSXV      
OVT       	Oculus Visiontech Inc                             	TSXV      
OX        	Orex Exploration Inc.                             	TSXV      
OY        	Oyster Oil and Gas Ltd                            	TSXV      
OYL       	Cgx Energy Inc                                    	TSXV      
PA        	Palamina Corp                                     	TSXV      
PAC       	Pacton Gold Inc.                                  	TSXV      
PAD       	Pan Andean Minerals Ltd                           	TSXV      
PAL       	Parallel Mining Corp                              	TSXV      
PAM       	Power Americas Minerals Corp.                     	TSXV      
PAN       	Pangolin Diamonds Corp                            	TSXV      
PAS       	Pascal Biosciences Inc.                           	TSXV      
PAT       	Patriot One Technologies Inc                      	TSXV      
PBM       	Pacific Bay Minerals Ltd                          	TSXV      
PBR       	Para Resources Inc                                	TSXV      
PBS       	Pacgen Life Science Corp                          	TSXV      
PCI       	Perlite Canada Inc.                               	TSXV      
PCO       	Phoenix Canada Oil Co.Lt                          	TSXV      
PCQ       	Petrolympic Ltd.                                  	TSXV      
PCR       	Pinecrest Resources Ltd                           	TSXV      
PDP       	Pediapharm Inc                                    	TSXV      
PDQ       	Petrodorado Energy Ltd                            	TSXV      
PE        	Pure Energy Minerals Lim                          	TSXV      
PEA       	Petrolia Inc.                                     	TSXV      
PED.H     	Pedro Resources Ltd                               	TSXV      
PEEK      	Peeks Social Ltd.                                 	TSXV      
PEH       	Primeline Energy Holding                          	TSXV      
PEO       	People Corporation                                	TSXV      
PET       	Peat Resources Ltd.                               	TSXV      
PEX       	Pacific Ridge Exploratio                          	TSXV      
PFC       	Petrofrontier Corp.                               	TSXV      
PFM       	Prontoforms Corporation                           	TSXV      
PGC       	Plato Gold Corp.                                  	TSXV      
PGE       	Group Ten Metals Inc                              	TSXV      
PGK       	Png Gold Corporation                              	TSXV      
PGM       	Pure Gold Mining Inc                              	TSXV      
PGS       	Paget Minerals Corp.                              	TSXV      
PGV       	Prodigy Ventures Inc                              	TSXV      
PGX       	Prosper Gold Corp                                 	TSXV      
PGZ       	Pan Global Resources Inc                          	TSXV      
PHI       	Philippine Metals Inc                             	TSXV      
PHL.H     	Planet Health Corp                                	TSXV      
PHM       	Patient Home Monitoring                           	TSXV      
PHM.DB    	Patient Home Monitoring                           	TSXV      
PHO       	Photon Control Inc.                               	TSXV      
PIT.H     	Pitchblack Resources Ltd                          	TSXV      
PJT       	Partner Jet Corp.                                 	TSXV      
PJX       	Pjx Resources Inc                                 	TSXV      
PKC.H     	Pacific Link Mining Corp                          	TSXV      
PKT       	Parkit Enterprise Inc                             	TSXV      
PLA       	Plata Latina Minerals Co                          	TSXV      
PLO.H     	Paloma Resources Inc.                             	TSXV      
PLU       	Plateau Uranium Inc                               	TSXV      
PLX       	Point Loma Resources Ltd                          	TSXV      
PLY       	Playfair Mining Ltd                               	TSXV      
PMA       	Petromaroc Corporation P                          	TSXV      
PML       	Panoro Minerals Ltd                               	TSXV      
PMX       	Proam Exploration Corpor                          	TSXV      
PNG       	Kraken Sonar Inc                                  	TSXV      
PNN       	Pennine Petroleum Corpor                          	TSXV      
PNR.H     	Prince Resource Corp                              	TSXV      
POC       	Pacific Iron Ore Corpora                          	TSXV      
POE       	Pan Orient Energy Corp.                           	TSXV      
POG       	Perisson Petroleum Corporation                    	TSXV      
POOL      	Pool Safe Inc                                     	TSXV      
POR       	Portofino Resources Inc                           	TSXV      
PP        	Pacific Potash Corporation                        	TSXV      
PPE       	Pacific Paradym Energy I                          	TSXV      
PPK       	Prospect Park Capital Co                          	TSXV      
PPM       	Pacific Imperial Mines I                          	TSXV      
PPP       	Parlane Resource Corp                             	TSXV      
PPV.H     	P and P Ventures Inc                              	TSXV      
PPX       	Peruvian Precious Metals                          	TSXV      
PPZ.H     	Pacific Topaz Resources                           	TSXV      
PQE       	Petroteq Energy Inc.                              	TSXV      
PRB       	Probe Metals Inc                                  	TSXV      
PRG       	Precipitate Gold Corp                             	TSXV      
PRH       	Pearl River Holdings Ltd                          	TSXV      
PRN       	Profound Medical Corp                             	TSXV      
PRR       	Prospector Resources Corp                         	TSXV      
PRS       	Prism Resources Inc                               	TSXV      
PRV.UN    	Pro Real Estate Investme                          	TSXV      
PRZ       	Prize Mining Corp                                 	TSXV      
PSH       	Petroshale Inc                                    	TSXV      
PSL       	Prospero Silver Corp.                             	TSXV      
PST       	Pistol Bay Mining Inc                             	TSXV      
PTC       	Petrox Resources Corp                             	TSXV      
PTE       	Pioneering Technology Co                          	TSXV      
PTF       	Pender Growth Fund Vcc I                          	TSXV      
PTK       	Poet Technologies Inc                             	TSXV      
PTP       	Petrichor Energy Inc                              	TSXV      
PTU       	Purepoint Uranium Group                           	TSXV      
PTV       	Petro Vista Energy Corp.                          	TSXV      
PUC       	Pancontinental Gold Corporation                   	TSXV      
PUL       	Pulse Oil Corp                                    	TSXV      
PUM       	Puma Exploration Inc                              	TSXV      
PVF.PR.U  	Partners Value Investments Series 1 Pref          	TSXV      
PVF.UN    	Partners Value Investments  LP                    	TSXV      
PVF.WT    	Partners Value Investments Warrants               	TSXV      
PWM       	Power Metals Corp.                                	TSXV      
PX        	Pelangio Exploration Inc                          	TSXV      
PXI       	Planet Mining Exploratio                          	TSXV      
PYD       	Poydras Gaming Finance C                          	TSXV      
PYR       	Pyrogenesis Canada Inc                            	TSXV      
Q.A       	Questfire Energy Corp Cl                          	TSXV      
QAI.H     	Cairo Resources Inc                               	TSXV      
QBA       	Lgc Capital Ltd                                   	TSXV      
QGR       	Q Gold Resources Ltd                              	TSXV      
QIC       	Quantum International In                          	TSXV      
QIS       	Quorum Information Techn                          	TSXV      
QIT       	Quinto Real Capital Corp                          	TSXV      
QMC       	Qmc Quantum Minerals Cor                          	TSXV      
QMX       	Qmx Gold Corporation                              	TSXV      
QNC       	Quantum Numbers Corp                              	TSXV      
QPT       	Quest Pharmatech Inc.                             	TSXV      
QQ        	Quizam Media Corporation                          	TSXV      
QRO.H     	Quadro Resources Ltd                              	TSXV      
QST       	Questor Technology Inc.                           	TSXV      
QTA       	Quaterra Resources Inc.                           	TSXV      
QYOU      	Qyou Media Inc                                    	TSXV      
QZM       	Quartz Mountain Resource                          	TSXV      
RAB       	Rambler Metals and Minin                          	TSXV      
RAK       	Rackla Metals Inc                                 	TSXV      
RB.H      	Russell Breweries Inc                             	TSXV      
RBE       	Rockbridge Resources Inc                          	TSXV      
RBX       	Robex Resources Inc                               	TSXV      
RCC.H     	Red Rock Capital Corp                             	TSXV      
RCG       	Resource Capital Gold Corp                        	TSXV      
RCK       	Rock Tech Lithium Inc                             	TSXV      
RCT       	Rochester Resources Ltd.                          	TSXV      
RCU       	Rockcliff Copper Corporation                      	TSXV      
RDS       	Radisson Mining Resource                          	TSXV      
RDU       	Radius Gold Inc.                                  	TSXV      
REG       	Regulus Resources Inc                             	TSXV      
REKO      	Reko International Group                          	TSXV      
REL       	Roughrider Exploration L                          	TSXV      
REN       	Renaissance Gold Inc                              	TSXV      
REO       	Reservoir Capital Corp.                           	TSXV      
RER       	Remo Resources Inc                                	TSXV      
REW       	Rewardstream Solutions Inc                        	TSXV      
REX       	Orex Minerals Inc                                 	TSXV      
REZ       	Redzone Resources Ltd                             	TSXV      
RFC       	Rifco Inc.                                        	TSXV      
RG        	Romios Gold Resources In                          	TSXV      
RGC       	Redstar Gold Corp.                                	TSXV      
RGD       	Reunion Gold Corporation                          	TSXV      
RGI       	Reco International Group Inc.                     	TSXV      
RGM       	Remington Resources Inc.                          	TSXV      
RGZ.H     	Randsburg International Gold Corp.                	TSXV      
RHA       	Annidis Corporation                               	TSXV      
RHC.H     	Rhc Capital Corporation                           	TSXV      
RHT       	Reliq Health Technologies Inc                     	TSXV      
RIN       	Resinco Capital Partners                          	TSXV      
RIO       	Rio2 Limited                                      	TSXV      
RIR       	Rainmaker Resources Ltd                           	TSXV      
RJ        	Rojo Resources Ltd                                	TSXV      
RJX.A     	Rjk Explorations Ltd. C                           	TSXV      
RK        	Rockhaven Resources Ltd.                          	TSXV      
RKR       	Rokmaster Resources Corp                          	TSXV      
RLS.H     	Royal Lifescience Corp                            	TSXV      
RLV       	Relevium Technologies Inc                         	TSXV      
RM        	Rodinia Lithium Inc.                              	TSXV      
RMD       	Richmond Minerals Inc.                            	TSXV      
RMK       	Red Moon Potash Inc                               	TSXV      
RML       	Rusoro Mining Ltd                                 	TSXV      
RMN       	Red Tiger Mining Inc                              	TSXV      
RMO       	Rainy Mountain Royalty C                          	TSXV      
RMO.WT    	Rainy Mountain Royalty Corp Wts                   	TSXV      
RNG       	Reliant Gold Corp                                 	TSXV      
RNK.A     	Wow Unlimited Media Inc Cl A                      	TSXV      
RNP       	Royalty North Partners Ltd                        	TSXV      
RNP.WT    	Royalty North Partners Ltd Wts                    	TSXV      
ROB       	Red Hut Metals Inc                                	TSXV      
ROC.H     	Red Oak Mining Corp                               	TSXV      
ROE       	Renaissance Oil Corp                              	TSXV      
ROE.WT.A  	Renaissance Oil Corp Wts A                        	TSXV      
ROI       	Route1 Inc.                                       	TSXV      
ROM.H     	Romulus Resources Ltd                             	TSXV      
ROS.H     	Roscan Minerals Corporat                          	TSXV      
ROX       	Canstar Resources Inc.                            	TSXV      
RP        	Replicel Life Sciences I                          	TSXV      
RPC       	Raise Production Inc                              	TSXV      
RPM       	Rye Patch Gold Corp                               	TSXV      
RPR       	Rapier Gold Inc                                   	TSXV      
RPX       	Red Pine Exploration Inc                          	TSXV      
RRI       	Riverside Resources Inc.                          	TSXV      
RRL       	Relentless Resources Ltd                          	TSXV      
RRM.H     	Ross River Minerals Inc                           	TSXV      
RRR.UN    	R and R Real Estate Inve                          	TSXV      
RRS       	Rogue Resources Inc                               	TSXV      
RSL       	Royal Sapphire Corp                               	TSXV      
RST       	Rosita Mining Corporatio                          	TSXV      
RSV       	Resolve Ventures Inc.                             	TSXV      
RSY       	Rsi International System                          	TSXV      
RTH       	Rathdowney Resources Ltd                          	TSXV      
RTI       	Radient Technologies Inc                          	TSXV      
RTM       	Rt Minerals Corp                                  	TSXV      
RTN       	Return Energy Inc                                 	TSXV      
RUF.DB.U  	Pure Multi Family REIT L                          	TSXV      
RUF.U     	Pure Multi Family REIT L                          	TSXV      
RUF.UN    	Pure Multi Family REIT L                          	TSXV      
RUG       	Rugby Mining Limited                              	TSXV      
RUM       	Rocky Mountain Liquor In                          	TSXV      
RUM.DB.A  	Rocky Mountain Liquor Inc 7.5 Pct Debs            	TSXV      
RUN       	Running Fox Resource Cor                          	TSXV      
RUP       	Rupert Resources Ltd.                             	TSXV      
RVL       	Revelo Resources Corp                             	TSXV      
RVV       	Revive Therapeutics Ltd                           	TSXV      
RW        	Renoworks Software Inc.                           	TSXV      
RX        	Biosyent Inc.                                     	TSXV      
RYE       	Rhyolite Resources Ltd                            	TSXV      
RYO       	Rio Silver Inc                                    	TSXV      
RYR       	Royal Road Minerals Limi                          	TSXV      
RYS.H     	Rhys Resources Ltd                                	TSXV      
RYU       	Ryu Apparel Inc                                   	TSXV      
RZE       	Razor Energy Corp                                 	TSXV      
RZL       	Rizal Resources Corporation                       	TSXV      
RZZ       	Abitibi Royalties Inc                             	TSXV      
SA        	Southern Arc Minerals In                          	TSXV      
SAE.H     	Sable Resources Ltd                               	TSXV      
SAH       	Sahara Energy Ltd                                 	TSXV      
SAI       	Sunshine Agri Tech Inc.                           	TSXV      
SAN       	Solar Alliance Energy Inc                         	TSXV      
SAT       	Asian Television Network                          	TSXV      
SAY.H     	Sparta Capital Ltd                                	TSXV      
SBM       	Sirona Biochem Corp.                              	TSXV      
SBS.H     	Sebastiani Ventures Corp                          	TSXV      
SBW       	Strongbow Exploration In                          	TSXV      
SBX       	Sea Breeze Power Corp                             	TSXV      
SC.H      	Serrano Resources Ltd                             	TSXV      
SCA       	Savary Gold Corp                                  	TSXV      
SCG       	Selectcore Ltd.                                   	TSXV      
SCR       	Thescore Inc                                      	TSXV      
SCR.WT    	Thescore Inc Wts                                  	TSXV      
SCZ       	Santacruz Silver Mining                           	TSXV      
SDC       	Solidusgold Inc                                   	TSXV      
SDE       	Standard Exploration Ltd                          	TSXV      
SDR       	Stroud Resources Ltd.                             	TSXV      
SDS       	Seair Inc.                                        	TSXV      
SDX       	Sea Dragon Energy Inc.                            	TSXV      
SDZ       	Security Devices Interna                          	TSXV      
SEB       	Smart Employee Benefits                           	TSXV      
SEI       	Sintana Energy Inc                                	TSXV      
SEK       	Secova Metals Corp.                               	TSXV      
SEW       	Seaway Energy Services I                          	TSXV      
SFT       	Softrock Minerals Ltd.                            	TSXV      
SFX       	Sphinx Resources Ltd                              	TSXV      
SGA       	Samco Gold Limited                                	TSXV      
SGB       	Solegear Bioplastic Tech                          	TSXV      
SGE       	Strategem Capital Corp                            	TSXV      
SGH       	Standard Graphite Corpor                          	TSXV      
SGI       	Superior Gold Inc                                 	TSXV      
SGM       	Sutter Gold Mining Inc.                           	TSXV      
SGN       	Scorpio Gold Corporation                          	TSXV      
SGU       	Signature Resources Ltd                           	TSXV      
SGW       	Shoal Games Ltd                                   	TSXV      
SGX       	Sage Gold Inc.                                    	TSXV      
SGZ       	Sego Resources Inc.                               	TSXV      
SHJ       	Shoshoni Gold Ltd                                 	TSXV      
SHL       	Spruce Ridge Resources L                          	TSXV      
SHM       	Saccharum Energy Corp                             	TSXV      
SIC       	Sokoman Iron Corp                                 	TSXV      
SIE       	Sienna Resources Inc                              	TSXV      
SIL       	Silvercrest Metals Inc                            	TSXV      
SIL.WT    	Silvercrest Metals Inc Wts                        	TSXV      
SIM       	Siyata Mobile Inc.                                	TSXV      
SIQ.P     	Snobro Enterprises Inc                            	TSXV      
SIR       	Serengeti Resources Inc.                          	TSXV      
SJL       	Saint Jean Carbon Inc                             	TSXV      
SJR.A     	Shaw Communications Inc.                          	TSXV      
SKE       	Skeena Resources Limited                          	TSXV      
SKP       	Strikepoint Gold Inc.                             	TSXV      
SLAU      	Sandy Lake Gold Inc                               	TSXV      
SLG       	Sterling Resources Ltd                            	TSXV      
SLK       	Silk Road Energy Inc                              	TSXV      
SLL       	Standard Lithium Ltd                              	TSXV      
SLY.H     	Shelby Ventures Inc                               	TSXV      
SMB       	Simba Essel Energy Inc.                           	TSXV      
SMD       	Strategic Metals Ltd                              	TSXV      
SME       	Sama Resources Inc Resso                          	TSXV      
SMI       	Saturn Oil & Gas Inc.                             	TSXV      
SMM       	Silver Mountain Mines In                          	TSXV      
SMN       	San Marco Resources Inc.                          	TSXV      
SMO       	Sonoro Metals Corp                                	TSXV      
SMP.H     	Strata Minerals Inc                               	TSXV      
SMV.H     	Smc Ventures Inc.                                 	TSXV      
SMY       	Search Minerals Inc.                              	TSXV      
SN        	Sennen Potash Corporatio                          	TSXV      
SNF       	Sunora Foods Inc                                  	TSXV      
SNG       	Silver Range Resources L                          	TSXV      
SNL       	Signal Exploration Inc                            	TSXV      
SNM       	Shamaran Petroleum Corp.                          	TSXV      
SNR       	Senator Minerals Inc.                             	TSXV      
SNS       	Select Sands Corp                                 	TSXV      
SNV       	Sonoro Energy Ltd                                 	TSXV      
SNX.H     	Sixonine Ventures Corp                            	TSXV      
SOC       	Sonora Gold & Silver Cor                          	TSXV      
SOG       	Strategic Oil and Gas Lt                          	TSXV      
SOI       	Sirios Resources Inc.                             	TSXV      
SOJ       	Sojourn Ventures Inc                              	TSXV      
SOLE.P    	Soleil Capital Corp                               	TSXV      
SOR       	Sora Capital Corp                                 	TSXV      
SPA       	Spanish Mountain Gold Lt                          	TSXV      
SPD       	Silver Predator Corp                              	TSXV      
SPF       	Silver Pursuit Resources                          	TSXV      
SPI       	Canadian Spirit Resource                          	TSXV      
SPK       	Sunset Pacific Petroleum                          	TSXV      
SPL.P     	Spada Gold Ltd                                    	TSXV      
SPN       	Snipp Interactive Inc                             	TSXV      
SPP       	Spot Coffee Canada Ltd.                           	TSXV      
SPT       	Stockport Exploration Inc                         	TSXV      
SPX       	Stellar Africagold Inc                            	TSXV      
SQD       	Sqi Diagnostics Inc.                              	TSXV      
SQG       	Spackman Equities Group                           	TSXV      
SR.H      	Scorpion Resources Inc                            	TSXV      
SRA       	Stria Lithium Inc                                 	TSXV      
SRC       	Stakeholder Gold Corp                             	TSXV      
SRE       	Saville Resources Inc.                            	TSXV      
SRG       	Sama Graphite Inc                                 	TSXV      
SRI       	Sparton Resources Inc                             	TSXV      
SRJ       	Spearmint Resources Inc                           	TSXV      
SRL       	Salazar Resources Limite                          	TSXV      
SRX       	Storm Resources Ltd                               	TSXV      
SSA       	Spectra Inc                                       	TSXV      
SSC       	Smartcool Systems Inc.                            	TSXV      
SSE       	Silver Spruce Resources                           	TSXV      
SSG       	Sigma Industries Inc                              	TSXV      
SSN       	Stetson Oil                                       	TSXV      
SSP       	Sandspring Resources Ltd                          	TSXV      
SSS       	Sunvest Minerals Corp                             	TSXV      
SSV       	Southern Silver Explorat                          	TSXV      
STA       	Sanatana Resources Inc                            	TSXV      
STAR      	Five Star Diamonds Limited                        	TSXV      
STC       	Sangoma Technologies Cor                          	TSXV      
STE       	Starr Peak Exploration Ltd                        	TSXV      
STH       	Stelmine Canada Ltd.                              	TSXV      
STI       	Strategic Resources Inc                           	TSXV      
STM       	Scientific Metals Corp                            	TSXV      
STMP      	Stamper Oil & Gas Corp.                           	TSXV      
STS.H     	Stem 7 Capital Inc                                	TSXV      
STT       	Stt Enviro Corp                                   	TSXV      
STUS.A    	Starlight US Multi Family No 5                    	TSXV      
STUS.U    	Starlight US Multi Family No 5 USD                	TSXV      
SUI.H     	Superior Mining Internat                          	TSXV      
SUP       	Northern Superior Resour                          	TSXV      
SVA       	Sernova Corp.                                     	TSXV      
SVE       	Silver One Resources Inc                          	TSXV      
SVG       	Silver Grail Resources L                          	TSXV      
SVI       	Storagevault Canada Inc.                          	TSXV      
SVS       	Solarvest Bioenergy Inc                           	TSXV      
SVT       	Savant Explorations Ltd.                          	TSXV      
SWA       	Sarama Resources Ltd                              	TSXV      
SXE       	Strata X Energy Ltd                               	TSXV      
SXL       	Slam Exploration Inc                              	TSXV      
SY        	Symbility Solutions Inc                           	TSXV      
SYH       	Skyharbour Resources Ltd                          	TSXV      
SYI       	Silvermet Inc.                                    	TSXV      
SYN       	Syncordia Tech and Healt                          	TSXV      
SYZ       	Sylogist Ltd                                      	TSXV      
SZM       	Scozinc Mining Ltd                                	TSXV      
TAC       	Tasca Resources Ltd                               	TSXV      
TAE.H     	Transamerican Energy Inc                          	TSXV      
TAJ       	Tajiri Resources Corp                             	TSXV      
TAN       	Tanager Energy Inc                                	TSXV      
TAR       	Astar Minerals Ltd                                	TSXV      
TAU       	Tintina Resources Inc.                            	TSXV      
TBR       	Timberline Resources Cor                          	TSXV      
TCA       	Timia Capital Corp                                	TSXV      
TCC.H     	Trenchant Capital Corp                            	TSXV      
TCO       	Transatlantic Mining Corp                         	TSXV      
TE        	Trinity Valley Energy Co                          	TSXV      
TEG.H     	Troy Energy Corp.                                 	TSXV      
TEK       	Tekmodo Industries Inc                            	TSXV      
TEM       	Tembo Gold Corp                                   	TSXV      
TEN       	Terraco Gold Corp.                                	TSXV      
TEP.DB    	Transeastern Power Trust                          	TSXV      
TEP.UN    	Transeastern Power Trust                          	TSXV      
TES       	Tesoro Minerals Corp                              	TSXV      
TGH       	Tornado Global Hydrovacs Ltd                      	TSXV      
TGI.H     	True Grit Resources Ltd                           	TSXV      
TGR       	Tiger International Reso                          	TSXV      
TGV       	Tango Mining Limited                              	TSXV      
TGX       	True North GEMS Inc.                              	TSXV      
THCX      	The Hydropothecary Corp.                          	TSXV      
THH       	Theia Resources Ltd.                              	TSXV      
THM       	Thunder Mountain Gold In                          	TSXV      
THP       	Totally Hip Technologies                          	TSXV      
THX       	Thor Explorations Ltd.                            	TSXV      
TIA.H     	Triangle Industries Ltd                           	TSXV      
TIC       	Titanium Corporation Inc                          	TSXV      
TIG       	Triumph Gold Corp                                 	TSXV      
TII       	Terra Firma Capital Corp                          	TSXV      
TIL       	Till Capital Ltd                                  	TSXV      
TIM       	Toachi Mining Inc                                 	TSXV      
TIN       	Eurotin Inc                                       	TSXV      
TIP.H     	Tyner Resources Ltd                               	TSXV      
TIR.H     	Tiller Resources Ltd                              	TSXV      
TK        	Tinka Resources Ltd                               	TSXV      
TKU       	Tarku Resources Ltd                               	TSXV      
TKX       	Trackx Holdings Inc                               	TSXV      
TLA       	Titan Logix Corp                                  	TSXV      
TLK       	Frankly Inc                                       	TSXV      
TLL.H     	Tilting Capital Corp                              	TSXV      
TLT       	Theralase Technologies I                          	TSXV      
TM        	Trigon Metals Inc.                                	TSXV      
TMG       	Thermal Energy Internati                          	TSXV      
TMS       	Targeted Microwave Solutions Inc                  	TSXV      
TMT.H     	Tmt Resources Inc                                 	TSXV      
TNA       	Evergreen Gaming Corpora                          	TSXV      
TNC       	Tio Networks Corp.                                	TSXV      
TNO.H     	Terreno Resources Corp                            	TSXV      
TNR       	Tnr Gold Corp                                     	TSXV      
TOE       	Tri Origin Exploration L                          	TSXV      
TOM       	Tolima Gold Inc                                   	TSXV      
TORQ      	Torq Resources Inc.                               	TSXV      
TORR      	Torrent Capital Ltd                               	TSXV      
TPC       	Tenth Avenue Petroleum C                          	TSXV      
TRA       	Teras Resources Inc                               	TSXV      
TRAK      	Trakopolis Iot Corp                               	TSXV      
TRB       	Tribute Resources Inc                             	TSXV      
TREK      	Trek Mining Inc.                                  	TSXV      
TREK.WT   	Trek Mining Inc Wts                               	TSXV      
TRG.H     	Trigen Resources Inc                              	TSXV      
TRM       	Trueclaim Exploration In                          	TSXV      
TRO       	Taranis Resources Inc.                            	TSXV      
TRS       	Tres-Or Resources Ltd.                            	TSXV      
TRU       	Trius Investments Inc.                            	TSXV      
TSD       	Tsodilo Resources Ltd                             	TSXV      
TSG       	Tristar Gold Inc.                                 	TSXV      
TSN       	Telson Resources Inc                              	TSXV      
TSP       	Titan Star Properties In                          	TSXV      
TSP.DB    	Titanstar Properties Inc                          	TSXV      
TTD       	Tinkerine Studios Ltd                             	TSXV      
TTM       	3Tl Technologies Corp                             	TSXV      
TTR       	Titanium Transportation                           	TSXV      
TTS       	Tintina Mines Ltd                                 	TSXV      
TTZ       	Total Telcom Inc.                                 	TSXV      
TUD       	Tudor Gold Corp                                   	TSXV      
TUF       	Honey Badger Exploration                          	TSXV      
TUO       	Teuton Resources Corp                             	TSXV      
TVI       	Tvi Pacific Inc                                   	TSXV      
TVL       	Traverse Energy Ltd.                              	TSXV      
TWM       	Tidewater Midstream and                           	TSXV      
TWR       	Tower Resources Ltd                               	TSXV      
TWY       	Twyford Ventures Inc                              	TSXV      
TXR       	Terrax Minerals Inc.                              	TSXV      
TXX       	Tirex Resources Ltd.                              	TSXV      
TYE       	Troymet Exploration Corp                          	TSXV      
TYP       	Typhoon Exploration Inc.                          	TSXV      
TZR       	Terrace Energy Corp                               	TSXV      
TZR.DB    	Terrace Energy Corp 8.0                           	TSXV      
UBN       	Urban Communications Inc                          	TSXV      
UCU       	Ucore Rare Metals Inc                             	TSXV      
UFC       	Urbanfund Corp.                                   	TSXV      
UGD       	Unigold Inc.                                      	TSXV      
UGE       	Uge International Ltd                             	TSXV      
UGE.WT    	Uge International Ltd Wts                         	TSXV      
UHO       	United Hunter Oil and Ga                          	TSXV      
UI        	Urbanimmersive Technolog                          	TSXV      
ULI       	Ultra Lithium Inc.                                	TSXV      
UNI       	Unisync Corp Class B                              	TSXV      
UNO       	Northern Uranium Corp                             	TSXV      
URA       	Anglo Canadian Mining Co                          	TSXV      
URC       	Uracan Resources Ltd.                             	TSXV      
USCO      	US Cobalt Inc.                                    	TSXV      
USO       	US Oil Sands Inc                                  	TSXV      
USS       	Uniserve Communications                           	TSXV      
UTY       	Unity Energy Corp                                 	TSXV      
UVN       	Uravan Minerals Inc.                              	TSXV      
VAL       	Valgold Resources Ltd                             	TSXV      
VAN       	Vangold Mining Corp.                              	TSXV      
VANC      	Vanc Pharmaceuticals Inc                          	TSXV      
VAX       	Vantex Resources Ltd.                             	TSXV      
VCI       	Vitreous Glass Inc.                               	TSXV      
VCV.H     	Vatic Ventures Corp                               	TSXV      
VDO       	Nevado Resources Corpora                          	TSXV      
VEIN      	Enforcer Gold Corp.                               	TSXV      
VEM.H     	Vena Resources Inc                                	TSXV      
VG        	Volcanic Gold Mines Ltd                           	TSXV      
VGD       	Visible Gold Mines Inc.                           	TSXV      
VGL       	Vigil Health Solutions I                          	TSXV      
VGM       	Global Gardens Group Inc.                         	TSXV      
VGN       	Greencastle Res Ltd.                              	TSXV      
VGO       	Vogogo Inc                                        	TSXV      
VIE.P     	Vier Capital Corp                                 	TSXV      
VIO       	Societe D Exploration Mi                          	TSXV      
VIS       	Visionstate Corp                                  	TSXV      
VIT       	Victoria Gold Corp.                               	TSXV      
VIV       	Avivagen Inc                                      	TSXV      
VLA       	Vela Minerals Ltd                                 	TSXV      
VLC.H     	Velocity Minerals Ltd                             	TSXV      
VLT       	Voltaic Minerals Corp                             	TSXV      
VLV       	Venerable Ventures Ltd.                           	TSXV      
VM        	Voyageur Minerals Ltd                             	TSXV      
VML       	Viscount Mining Corp                              	TSXV      
VMY.H     	Voice Mobility Internati                          	TSXV      
VOLT      	Volt Energy Corp.                                 	TSXV      
VONE      	Vanadium One Energy Corp.                         	TSXV      
VPI       	Vitality Products Inc.                            	TSXV      
VPT       	Ventripoint Diagnostics                           	TSXV      
VPY       	Versapay Corporation                              	TSXV      
VQA       	Valterra Resource Corp                            	TSXV      
VQS       	Viq Solutions Inc.                                	TSXV      
VR        	Victory Resources Corpor                          	TSXV      
VRB       	Vanadiumcorp Resource In                          	TSXV      
VRR       	Vr Resources Inc.                                 	TSXV      
VRS       	Verisante Technology Inc                          	TSXV      
VRY       	Petro Victory Energy Cor                          	TSXV      
VSR       	Vanstar Mining Resources                          	TSXV      
VTI       	Valdor Technology Intern                          	TSXV      
VTT       	Vendetta Mining Corp                              	TSXV      
VUI       	Virginia Energy Resource                          	TSXV      
VUL       	Vulcan Minerals Inc                               	TSXV      
VUX       	Vital Energy Inc                                  	TSXV      
VVC       	Vvc Exploration Corp.                             	TSXV      
VVI.H     	Valencia Ventures Inc                             	TSXV      
VXL       	Vaxil Bio Ltd                                     	TSXV      
VYC       	Vanity Capital Inc                                	TSXV      
VZZ.H     	Uranium Valley Mines Ltd                          	TSXV      
WAF       	West African Resources L                          	TSXV      
WAR       	War Eagle Mining Company                          	TSXV      
WAS.H     	Watusi Capital Corp                               	TSXV      
WBE       	Westbond Enterprises Cor                          	TSXV      
WCB       	Wcb Resources Ltd                                 	TSXV      
WCC       	Consolidated Woodjam Cop                          	TSXV      
WCE       	Wescan Energy Corp                                	TSXV      
WDG       	Giyani Gold Corp                                  	TSXV      
WEB       	Westbridge Energy Corpor                          	TSXV      
WED       	The Westaim Corporation                           	TSXV      
WEE       	Wavefront Technology Sol                          	TSXV      
WEST.H    	Westbay Ventures Inc                              	TSXV      
WFG       	Waterfront Capital Corpo                          	TSXV      
WGF       	Wescan Goldfields Inc                             	TSXV      
WGO       	White Gold Corp.                                  	TSXV      
WGX.H     	Whistler Gold Exploratio                          	TSXV      
WHM       	White Metal Resources Co                          	TSXV      
WHN       	Westhaven Ventures Inc                            	TSXV      
WHY       	West High Yield Resource                          	TSXV      
WI        	The Western Investment Co of Cda Ltd              	TSXV      
WIF.H     	Windfire Capital Corp                             	TSXV      
WIL       	Wilton Resources Inc                              	TSXV      
WKG       	Westkam Gold Corp                                 	TSXV      
WKM       	West Kirkland Mining Inc                          	TSXV      
WKM.WT    	West Kirkland Mining Inc                          	TSXV      
WLF       	Wolfden Resources Corpor                          	TSXV      
WLV       	Wolverine Minerals Corp.                          	TSXV      
WMD       	Weedmd Inc                                        	TSXV      
WMK.H     	Whitemud Resources Inc                            	TSXV      
WML       	Wealth Minerals Ltd.                              	TSXV      
WMR       	Westminster Resources Lt                          	TSXV      
WMT       	West Mountain Environmen                          	TSXV      
WPQ       	Wpc Resources Inc                                 	TSXV      
WR.H      	Worldwide Resources Corp                          	TSXV      
WRI       	Waseco Resources Inc.                             	TSXV      
WRP       	Western Pacific Resource                          	TSXV      
WRR       	Walker River Resources C                          	TSXV      
WRY       	Western Troy Cap Res Inc                          	TSXV      
WSH.P     	Westshire Capital II Corp                         	TSXV      
WST.H     	Westridge Resources Inc                           	TSXV      
WT.H      	Wangton Capital Corp                              	TSXV      
WTR       	Westcore Energy Ltd.                              	TSXV      
WZR       	Westernzagros Resources                           	TSXV      
XAG       	Xtierra Inc.                                      	TSXV      
XBC       	Xebec Adsorption Inc                              	TSXV      
XCX       	Chinook Tyee Industry Li                          	TSXV      
XIA       	Xiana Mining Inc                                  	TSXV      
XIM       	Ximen Mining Corp                                 	TSXV      
XND       	Xander Resources Inc                              	TSXV      
XOP       	Canadian Overseas Petrol                          	TSXV      
XR        	Red Eagle Exploration Ltd                         	TSXV      
XTM       	Transition Metals Corp                            	TSXV      
XTT       	X Terra Resources Inc                             	TSXV      
XX        	Avante Logixx Inc                                 	TSXV      
XYL       	Xylitol Canada Inc.                               	TSXV      
YAK       	Mongolia Growth Group Lt                          	TSXV      
YD        	Ydreams Global Interactive Tech Inc               	TSXV      
YES       	Char Technologies Ltd                             	TSXV      
YFI       	Edgewater Wireless Syste                          	TSXV      
YMI       	Yellowhead Mining Inc                             	TSXV      
YOO       	Yangaroo Inc                                      	TSXV      
YSC.H     	Yongsheng Capital Inc                             	TSXV      
YTY       	Wi2Wi Corporation                                 	TSXV      
YVI       	Yorkton Ventures Inc                              	TSXV      
Z         	Zinc One Resources Inc.                           	TSXV      
ZAD       	Zadar Ventures Ltd                                	TSXV      
ZAZ       	Zazu Metals Corporation                           	TSXV      
ZC        	Zimtu Capital Corp.                               	TSXV      
ZCC       	Zena Mining Corp.                                 	TSXV      
ZEE       	Zenith Energy Ltd                                 	TSXV      
ZEN       	Zenyatta Ventures Ltd.                            	TSXV      
ZFR       	Zephyr Minerals Ltd                               	TSXV      
ZKL       	China Keli Electric Co Ltd                        	TSXV      
ZMA       	Zoomaway Travel Inc                               	TSXV      
ZMD       	Zoommed Inc.                                      	TSXV      
ZMS       	Zecotek Photonics Inc.                            	TSXV      
ZNC.H     	Zincore Metals Inc                                	TSXV      
ZOM       	Zomedica Pharmaceuticals Corp                     	TSXV      
ZON       	Zonte Metals Inc                                  	TSXV      
ZUM       	Zoomermedia Limited                               	TSXV      
