ATXR.IDX	S&P C.S. Ga-Atlanta Home Price Index
BOXR.IDX	S&P C.S. Ma-Boston Home Price Index
CEXR.IDX	S&P C.S. Oh-Cleveland Home Price Index
CHXR.IDX	S&P C.S. Il-Chicago Home Price Index
CRXR.IDX	S&P C.S. Nc-Charlotte Home Price Index
CS2R.IDX	S&P C.S. 20-City Composite Home Price Index
CSXR.IDX	S&P C.S. 10-City Composite Home Price Index
DAXR.IDX	S&P C.S. Tx-Dallas Home Price Index
DEXR.IDX	S&P C.S. Mi-Detroit Home Price Index
DNXR.IDX	S&P C.S. Co-Denver Home Price Index
LVXR.IDX	S&P C.S. Nv-Las Vegas Home Price Index
LXXR.IDX	S&P C.S. Ca-Los Angeles Home Price Index
MIXR.IDX	S&P C.S. Fl-Miami Home Price Index
MNXR.IDX	S&P C.S. Mn-Minneapolis Home Price Index
NYXR.IDX	S&P C.S. Ny-New York Home Price Index
PHXR.IDX	S&P C.S. Az-Phoenix Home Price Index
POXR.IDX	S&P C.S. Or-Portland Home Price Index
SEXR.IDX	S&P C.S. Wa-Seattle Home Price Index
SFXR.IDX	S&P C.S. Ca-San Francisco Home Price Index
SNXR.IDX	S&P C.S. Ca-San Diego Home Price Index
TPXR.IDX	S&P C.S. Fl-Tampa Home Price Index
WDXR.IDX	S&P C.S. Dc-Washington Home Price Index
