NADA.IDX  	52-Week Hi-Lo S&P 600                             	INDEX     
NADB.IDX  	52-Week Hi-Lo S&P 400                             	INDEX     
NADC.IDX  	52-Week Hi-Lo Nasdaq 100                          	INDEX     
NADD.IDX  	52-Week Hi-Lo DOW Indu                            	INDEX     
NADE.IDX  	52-Week Hi-Lo DOW Comp                            	INDEX     
NADF.IDX  	52-Week Hi-Lo DOW Tran                            	INDEX     
NADG.IDX  	52-Week Hi-Lo DOW Util                            	INDEX  
TRIA.IDX  	AMEX Trin                                         	INDEX     
TRIN.IDX  	NYSE Trin                                         	INDEX     
TRIQ.IDX  	NASD Trin                                         	INDEX   
ATXR.IDX  	S&P C.S. Ga-Atlanta Home Price Index              	INDEX     
BOXR.IDX  	S&P C.S. Ma-Boston Home Price Index               	INDEX     
CEXR.IDX  	S&P C.S. Oh-Cleveland Home Price Index            	INDEX     
CHXR.IDX  	S&P C.S. Il-Chicago Home Price Index              	INDEX     
CRXR.IDX  	S&P C.S. Nc-Charlotte Home Price Index            	INDEX     
CS2R.IDX  	S&P C.S. 20-City Composite Home Price Index       	INDEX     
CSXR.IDX  	S&P C.S. 10-City Composite Home Price Index       	INDEX     
DAXR.IDX  	S&P C.S. Tx-Dallas Home Price Index               	INDEX     
DEXR.IDX  	S&P C.S. Mi-Detroit Home Price Index              	INDEX     
DNXR.IDX  	S&P C.S. Co-Denver Home Price Index               	INDEX     
LVXR.IDX  	S&P C.S. Nv-Las Vegas Home Price Index            	INDEX     
LXXR.IDX  	S&P C.S. Ca-Los Angeles Home Price Index          	INDEX     
MIXR.IDX  	S&P C.S. Fl-Miami Home Price Index                	INDEX     
MNXR.IDX  	S&P C.S. Mn-Minneapolis Home Price Index          	INDEX     
NYXR.IDX  	S&P C.S. Ny-New York Home Price Index             	INDEX     
PHXR.IDX  	S&P C.S. Az-Phoenix Home Price Index              	INDEX     
POXR.IDX  	S&P C.S. Or-Portland Home Price Index             	INDEX     
SEXR.IDX  	S&P C.S. Wa-Seattle Home Price Index              	INDEX     
SFXR.IDX  	S&P C.S. Ca-San Francisco Home Price Index        	INDEX     
SNXR.IDX  	S&P C.S. Ca-San Diego Home Price Index            	INDEX     
TPXR.IDX  	S&P C.S. Fl-Tampa Home Price Index                	INDEX     
WDXR.IDX  	S&P C.S. Dc-Washington Home Price Index           	INDEX
TNX.IDX   	10-YEAR TREASURY NOTE                             	INDEX
TYX.IDX   	30-YEAR TREASURY BOND                             	INDEX
IRX.IDX   	13-WEEK TREASURY BILL                             	INDEX
FVX.IDX   	5-YEAR TREASURY NOTE                              	INDEX
SPX.IDX   	S&P 500 INDEX                                     	INDEX     
DJI.IDX   	DJ Industrial Average                             	INDEX     
DJT.IDX   	DJ Transport Average                              	INDEX     
DJU.IDX   	DJ Utility Average                                	INDEX     
NDY.IDX   	Nasdaq 100                                        	INDEX     
VIX.IDX   	CBOE Volatility Index                             	INDEX     
IQX.IDX   	S&P 500 EQUAL WEIGHT                              	INDEX     
XLB       	S&P 500 Materials Sector SPDR                     	AMEX      
XLE       	S&P 500 Energy Sector SPDR                        	AMEX      
XLF       	S&P 500 Financials Sector SPDR                    	AMEX      
XLG       	Russell Top 50 Guggenheim                         	AMEX      
XLI       	S&P 500 Industrial Sector SPDR                    	AMEX      
XLK       	S&P 500 Info Tech Sector SPDR                     	AMEX      
XLP       	S&P 500 Cons Staples Sector SPDR                  	AMEX      
XLRE      	S&P 500 Real Estate Sector SPDR                   	AMEX      
XLU       	S&P 500 Utilities Sector SPDR                     	AMEX      
XLV       	S&P 500 Healthcare Sector SPDR                    	AMEX      
XLY       	S&P 500 Cons Disc Sector SPDR                     	AMEX      \
XRT       	S&P Retail SPDR                                   	AMEX      
DXY.IDX   	U.S. Dollar Index                                 	INDEX     
GLD.IDX   	Gold Index                                        	INDEX     
XHB       	S&P Homebuilders SPDR                             	AMEX      
XSD       	S&P Semiconductor SPDR                            	AMEX      
TIP       	TIPS Bond Ishares                                 	AMEX      

