ACWF      	Ishares Global Multifactor ETF                    	AMEX      
ACWV      	All Country World Min Vol MSCI Ishares            	AMEX      
AGG       	Aggregate Bond Ishares                            	AMEX      
AGT       	Ishares Argentina and Global Exposure ETF         	AMEX      
AGZ       	Agency Bond Ishares                               	AMEX      
AOA       	S&P Aggressive Allocation Ishares                 	AMEX      
AOK       	S&P Conservative Allocation Ishares               	AMEX      
AOM       	S&P Moderate Allocation Ishares                   	AMEX      
AOR       	S&P Growth Allocation Ishares                     	AMEX      
AXJV      	Asia Ex Japan Mini Ishares ETF                    	AMEX      
BKF       	BRIC Index MSCI Ishares                           	AMEX      
BYLD      	Yield Optimized Bond Ishares                      	AMEX      
CEMB      	Emrg Mkts Corporate Bond Fund Ishares             	AMEX      
CLY       	10+ Year Credit Bond Ishares                      	AMEX      
CLYH      	Ishares Int-Rate Hedged 10 Year Bond              	AMEX      
CMBS      	CMBS Bond Ishares                                 	AMEX      
CMDT      	DOW Jones-UBS Roll Select Ishares                 	AMEX      
CMF       	S&P CA Municipal Bond Ishares                     	AMEX      
CNDF      	Ishares Consumer Disc Multifactor                 	AMEX      
CNSF      	Ishares Consumer Staple Multifactor               	AMEX      
CNYA      	Ishares China A ETF                               	AMEX      
CRBN      	Ishares ACWI Low Carbon Target ETF                	AMEX      
DEFA      	Ishares EAFE Adaptive Currency Hedge              	AMEX      
DEWJ      	Ishares Japan Adaptive Currency Hedge             	AMEX      
DEZU      	Ishares Eurozone Adaptive Currency Hedge          	AMEX      
DGRO      	Dividend Growth Ishares                           	AMEX      
DSI       	KLD 400 Social Index Ishares                      	AMEX      
DVYA      	Asia Pacific Dividend 30 Ishares                  	AMEX      
DVYE      	Emrg Mkts Dividend Ishares                        	AMEX      
ECH       	Chile Index MSCI Ishares                          	AMEX      
ECNS      	China Smallcap MSCI Ishares                       	AMEX      
EEM       	Emrg Mkts Index MSCI Ishares                      	AMEX      
EEMS      	Emrg Mkts Smallcap MSCI Ishares                   	AMEX      
EEMV      	Emrg Mkts Min Vol Idx MSCI Ishares                	AMEX      
EFA       	EAFE Index MSCI Ishares                           	AMEX      
EFAV      	EAFE Min Volatility MSCI Ishares                  	AMEX      
EFG       	EAFE Growth Index MSCI Ishares                    	AMEX      
EFNL      	Finland Index MSCI Ishares                        	AMEX      
EFV       	EAFE Value Index MSCI Ishares                     	AMEX      
EIDO      	Indonesia Index MSCI Ishares                      	AMEX      
EIRL      	Ireland Index MSCI Ishares                        	AMEX      
EIS       	Israel Index MSCI Ishares                         	AMEX      
EMBH      	Ishares Int-Rate Hedged EM Bond                   	AMEX      
EMGF      	Ishares MSCI Multifactor EM ETF                   	AMEX      
EMHY      	Emrg Mkts High Yield Bond Fund Ishares            	AMEX      
ENOR      	Norway Index MSCI Ishares                         	AMEX      
EPHE      	Philippines Index MSCI Ishares                    	AMEX      
EPOL      	Poland Index MSCI Ishares                         	AMEX      
EPP       	Pacific Ex-Japan MSCI Ishares                     	AMEX      
EPU       	Peru Index MSCI Ishares                           	AMEX      
ERGF      	Ishares Energy Multifactor                        	AMEX      
ERUS      	Russia Index MSCI Ishares                         	AMEX      
EUMV      	Europe Minimum Vol Ishares ETF                    	AMEX      
EUSA      	US Index MSCI Ishares                             	AMEX      
EWA       	Australia Index MSCI Ishares                      	AMEX      
EWC       	Canada Index MSCI Ishares                         	AMEX      
EWD       	Sweden Index MSCI Ishares                         	AMEX      
EWG       	Germany Index MSCI Ishares                        	AMEX      
EWGS      	Germany Smallcap MSCI Ishares                     	AMEX      
EWH       	Hong Kong Index MSCI Ishares                      	AMEX      
EWI       	Italy Index MSCI Ishares                          	AMEX      
EWJ       	Japan Index MSCI Ishares                          	AMEX      
EWK       	Belgium Index MSCI Ishares                        	AMEX      
EWL       	Switzerland Index MSCI Ishares                    	AMEX      
EWM       	Malaysia Index MSCI Ishares                       	AMEX      
EWN       	Netherlands Invstbl Mkt Idx Ishares ETF           	AMEX      
EWO       	Austria Index MSCI Ishares                        	AMEX      
EWP       	Spain Index MSCI Ishares                          	AMEX      
EWQ       	France Index MSCI Ishares                         	AMEX      
EWS       	Singapore Index MSCI Ishares                      	AMEX      
EWT       	Taiwan Index MSCI Ishares                         	AMEX      
EWU       	UK Index MSCI Ishares                             	AMEX      
EWUS      	UK Smallcap MSCI Ishares                          	AMEX      
EWW       	Mexico Index MSCI Ishares                         	AMEX      
EWY       	South Korea Index MSCI Ishares                    	AMEX      
EWZ       	Brazil Index MSCI Ishares                         	AMEX      
EXI       	S&P Global Industrials Ishares                    	AMEX      
EZA       	South Africa Index MSCI Ishares                   	AMEX      
EZU       	Ishares MSCI Eurozone ETF                         	AMEX      
FIBR      	Ishares US Fixed Income                           	AMEX      
FILL      	Global Energy Producers MSCI Ishares              	AMEX      
FLOT      	Floating Rate Note Ishares                        	AMEX      
FM        	Frontier 100 Ishares ETF                          	AMEX      
FNCF      	Ishares Financials Multifactor                    	AMEX      
FXI       	FTSE China 25 Index Fund Ishares                  	AMEX      
GBF       	Government/Credit Bond Ishares                    	AMEX      
GHYG      	Global High Yield Corporate Bond Fund Ishares     	AMEX      
GOVT      	Core US Treasury Bond ETF Ishares                 	AMEX      
GSG       	S&P GSCI Commodity-Indexed Ishares                	AMEX      
GVI       	Interm Govt/Credit Bond Ishares                   	AMEX      
HACV      	Ishares Min Vol Global Currency ETF               	AMEX      
HACW      	Ishares ACWI Currency Hedged                      	AMEX      
HAUD      	Ishares Australia Currency Hedged                 	AMEX      
HAWX      	Ishares ACWI Ex-US Currency Hedged                	AMEX      
HCRF      	Ishares Healthcare Multifactor                    	AMEX      
HDV       	Core High Dividend ETF Ishares                    	AMEX      
HEEM      	Ishares EM Currency Hedged                        	AMEX      
HEFA      	MSCI EAFE Ishares Currency Hedged                 	AMEX      
HEFV      	Ishares Min Vol EAFE Currency Hedged              	AMEX      
HEMV      	Ishares Min Vol EM Currency Hedged                	AMEX      
HEUS      	Ishares Europe Smallcap Currency Hedged           	AMEX      
HEUV      	Ishares Min Vol Europe Currency Hedged            	AMEX      
HEWC      	Ishares Canada Currency Hedged                    	AMEX      
HEWI      	Ishares Italy Currency Hedged                     	AMEX      
HEWJ      	MSCI Japan Ishares Currency Hedged                	AMEX      
HEWL      	Ishares Switzerland Currency Hedged               	AMEX      
HEWP      	Ishares Spain Currency Hedged                     	AMEX      
HEWU      	Ishares UK Currency Hedged                        	AMEX      
HEWW      	Ishares Mexico Currency Hedged                    	AMEX      
HEWY      	Ishares South Korea Currency Hedged               	AMEX      
HEZU      	Ishares Eurozone Currency Hedged                  	AMEX      
HHYX      	Ishares Intl High Yld Currency Hedged             	AMEX      
HJPX      	Ishares Jpx-Nikkei 400 Currency Hedged            	AMEX      
HSCZ      	Ishares EAFE Smallcap Currency Hedged             	AMEX      
HYDB      	Ishares Edge High Yield Defensive Bond ETF        	AMEX      
HYG       	Iboxx $ High Yield Corporate Bd Ishares           	AMEX      
HYGH      	Interest Rate Hedged Hi Yld Ishares               	AMEX      
HYXU      	Global Ex-US High Yield Corp Bond Fund Ishares    	AMEX      
IAGG      	Ishares Intl Aggregate Bond Fund                  	AMEX      
IAI       	DJ US Broker-Dealers Ishares                      	AMEX      
IAK       	DJ US Insurance Ishares                           	AMEX      
IAT       	DJ US Regional Banks Ishares                      	AMEX      
IAU       	Gold Trust Ishares ETF                            	AMEX      
IBCC      	2018 Investment Grade Ishares                     	AMEX      
IBCD      	2020 Investment Grade Ishares                     	AMEX      
IBCE      	2023 Investment Grade Ishares                     	AMEX      
IBDB      	Ishares Mar 2018 Term Corp ETF                    	AMEX      
IBDC      	Ishares Mar 2020 Term Corp ETF                    	AMEX      
IBDD      	Ishares Mar 2023 Term Corp ETF                    	AMEX      
IBDH      	Ishares Dec 2018 Term Corp ETF                    	AMEX      
IBDJ      	Ishares Dec 2017 Term Corp ETF                    	AMEX      
IBDK      	Ishares Dec 2019 Term Corp ETF                    	AMEX      
IBDL      	Ishares Dec 2020 Term Corp ETF                    	AMEX      
IBDM      	Ishares Dec 2021 Term Corp ETF                    	AMEX      
IBDN      	Ishares Dec 2022 Term Corp ETF                    	AMEX      
IBDO      	Ishares Dec 2023 Term Corp ETF                    	AMEX      
IBDP      	Ishares Dec 2024 Term Corp ETF                    	AMEX      
IBDQ      	Ishares Dec 2025 Term Corp ETF                    	AMEX      
IBDR      	Ishares Dec 2026 Term Corp ETF                    	AMEX      
IBDS      	Ishares Ibonds Dec 2027 Term Corporate ETF        	AMEX      
IBMG      	2018 S&P Amt-Free Municipal Ishares               	AMEX      
IBMH      	2019 Amt-Free Muni Term Ishares                   	AMEX      
IBMI      	Ishares Sep 2020 Term Muni Bond ETF               	AMEX      
IBMJ      	Ishares Dec 2021 Term Muni Bond ETF               	AMEX      
IBMK      	Ishares Dec 2022 Term Muni Bond ETF               	AMEX      
IBML      	Ishares Dec 2023 Term Muni Bond ETF               	AMEX      
ICF       	Reality Majors Cohen & Steers Ishares             	AMEX      
ICOL      	Colombia Capped Ishares ETF                       	AMEX      
ICSH      	Liquidity Income Ishares ETF                      	AMEX      
ICVT      	Ishares Convertible Bond ETF                      	AMEX      
IDEV      	Ishares Core MSCI Intl Devd Market ETF            	AMEX      
IDU       	DOW Utilities Ishares                             	AMEX      
IDV       	DJ Intl Select Div Idx Ishares                    	AMEX      
IEFA      	Core MSCI EAFE Ishares                            	AMEX      
IEMG      	Core MSCI Emerging Mkts Ishares                   	AMEX      
IEO       	DJ US Oil & Gas Ex Index Ishares                  	AMEX      
IEUR      	Core Europe Ishares                               	AMEX      
IEV       	Europe 350 Ishares                                	AMEX      
IEZ       	DJ US Oil Equipment Index Ishares                 	AMEX      
IGE       	S&P Natural Resources North Amer Ishares          	AMEX      
IGEB      	Ishares Edge Investment Grade Enhanced Bond ETF   	AMEX      
IGM       	S&P Technology North Amer Ishares                 	AMEX      
IGN       	S&P Tech-Multimedia Ntwk North Amer Ishares       	AMEX      
IGRO      	Ishares Intl Dividend Growth ETF                  	AMEX      
IGV       	S&P Tech-Software North Amer Ishares              	AMEX      
IHE       	DJ US Pharmaceuticals Ishares                     	AMEX      
IHF       	DJ US Healthcare Provider Ishares                 	AMEX      
IHI       	DJ US Medical Devices Ishares                     	AMEX      
IJH       	S&P Midcap 400 Ishares                            	AMEX      
IJJ       	S&P Midcap 400 Value Ishares                      	AMEX      
IJK       	S&P Midcap 400 Growth Ishares                     	AMEX      
IJR       	S&P Smallcap 600 Index Ishares                    	AMEX      
IJS       	S&P Smallcap 600 Value Ishares                    	AMEX      
ILF       	Latin America 40 Ishares                          	AMEX      
ILTB      	10+ Year Government/Credit Bond Ishares           	AMEX      
IMTB      	Ishares Core 5 10 Year USD Bond ETF               	AMEX      
IMTM      	Ishares Intl Momentum Factor ETF                  	AMEX      
INDA      	India Index MSCI Ishares                          	AMEX      
INDF      	Ishares Industrials Multifactor                   	AMEX      
INTF      	Ishares Intl Multifactor ETF                      	AMEX      
IOO       	S&P Global 100 Ishares                            	AMEX      
IPAC      	Pacific Core Ishares                              	AMEX      
IPFF      	S&P Intl Preferred Stock Ishares                  	AMEX      
IQLT      	Ishares Intl Quality Factor ETF                   	AMEX      
ISCF      	Ishares Intl Smallcap Multifactor ETF             	AMEX      
ISZE      	Ishares Intl Size Factor ETF                      	AMEX      
ITA       	DJ US Aerospace & Defense Ishares                 	AMEX      
ITB       	DJ US Home Construction Ishares                   	AMEX      
ITOT      	S&P 1500 Ishares                                  	AMEX      
IVE       	S&P 500 Value Ishares                             	AMEX      
IVLU      	Ishares Intl Value Factor ETF                     	AMEX      
IVV       	S&P 500 Ishares                                   	AMEX      
IVW       	S&P 500 Growth Ishares                            	AMEX      
IWB       	Russell 1000 Ishares                              	AMEX      
IWC       	Russell Microcap Ishares                          	AMEX      
IWD       	Russell 1000 Value Ishares                        	AMEX      
IWF       	Russell 1000 Growth Ishares                       	AMEX      
IWL       	Russell Top 200 Ishares                           	AMEX      
IWM       	Russell 2000 Ishares                              	AMEX      
IWN       	Russell 2000 Value Ishares                        	AMEX      
IWO       	Russell 2000 Growth Ishares                       	AMEX      
IWP       	Russell Midcap Growth Ishares                     	AMEX      
IWR       	Russell Midcap Ishares                            	AMEX      
IWS       	Russell Midcap Value Ishares                      	AMEX      
IWV       	Russell 3000 Ishares                              	AMEX      
IWX       	Russell Top 200 Value Ishares                     	AMEX      
IWY       	Russell Top 200 Growth Ishares                    	AMEX      
IXC       	S&P Global Energy Ishares                         	AMEX      
IXG       	S&P Global Financials Ishares                     	AMEX      
IXJ       	S&P Global Healthcare Ishares                     	AMEX      
IXN       	S&P Global Technology Ishares                     	AMEX      
IXP       	S&P Global Telecom Ishares                        	AMEX      
IYC       	DJ US Consumer Services Ishares                   	AMEX      
IYE       	DJ US Energy Ishares                              	AMEX      
IYF       	DJ US Financial Sector Ishares                    	AMEX      
IYG       	DJ US Financial Services Ishares                  	AMEX      
IYH       	DJ US Healthcare Ishares                          	AMEX      
IYJ       	DJ US Industrial Ishares                          	AMEX      
IYK       	DJ US Consumer Goods Ishares                      	AMEX      
IYLD      	Mstar Multi-Asset Income Index Ishares            	AMEX      
IYM       	DJ US Basic Materials Ishares                     	AMEX      
IYR       	DJ US Real Estate Ishares                         	AMEX      
IYT       	DOW Transportations Ishares                       	AMEX      
IYW       	DJ US Technology Ishares                          	AMEX      
IYY       	DJ US Index Ishares                               	AMEX      
IYZ       	DJ US Telecom Ishares                             	AMEX      
JKD       	Mstar Large Core Index Ishares                    	AMEX      
JKE       	Mstar Large Growth Index Ishares                  	AMEX      
JKF       	Mstar Large Value Index Ishares                   	AMEX      
JKG       	Mstar Mid Core Index Ishares                      	AMEX      
JKH       	Mstar Mid Growth Index Ishares                    	AMEX      
JKJ       	Mstar Small Core Index Ishares                    	AMEX      
JKK       	Mstar Small Growth Index Ishares                  	AMEX      
JKL       	Mstar Small Value Index Ishares                   	AMEX      
JPMV      	Japan Minimum Vola Ishares ETF                    	AMEX      
JPXN      	Ishares Jpx-Nikkei 400 ETF                        	AMEX      
JXI       	S&P Global Utilities Ishares                      	AMEX      
KSA       	Ishares Saudi Arabia Capped ETF                   	AMEX      
KXI       	S&P Global Cons Staples Ishares                   	AMEX      
LEMB      	Emrg Mkts Local Cur Bond Ishares                  	AMEX      
LLQD      	Ishares 10  Year Investment Grade Corporate Bond  	AMEX      
LQD       	Iboxx $ Invest Grade Corp Bond Ishares            	AMEX      
LQDH      	Ishares Int-Rate Hedged Corp Bond                 	AMEX      
LRGF      	Ishares US Multifactor ETF                        	AMEX      
MATF      	Ishares Materials Multifactor                     	AMEX      
MEAR      	Ishares Short Maturity Municipal ETF              	AMEX      
MLQD      	Ishares 5-10 Year Investment Grade Corporate Bon  	AMEX      
MTUM      	USA Momentum Factor Ishares ETF                   	AMEX      
MUB       	S&P National Amt-Free Muni Bd Ishares             	AMEX      
MXI       	S&P Global Materials Ishares                      	AMEX      
NEAR      	Maturity Bond Short Ishares                       	AMEX      
NYF       	S&P NY Municipal Bond Ishares                     	AMEX      
OEF       	S&P 100 Ishares                                   	AMEX      
PICK      	Global Sel Metals & Mining Prd MSCI Ishares       	AMEX      
QCAN      	Canada Quality Mix Ishares ETF                    	AMEX      
QDEU      	Germany Quality Mix Ishares ETF                   	AMEX      
QGBR      	UK Quality Mix Ishares ETF                        	AMEX      
QJPN      	Japan Quality Mix Ishares ETF                     	AMEX      
QLTA      	AAA - A Rated Corporate Bond Ishares              	AMEX      
QUAL      	USA Quality Factor Ishares ETF                    	AMEX      
REET      	Ishares Global REIT ETF                           	AMEX      
REM       	FTSE Nareit Mort Plus Cp Idx Ishares              	AMEX      
REZ       	Ishares Residential Real Estate ETF               	AMEX      
RXI       	S&P Global Cons Disc Ishares                      	AMEX      
SCJ       	Japan Smallcap MSCI Ishares                       	AMEX      
SHYG      	0-5 Year Hi Yld Core Ishares                      	AMEX      
SIZE      	USA Size Factor Ishares ETF                       	AMEX      
SLV       	Silver Trust Ishares                              	AMEX      
SLVP      	Global Silver Miners MSCI Ishares                 	AMEX      
SMIN      	India Smallcap MSCI Ishares                       	AMEX      
SMLF      	Ishares US Smallcap Multifactor ETF               	AMEX      
SMMD      	Ishares Trust                                     	AMEX      
SMMV      	Ishares Min Vol USA Smallcap ETF                  	AMEX      
STIP      	0-5 Year TIPS Bond Ishares                        	AMEX      
SUB       	S&P S/T National Muni Bond Ishares                	AMEX      
SUSA      	Ishares Trust                                     	AMEX      
TCHF      	Ishares Technology Multifactor                    	AMEX      
TFLO      	Treasury Floating Rate Ishares                    	AMEX      
THD       	Thailand Index MSCI Ishares                       	AMEX      
TIP       	TIPS Bond Ishares                                 	AMEX      
TLH       	10-20 Year Treasury Bd Ishares                    	AMEX      
TOK       	Kokusai Index MSCI Ishares                        	AMEX      
URTH      	World Index MSCI Ishares                          	AMEX      
USMV      	US Min Vol MSCI Ishares                           	AMEX      
USRT      	Ishares Core US REIT ETF                          	AMEX      
UTLF      	Ishares Utilities Multifactor                     	AMEX      
VEGI      	Global Agriculture Prod MSCI Ishares              	AMEX      
VLUE      	USA Value Factor Ishares ETF                      	AMEX      
WPS       	S&P Dev Ex-US Property Ishares                    	AMEX      
IAF       	Ishares Ubs Composite Bond Index Fund             	ASX       
IEM       	iShares MSCI Emerging Markets                     	ASX       
IEU       	iShares S&P Europe 350                            	ASX       
IGB       	Ishares Ubs Treasury Index Fund                   	ASX       
IHD       	Ishares S&p/asx High Dividend                     	ASX       
IHK       	iShares MSCI Hong Kong                            	ASX       
IJH       	iShares S&P Midcap 400                            	ASX       
IJP       	iShares MSCI Japan                                	ASX       
IJR       	iShares S&P Smallcap 600                          	ASX       
IKO       	iShares MSCI South Korea                          	ASX       
ILB       	Ishares Ubs Government Inflation Index Fund       	ASX       
ILC       	Ishares S&p/asx 20                                	ASX       
IOO       	iShares S&P Global 100                            	ASX       
IOZ       	Ishares Msci Australia 200                        	ASX       
IRU       	iShares Russell 2000                              	ASX       
ISG       	iShares MSCI Singapore                            	ASX       
ISO       	Ishares S&p/asx Small Ordinaries                  	ASX       
ITW       	iShares MSCI Taiwan                               	ASX       
IVE       	iShares MSCI Eafe                                 	ASX       
IVV       	iShares S&P 500                                   	ASX       
IZZ       	iShares FTSE Xinhua China                         	ASX       
AGED      	Ishares IV Plc                                    	LSE       
AGES      	Ishares IV Plc                                    	LSE       
BACK      	Ishares IV Plc                                    	LSE       
BACS      	Ishares IV Plc                                    	LSE       
BRIC      	Ishares II Plc                                    	LSE       
CBE0      	Ishares Vii Plc                                   	LSE       
CBE3      	Ishares Vii Plc                                   	LSE       
CBE7      	Ishares Vii Plc                                   	LSE       
CBR1      	Ishares Vii Plc                                   	LSE       
CBU0      	Ishares Vii Plc                                   	LSE       
CBU3      	Ishares Vii Plc                                   	LSE       
CBU7      	Ishares Vii Plc                                   	LSE       
CCAU      	Ishares Vii Plc                                   	LSE       
CE01      	Ishares Vii Plc                                   	LSE       
CE31      	Ishares Vii Plc                                   	LSE       
CE71      	Ishares Vii Plc                                   	LSE       
CEA1      	Ishares Vii Plc                                   	LSE       
CEMG      	Ishares V Public Limited                          	LSE       
CES1      	Ishares Vii Plc                                   	LSE       
CEU1      	Ishares Vii Plc                                   	LSE       
CID1      	Ishares Vii Plc                                   	LSE       
CJPU      	Ishares Vii Plc                                   	LSE       
CKR1      	Ishares Vii Plc                                   	LSE       
CMB1      	Ishares Vii Plc                                   	LSE       
CMX1      	Ishares Vii Plc                                   	LSE       
CNX1      	Ishares Vii Plc                                   	LSE       
CNYA      	Ishares IV Plc                                    	LSE       
COMM      	Ishares Vi Plc                                    	LSE       
CORP      	Ishares Plc                                       	LSE       
CPJ1      	Ishares Vii Plc                                   	LSE       
CRPH      	Ishares Vi Plc (The Comp                          	LSE       
CRPS      	Ishares Plc                                       	LSE       
CRPU      	Ishares Plc                                       	LSE       
CRU1      	Ishares Vii Plc                                   	LSE       
CS51      	Ishares Vii Plc                                   	LSE       
CSP1      	Ishares Vii Plc                                   	LSE       
CSX5      	Ishares Vii Plc                                   	LSE       
CU01      	Ishares Vii Plc                                   	LSE       
CU1       	Ishares Vii Plc                                   	LSE       
CU31      	Ishares Vii Plc                                   	LSE       
CU71      	Ishares Vii Plc                                   	LSE       
CUS1      	Ishares Vii Plc                                   	LSE       
DBRC      	Ishares II Plc                                    	LSE       
DEIN      	Ishares II Plc                                    	LSE       
DGIT      	Ishares IV Plc                                    	LSE       
DGTL      	Ishares IV Plc                                    	LSE       
DH2O      	Ishares II Plc                                    	LSE       
DJMC      	Ishares Plc                                       	LSE       
DJSC      	Ishares Plc                                       	LSE       
DLTM      	Ishares II Plc                                    	LSE       
DNRG      	Ishares II Plc                                    	LSE       
DRDR      	Ishares IV Plc                                    	LSE       
DTLE      	Ishares IV Plc                                    	LSE       
DWOD      	Ishares II Plc                                    	LSE       
E20Y      	Ishares IV Plc                                    	LSE       
EEMB      	Ishares II Plc                                    	LSE       
EEX5      	Ishares III Plc                                   	LSE       
EEXF      	Ishares III Plc                                   	LSE       
EG20      	Ishares IV Plc                                    	LSE       
EGIL      	Ishares III Plc                                   	LSE       
EGLN      	Ishares Physical Metals Plc                       	LSE       
EI18      	Ishares IV Plc                                    	LSE       
EIMI      	Ishares Plc                                       	LSE       
EMBE      	Ishares Vi Plc (The Comp                          	LSE       
EMCP      	Ishares V Public Limited Company                  	LSE       
EMCR      	Ishares V Public Limited Company                  	LSE       
EMID      	Ishares Vi Plc                                    	LSE       
EMIM      	Ishares Plc                                       	LSE       
EMMV      	Ishares Vi Plc (The Comp                          	LSE       
EMUL      	Ishares IV Plc                                    	LSE       
EMUM      	Ishares IV Plc                                    	LSE       
EMUU      	Ishares Vii Plc                                   	LSE       
EMV       	Ishares Vi Plc (The Comp                          	LSE       
EQDS      	Ishares II Plc                                    	LSE       
EQDV      	Ishares II Plc                                    	LSE       
ERN1      	Ishares IV Plc                                    	LSE       
ERND      	Ishares IV Plc                                    	LSE       
ERNE      	Ishares IV Plc                                    	LSE       
ERNS      	Ishares IV Plc                                    	LSE       
ERNU      	Ishares IV Plc                                    	LSE       
ES15      	Ishares Plc                                       	LSE       
EUCF      	Ishares Vi Plc (The Comp                          	LSE       
EUE       	Ishares II Plc                                    	LSE       
EULC      	Ishares IV Plc                                    	LSE       
EUMC      	Ishares IV Plc                                    	LSE       
EUMD      	Ishares Vi Plc                                    	LSE       
EUN       	Ishares II Plc                                    	LSE       
EUXS      	Ishares Plc                                       	LSE       
EXFN      	Ishares II Plc                                    	LSE       
FLO5      	Ishares II Plc                                    	LSE       
FLOE      	Ishares II Plc                                    	LSE       
FLOS      	Ishares II Plc                                    	LSE       
FLOT      	Ishares II Plc                                    	LSE       
FSEU      	Ishares IV Plc                                    	LSE       
FSUS      	Ishares IV Plc                                    	LSE       
FSWD      	Ishares IV Plc                                    	LSE       
FXC       	Ishares Plc                                       	LSE       
GHYS      	Ishares Vi Plc (The Comp                          	LSE       
HDIQ      	Ishares II Plc                                    	LSE       
HEAL      	Ishares IV Plc                                    	LSE       
HYLD      	Ishares Plc                                       	LSE       
IAAA      	Ishares Vi Plc (The Comp                          	LSE       
IAEX      	Ishares Plc                                       	LSE       
IAPD      	Ishares Plc                                       	LSE       
IASH      	Ishares IV Plc                                    	LSE       
IASP      	Ishares II Plc                                    	LSE       
IAUP      	Ishares V Public Limited Company                  	LSE       
IAUS      	Ishares III Plc                                   	LSE       
IBC1      	Ishares Plc                                       	LSE       
IBCI      	Ishares Plc                                       	LSE       
IBCX      	Ishares Plc                                       	LSE       
IBGE      	Ishares III Plc                                   	LSE       
IBGL      	Ishares II Plc                                    	LSE       
IBGM      	Ishares II Plc                                    	LSE       
IBGS      	Ishares Plc                                       	LSE       
IBGX      	Ishares II Plc                                    	LSE       
IBGY      	Ishares III Plc                                   	LSE       
IBTA      	Ishares Plc                                       	LSE       
IBTL      	Ishares IV Plc                                    	LSE       
IBTM      	Ishares II Plc                                    	LSE       
IBTS      	Ishares Plc                                       	LSE       
IBZL      	Ishares Plc                                       	LSE       
ICBU      	Ishares III Plc                                   	LSE       
ICDU      	Ishares V Public Limited Company                  	LSE       
ICOM      	Ishares Vi Plc                                    	LSE       
ICOV      	Ishares III Plc                                   	LSE       
ICSU      	Ishares V Public Limited Company                  	LSE       
IDAP      	Ishares Plc                                       	LSE       
IDAR      	Ishares II Plc                                    	LSE       
IDBT      	Ishares Plc                                       	LSE       
IDBZ      	Ishares Plc                                       	LSE       
IDEE      	Ishares Plc                                       	LSE       
IDEM      	Ishares Plc                                       	LSE       
IDEU      	Ishares V Public Limited Company                  	LSE       
IDFE      	Ishares II Plc                                    	LSE       
IDFF      	Ishares Plc                                       	LSE       
IDFX      	Ishares Plc                                       	LSE       
IDIN      	Ishares II Plc                                    	LSE       
IDJG      	Ishares Plc                                       	LSE       
IDJP      	Ishares III Plc                                   	LSE       
IDJV      	Ishares Plc                                       	LSE       
IDKO      	Ishares Plc                                       	LSE       
IDNA      	Ishares Plc                                       	LSE       
IDP6      	Ishares III Plc                                   	LSE       
IDPE      	Ishares II Plc                                    	LSE       
IDTK      	Ishares II Plc                                    	LSE       
IDTL      	Ishares IV Plc                                    	LSE       
IDTM      	Ishares II Plc                                    	LSE       
IDTP      	Ishares II Plc                                    	LSE       
IDTW      	Ishares Plc                                       	LSE       
IDUP      	Ishares II Plc                                    	LSE       
IDUS      	Ishares Plc                                       	LSE       
IDVY      	Ishares Plc                                       	LSE       
IDWP      	Ishares II Plc                                    	LSE       
IDWR      	Ishares Plc                                       	LSE       
IE15      	Ishares III Plc                                   	LSE       
IEAA      	Ishares III Plc                                   	LSE       
IEAC      	Ishares III Plc                                   	LSE       
IEAG      	Ishares III Plc                                   	LSE       
IEBB      	Ishares III Plc                                   	LSE       
IEBC      	Ishares III Plc                                   	LSE       
IECF      	Ishares Vi Plc (The Comp                          	LSE       
IEDY      	Ishares V Public Limited Company                  	LSE       
IEEM      	Ishares Plc                                       	LSE       
IEER      	Ishares Plc                                       	LSE       
IEEU      	Ishares IV Plc                                    	LSE       
IEFM      	Ishares IV Plc                                    	LSE       
IEFQ      	Ishares IV Plc                                    	LSE       
IEFS      	Ishares IV Plc                                    	LSE       
IEFV      	Ishares IV Plc                                    	LSE       
IEGA      	Ishares III Plc                                   	LSE       
IEGE      	Ishares III Plc                                   	LSE       
IEGL      	Ishares II Plc                                    	LSE       
IEGM      	Ishares II Plc                                    	LSE       
IEGS      	Ishares Plc                                       	LSE       
IEGX      	Ishares II Plc                                    	LSE       
IEGY      	Ishares III Plc                                   	LSE       
IEGZ      	Ishares III Plc                                   	LSE       
IEMA      	Ishares III Plc                                   	LSE       
IEMB      	Ishares II Plc                                    	LSE       
IEMG      	Ishares V Public Limited                          	LSE       
IEMI      	Ishares II Plc                                    	LSE       
IEML      	Ishares III Plc                                   	LSE       
IEMO      	Ishares IV Plc                                    	LSE       
IEMS      	Ishares III Plc                                   	LSE       
IEMU      	Ishares Vii Plc                                   	LSE       
IEQU      	Ishares IV Plc                                    	LSE       
IESE      	Ishares II Plc                                    	LSE       
IESG      	Ishares II Plc                                    	LSE       
IESP      	Ishares V Public Limited Company                  	LSE       
IESU      	Ishares V Public Limited Company                  	LSE       
IESZ      	Ishares IV Plc                                    	LSE       
IEUR      	Ishares Plc                                       	LSE       
IEUT      	Ishares Plc                                       	LSE       
IEUX      	Ishares Plc                                       	LSE       
IEVL      	Ishares IV Plc                                    	LSE       
IEX5      	Ishares III Plc                                   	LSE       
IEXF      	Ishares III Plc                                   	LSE       
IFFF      	Ishares Plc                                       	LSE       
IFRB      	Ishares V Public Limited Company                  	LSE       
IFRE      	Ishares IV Plc                                    	LSE       
IFSE      	Ishares IV Plc                                    	LSE       
IFSU      	Ishares IV Plc                                    	LSE       
IFSW      	Ishares IV Plc                                    	LSE       
IGEA      	Ishares III Plc                                   	LSE       
IGHY      	Ishares Plc                                       	LSE       
IGIL      	Ishares III Plc                                   	LSE       
IGLN      	Ishares Physical Metals Plc                       	LSE       
IGLO      	Ishares III Plc                                   	LSE       
IGLS      	Ishares III Plc                                   	LSE       
IGLT      	Ishares II Plc                                    	LSE       
IGSD      	Ishares IV Plc                                    	LSE       
IGSG      	Ishares II Plc                                    	LSE       
IGSU      	Ishares II Plc                                    	LSE       
IGUS      	Ishares V Public Limited Company                  	LSE       
IGWD      	Ishares V Public Limited Company                  	LSE       
IH2O      	Ishares II Plc                                    	LSE       
IHCU      	Ishares V Public Limited Company                  	LSE       
IHYA      	Ishares II Plc                                    	LSE       
IHYG      	Ishares Plc                                       	LSE       
IHYU      	Ishares II Plc                                    	LSE       
IISU      	Ishares V Public Limited Company                  	LSE       
IITB      	Ishares V Public Limited Company                  	LSE       
IITU      	Ishares V Public Limited Company                  	LSE       
IJPA      	Ishares III Plc                                   	LSE       
IJPD      	Ishares Plc                                       	LSE       
IJPE      	Ishares MSCI Japan EUR Hedged                     	LSE       
IJPH      	Ishares V Public Limited Company                  	LSE       
IJPN      	Ishares Plc                                       	LSE       
IJPU      	Ishares Plc                                       	LSE       
IKOR      	Ishares Plc                                       	LSE       
IMBA      	Ishares IV Plc                                    	LSE       
IMBS      	Ishares IV Plc                                    	LSE       
IMEA      	Ishares III Plc                                   	LSE       
IMEU      	Ishares II Plc                                    	LSE       
IMIB      	Ishares II Plc                                    	LSE       
IMV       	Ishares Vi Plc (The Comp                          	LSE       
IMVU      	Ishares Vi Plc (The Company)                      	LSE       
INAA      	Ishares Plc                                       	LSE       
INFR      	Ishares II Plc                                    	LSE       
INRG      	Ishares II Plc                                    	LSE       
INXG      	Ishares II Plc                                    	LSE       
IOGP      	Ishares V Public Limited Company                  	LSE       
IPDM      	Ishares Physical Metals Plc                       	LSE       
IPLT      	Ishares Physical Metals Plc                       	LSE       
IPOL      	Ishares V Public Limited Company                  	LSE       
IPRP      	Ishares Plc                                       	LSE       
IPRV      	Ishares II Plc                                    	LSE       
IPXJ      	Ishares III Plc                                   	LSE       
IRCP      	Ishares V Public Limited                          	LSE       
IRHC      	Ishares V Public Limited                          	LSE       
IRSA      	Ishares III Plc                                   	LSE       
IS15      	Ishares Plc                                       	LSE       
ISAC      	Ishares V Public Limited Company                  	LSE       
ISAG      	Ishares V Public Limited Company                  	LSE       
ISBB      	Ishares III Plc                                   	LSE       
ISDE      	Ishares II Plc                                    	LSE       
ISDU      	Ishares II Plc                                    	LSE       
ISDW      	Ishares II Plc                                    	LSE       
ISEM      	Ishares II Plc                                    	LSE       
ISEU      	Ishares II Plc                                    	LSE       
ISF       	Ishares Plc                                       	LSE       
ISFE      	Ishares II Plc                                    	LSE       
ISFR      	Ishares IV Plc                                    	LSE       
ISFU      	Ishares Plc                                       	LSE       
ISJP      	Ishares III Plc                                   	LSE       
ISLN      	Ishares Physical Metals Plc                       	LSE       
ISP6      	Ishares III Plc                                   	LSE       
ISRL      	Ishares IV Plc                                    	LSE       
ISUS      	Ishares II Plc                                    	LSE       
ISWD      	Ishares II Plc                                    	LSE       
ISX5      	Ishares Vii Plc                                   	LSE       
ISXF      	Ishares III Plc                                   	LSE       
ITKY      	Ishares II Plc                                    	LSE       
ITPS      	Ishares II Plc                                    	LSE       
ITWN      	Ishares Plc                                       	LSE       
IUAA      	Ishares II Plc                                    	LSE       
IUAG      	Ishares II Plc                                    	LSE       
IUCD      	Ishares V Public Limited Company                  	LSE       
IUCS      	Ishares V Public Limited Company                  	LSE       
IUES      	Ishares V Public Limited Company                  	LSE       
IUFS      	Ishares V Public Limited Company                  	LSE       
IUHC      	Ishares V Public Limited Company                  	LSE       
IUIS      	Ishares V Public Limited Company                  	LSE       
IUIT      	Ishares V Public Limited Company                  	LSE       
IUKD      	Ishares Plc                                       	LSE       
IUKP      	Ishares II Plc                                    	LSE       
IUMF      	Ishares IV Plc                                    	LSE       
IUMO      	Ishares IV Plc                                    	LSE       
IUQA      	Ishares IV Plc                                    	LSE       
IUSA      	Ishares Plc                                       	LSE       
IUSE      	Ishares V Public Limited Company                  	LSE       
IUSF      	Ishares IV Plc                                    	LSE       
IUSP      	Ishares II Plc                                    	LSE       
IUSU      	Ishares V Public Limited Company                  	LSE       
IUSZ      	Ishares IV Plc                                    	LSE       
IUUS      	Ishares V Public Limited Company                  	LSE       
IUVF      	Ishares IV Plc                                    	LSE       
IUVL      	Ishares IV Plc                                    	LSE       
IWDA      	Ishares III Plc                                   	LSE       
IWDE      	Ishares V Public Limited Company                  	LSE       
IWDG      	Ishares III Plc                                   	LSE       
IWDP      	Ishares II Plc                                    	LSE       
IWFM      	Ishares IV Plc                                    	LSE       
IWFQ      	Ishares IV Plc                                    	LSE       
IWFS      	Ishares IV Plc                                    	LSE       
IWFV      	Ishares IV Plc                                    	LSE       
IWMO      	Ishares IV Plc                                    	LSE       
IWQU      	Ishares IV Plc                                    	LSE       
IWRD      	Ishares Plc                                       	LSE       
IWSZ      	Ishares IV Plc                                    	LSE       
IWVL      	Ishares IV Plc                                    	LSE       
JPEA      	Ishares II Plc                                    	LSE       
JPEE      	Ishares II Plc                                    	LSE       
LQDA      	Ishares Plc                                       	LSE       
LQDE      	Ishares Plc                                       	LSE       
LQDG      	Ishares Plc                                       	LSE       
LQDH      	Ishares Plc                                       	LSE       
LQDS      	Ishares Plc                                       	LSE       
LQEE      	Ishares Plc                                       	LSE       
LTAM      	Ishares II Plc                                    	LSE       
MIDD      	Ishares Plc                                       	LSE       
MINV      	Ishares Vi Plc (The Comp                          	LSE       
MVEU      	Ishares Vi Plc (The Comp                          	LSE       
MVOL      	Ishares Vi Plc (The Comp                          	LSE       
MVUS      	Ishares Vi Plc (The Comp                          	LSE       
NK4E      	Ishares II Plc                                    	LSE       
OMXS      	Ishares IV Plc                                    	LSE       
QDIV      	Ishares II Plc                                    	LSE       
RBOT      	Ishares IV Plc                                    	LSE       
RBTX      	Ishares IV Plc                                    	LSE       
RISE      	Ishares IV Plc                                    	LSE       
SAAA      	Ishares Vi Plc (The Comp                          	LSE       
SAUS      	Ishares III Plc                                   	LSE       
SCOV      	Ishares III Plc                                   	LSE       
SDEU      	Ishares V Public Limited Company                  	LSE       
SDHG      	Ishares IV Plc                                    	LSE       
SDHY      	Ishares IV Plc                                    	LSE       
SDIA      	Ishares IV Plc                                    	LSE       
SDIG      	Ishares IV Plc                                    	LSE       
SE15      	Ishares III Plc                                   	LSE       
SEAG      	Ishares III Plc                                   	LSE       
SEDY      	Ishares V Public Limited Company                  	LSE       
SEGA      	Ishares III Plc                                   	LSE       
SEMA      	Ishares III Plc                                   	LSE       
SEMB      	Ishares II Plc                                    	LSE       
SEML      	Ishares III Plc                                   	LSE       
SEMS      	Ishares III Plc                                   	LSE       
SESP      	Ishares V Public Limited Company                  	LSE       
SFRB      	Ishares V Public Limited Company                  	LSE       
SGEA      	Ishares III Plc                                   	LSE       
SGIL      	Ishares III Plc                                   	LSE       
SGLN      	Ishares Physical Metals Plc                       	LSE       
SGLO      	Ishares III Plc                                   	LSE       
SHYG      	Ishares Plc                                       	LSE       
SHYU      	Ishares II Plc                                    	LSE       
SITB      	Ishares V Public Limited Company                  	LSE       
SJPA      	Ishares III Plc                                   	LSE       
SLXX      	Ishares Plc                                       	LSE       
SMBS      	Ishares IV Plc                                    	LSE       
SMEA      	Ishares III Plc                                   	LSE       
SPAG      	Ishares V Public Limited Company                  	LSE       
SPDM      	Ishares Physical Metals Plc                       	LSE       
SPGP      	Ishares V Public Limited Company                  	LSE       
SPLT      	Ishares Physical Metals Plc                       	LSE       
SPME      	Ishares Vi Plc (The Company)                      	LSE       
SPMV      	Ishares Vi Plc (The Comp                          	LSE       
SPOG      	Ishares V Public Limited Company                  	LSE       
SPOL      	Ishares V Public Limited Company                  	LSE       
SPXJ      	Ishares III Plc                                   	LSE       
SRSA      	Ishares III Plc                                   	LSE       
SSAC      	Ishares V Public Limited Company                  	LSE       
SSLN      	Ishares Physical Metals Plc                       	LSE       
SSXF      	Ishares III Plc                                   	LSE       
SUAG      	Ishares II Plc                                    	LSE       
SUAS      	Ishares IV Plc                                    	LSE       
SUES      	Ishares IV Plc                                    	LSE       
SUJA      	Ishares IV Plc                                    	LSE       
SUJP      	Ishares IV Plc                                    	LSE       
SUJS      	Ishares IV Plc                                    	LSE       
SUSE      	Ishares II Plc                                    	LSE       
SUSJ      	Ishares IV Plc                                    	LSE       
SUSM      	Ishares IV Plc                                    	LSE       
SUSS      	Ishares II Plc                                    	LSE       
SUUS      	Ishares IV Plc                                    	LSE       
SWDA      	Ishares III Plc                                   	LSE       
SXFN      	Ishares II Plc                                    	LSE       
TASE      	Ishares IV Plc                                    	LSE       
TIP5      	Ishares II Plc                                    	LSE       
UI18      	Ishares IV Plc                                    	LSE       
UIFS      	Ishares V Public Limited Company                  	LSE       
UKRE      	Ishares III Plc                                   	LSE       
USPR      	Ishares III Plc                                   	LSE       
USRE      	Ishares III Plc                                   	LSE       
WING      	Ishares IV Plc                                    	LSE       
WOOD      	Ishares II Plc                                    	LSE       
WQDS      	Ishares II Plc                                    	LSE       
WQDV      	Ishares II Plc                                    	LSE       
EUE       	Ishares Euro STOX50                               	MLSE      
AAXJ      	Ishares Aca X-Japan ETF                           	NASDAQ    
ACWI      	Ishares ACWI ETF                                  	NASDAQ    
ACWX      	Ishares ACWI Ex-US ETF                            	NASDAQ    
AIA       	Ishares Asia 50 ETF                               	NASDAQ    
AMCA      	Ishares Russell 1000 Pure U.S. Revenue ETF        	NASDAQ    
CIU       	Interm Credit Bd Ishares                          	NASDAQ    
COMT      	Ishares Commodities Select Strategy ETF           	NASDAQ    
CRED      	Core US Credit Bond ETF Ishares                   	NASDAQ    
CSJ       	1-3 Year Credit Bond Ishares                      	NASDAQ    
DVY       	DJ Select Dividend Index Ishares                  	NASDAQ    
EEMA      	Ishares EM Asia ETF                               	NASDAQ    
EMB       	USD Emrg Mkts Bond Ishares                        	NASDAQ    
EMIF      	Ishares EM Infrastructure ETF                     	NASDAQ    
EMXC      	Ishares Inc. Ishares MSCI Emerging Markets Ex C   	NASDAQ    
ENZL      	New Zealand Index MSCI Ishares                    	NASDAQ    
ESGD      	Ishares EAFE ESG Select ETF                       	NASDAQ    
ESGE      	Ishares EM ESG Select ETF                         	NASDAQ    
ESGU      	Ishares US ESG Optimized ETF                      	NASDAQ    
EUFN      	Ishares Europe Financials ETF                     	NASDAQ    
EWZS      	Ishares Brazil Smallcap ETF                       	NASDAQ    
FALN      	Ishares Fallen Angels USD Bond                    	NASDAQ    
GNMA      	Ishares GNMA Bond ETF                             	NASDAQ    
HEWG      	MSCI Germany Ishares Currency Hedged              	NASDAQ    
HYXE      	Ishares Iboxx $ High Yield Ex O                   	NASDAQ    
ICLN      	Ishares Global Clean Energy ETF                   	NASDAQ    
IEF       	7-10 Year Treasury Ishares                        	NASDAQ    
IEI       	3-7 Year Treasury Bond Ishares                    	NASDAQ    
IEUS      	Ishares Europe ETF                                	NASDAQ    
IFEU      	Ishares Europe Developed                          	NASDAQ    
IFGL      	Ishares Intl Devp Real Estate ETF                 	NASDAQ    
IGF       	Ishares Global Infrastructure ETF                 	NASDAQ    
IGOV      	Ishares Intl Treasury Bond ETF                    	NASDAQ    
IJT       	S&P Smallcap 600 Growth Ishares                   	NASDAQ    
INDY      	Ishares India 50 ETF                              	NASDAQ    
ISHG      	1-3 Year Intl Treas Bond Ishares                  	NASDAQ    
ISTB      	Core Short-Term US Bond Ishares                   	NASDAQ    
IUSB      	Universal Bond Ishares                            	NASDAQ    
IUSG      	Core US Growth Ishares                            	NASDAQ    
IUSV      	Core US Value ETF Ishares                         	NASDAQ    
IXUS      	Ishares Core Total International Stock ETF        	NASDAQ    
JKI       	Ishares Mid-Cap Value ETF                         	NASDAQ    
MBB       	MBS Bond Ishares                                  	NASDAQ    
MCHI      	China Index MSCI Ishares                          	NASDAQ    
MPCT      	Ishares Global Impact ETF                         	NASDAQ    
PFF       	S&P US Preferred Stock Ishares                    	NASDAQ    
QAT       	Ishares Qatar Capped ETF                          	NASDAQ    
RING      	Global Gold Miners MSCI Ishares                   	NASDAQ    
SCZ       	Ishares EAFE Smallcap ETF                         	NASDAQ    
SHV       	Short-Treasury Bond Ishares                       	NASDAQ    
SHY       	1-3 Year Treasury Bond Ishares                    	NASDAQ    
SLQD      	0-5 Year Ivst Grade Corp Bond Ishares             	NASDAQ    
SOXX      	Ishares PHLX Semiconductor ETF                    	NASDAQ    
SUSB      	Ishares Trust Ishares ESG 1-5 Year USD Corporate  	NASDAQ    
SUSC      	Ishares Trust Ishares ESG USD Corporate Bond ETF  	NASDAQ    
TLT       	20 Year Bond Ishares                              	NASDAQ    
TUR       	Turkey Index MSCI Ishares                         	NASDAQ    
UAE       	Ishares UAE Capped ETF                            	NASDAQ    
WOOD      	Ishares Global Timber & Forestry ETF              	NASDAQ    
XT        	Ishares Exponential Technologies                  	NASDAQ    
BCYIF     	Ishares Plc FTSE 100                              	OTCBB     
CLAYF     	Ishares 1-5 Year Laddered Corporate Bond Index E  	OTCBB     
CLYLF     	Ishares S&P/Tsx Canadian Dividend Aristocrats In  	OTCBB     
CYSXF     	Ishares S&P/Tsx Canadian Preferred Share Index E  	OTCBB     
ICDZF     	Ishares Canadian Hybrid Corp Bond ETF             	OTCBB     
IHHFF     	Ishares US Aggregate Bond Ucits ETF               	OTCBB     
IHIHF     	Ishares III Plc Shs USD                           	OTCBB     
IHPCF     	Ishares Plc                                       	OTCBB     
IHRMF     	Ishares MSCI Japan                                	OTCBB     
IHSFF     	Ishares II Plc                                    	OTCBB     
IHSRF     	Ishares Edge S&P 500 Minimum Volatility Ucits Et  	OTCBB     
IHSZF     	Ishares II Plc                                    	OTCBB     
IIREF     	Ishares MSCI World                                	OTCBB     
IMSEF     	Ishares II Plc MSCI Europe EUR Ucits ETF Inc      	OTCBB     
INITF     	Ishares Dex Short Term Bond Index Fund            	OTCBB     
IPYYF     	Ishares Physical Metals Plc - Ishares Physical G  	OTCBB     
IREMF     	Ishares MSCI                                      	OTCBB     
IRRRF     	Ishares Core MSCI World Ucits ETF USD [Acc]       	OTCBB     
IRSHF     	Ishares S&P/Tsx Capp                              	OTCBB     
ISAPF     	Ishares Plc Accum Ptg Shs ETF USD                 	OTCBB     
ISDJF     	Ishares DOW Jones CD                              	OTCBB     
ISESF     	Ishares S&P/Tsx Capp                              	OTCBB     
ISEXF     	Ishares MSCI AC Far East Ex-Japan Ucits ETF       	OTCBB     
ISHFF     	Ishares $ Short Duration Corp Bd Ucits ETF        	OTCBB     
ISHHF     	Ishares Plc Shs ETF EUR                           	OTCBB     
ISHOF     	Ishares III                                       	OTCBB     
ISHPF     	Ishares Emerging Markets Dividend Ucits ETF       	OTCBB     
ISPFF     	Ishares II Plc Developed Mkts Pt Yld USD Ucits E  	OTCBB     
ISRCF     	Ishares V Plc MSCI World IT USD                   	OTCBB     
ISRHF     	Ishares V Plc MSCI World Energy USD               	OTCBB     
ISRMF     	Ishares MSCI                                      	OTCBB     
ISRPF     	Ishares Plc                                       	OTCBB     
ISRUF     	Ishares V Plc MSCI World Financials USD           	OTCBB     
ISRVF     	Ishares V Plc Accum Ordinary Sh                   	OTCBB     
ISRWF     	Ishares II Plc                                    	OTCBB     
ISRZF     	Ishares II Plc                                    	OTCBB     
ISSGF     	Ishares 1-10 Year Laddered Government Bond Index  	OTCBB     
ISSHF     	Ishares $ Treasury Bond 7-10Yr Ucits ETF          	OTCBB     
ISSIF     	Ishares III Plc                                   	OTCBB     
ISUPF     	Ishares US Property Yield Ucits ETF               	OTCBB     
ISVFF     	Ishares V Plc MSCI World Health Care USD          	OTCBB     
ISVPF     	Ishares MSCI EMU USD Hedged Ucits ETF [Acc]       	OTCBB     
ISXIF     	Ishares Bse Sensex                                	OTCBB     
ISXPF     	Ishares Plc Ptg Shs ETF USD                       	OTCBB     
ITBFF     	Ishares $ Treasury Bond 1-3Yr Ucits ETF           	OTCBB     
IUNSF     	Ishares S&P/Tsx Capp                              	OTCBB     
IVIVF     	Ishares Vi Plc Shs ETF USD                        	OTCBB     
IVVVF     	Ishares $ Short Duration Hi Yld Corp Bd Ucits Et  	OTCBB     
IZIZF     	Ishares III Plc                                   	OTCBB     
N6M       	Ishares Usd Asia Bond Etf                         	SGX       
O9P       	Ishares Usd Asia Hy Bond Etf                      	SGX       
QL2       	Ishares Usd Asia Bond Etf S$                      	SGX       
QL3       	Ishares Usd Asia Hy Bond Etfs$                    	SGX       
CBD       	Ishares Balanced Income Core ETF                  	TSX       
CBD.A     	Ishares Balanced Income Core ETF AC               	TSX       
CBH       	Ishares 1-10 Yr Laddered Corp Bond ETF            	TSX       
CBH.A     	Ishares 1-10Yr Laddered ETF                       	TSX       
CBN       	Ishares Balanced Growth Core ETF                  	TSX       
CBN.A     	Ishares Balanced Growth Core ETF AC               	TSX       
CBO       	Ishares 1-5Yr Laddered Corp Bond ETF              	TSX       
CBO.A     	Ishares 1-5Yr Laddered Corp Bond ETF AC           	TSX       
CBQ       	Ishares BRIC ETF                                  	TSX       
CBQ.A     	Ishares BRIC ETF AC                               	TSX       
CDZ       	Ishares SP TSX CDN Dividend ETF                   	TSX       
CDZ.A     	Ishares SP TSX CDN Dividend ETF AC                	TSX       
CEW       	Ishares Equal Weight Banc Lifeco ETF              	TSX       
CEW.A     	Ishares Equal Weight Banc Lifeco ETF AC           	TSX       
CGL       	Ishares Gold Bullion ETF Hdg                      	TSX       
CGL.C     	Ishares Gold Bullion ETF Non Hdg                  	TSX       
CGR       	Ishares Global Real Estate ETF                    	TSX       
CGR.A     	Ishares Global Real Estate ETF AC                 	TSX       
CHB       	Ishares US HY Fixed Income Index ETF              	TSX       
CHB.A     	Ishares US HY Fixed Income Index ETF AC           	TSX       
CIF       	Ishares Global Infrastructure Index ETF           	TSX       
CIF.A     	Ishares Global Infrastructure ETF AC              	TSX       
CLF       	Ishares 1-5 Yr Ladder Govt Bond ETF               	TSX       
CLF.A     	Ishares 1-5 Yr Ladder Govt Bond ETF AC            	TSX       
CLG       	Ishares 1-10 Yr Ladder Govt Bond ETF              	TSX       
CLG.A     	Ishares 1-10Yr Ladder Govt Bond ETF AC            	TSX       
CMR       	Ishares Premium Money Market ETF                  	TSX       
CMR.A     	Ishares Premium Money Market ETF AC               	TSX       
COW       	Ishares Global Agri Index ETF                     	TSX       
COW.A     	Ishares Global Agri Index ETF AC                  	TSX       
CPD       	Ishares SP TSX CDN Pref ETF                       	TSX       
CPD.A     	Ishares SP TSX CDN Pref ETF AC                    	TSX       
CSD       	Ishares Short Dur Hi Inc ETF CAD Hgd              	TSX       
CSD.A     	Ishares Adv Shrt Dur Hi Inc ETF                   	TSX       
CUD       	Ishares SP US Div Growers ETF                     	TSX       
CUD.A     	Ishares SP US Div Growers ETF AC                  	TSX       
CVD       	Ishares Convertible Bond Index ETF                	TSX       
CWW       	Ishares SP Global Water ETF                       	TSX       
CWW.A     	Ishares SP Global Water ETF AC                    	TSX       
CYH       	Ishares Global Monthly Dividend ETF               	TSX       
CYH.A     	Ishares Global Monthly Div ETF AC                 	TSX       
DXB       	Dynamic Ishares Act Tactical Bond ETF             	TSX       
DXC       	Dyn Ishares Active CDN Div ETF                    	TSX       
DXG       	Dyn Ishares Active Global Div ETF                 	TSX       
DXO       	Dyn Ishares Act Crossover Bond ETF                	TSX       
DXP       	Dyn Ishares Active Pref Shares ETF                	TSX       
DXU       	Dyn Ishares Active US Div ETF                     	TSX       
DXZ       	Dynamic Ishares Acitve US Mid Cap ETF             	TSX       
FIE       	Ishares CDN Fin Mthly Income ETF                  	TSX       
FIE.A     	Ishares CDN Fin Mthly Income ETF AC               	TSX       
SVR       	Ishares Silver Bullion ETF Hdg                    	TSX       
SVR.C     	Ishares Silver Bullion ETF Non Hdg                	TSX       
XAL       	Ishares Alternatives Comp. Port. Fund             	TSX       
XAW       	Ishares Core MSCI All Cntry Ex Can ETF            	TSX       
XBB       	Ishares Core CDN Universe Bond ETF                	TSX       
XBM       	Ishares SP TSX Global Base Mtls ETF               	TSX       
XBZ       	Ishares MSCI Brazil Index ETF                     	TSX       
XCB       	Ishares Canadian Corporate Bond ETF               	TSX       
XCD       	Ishares SP Global Cons Disc ETF                   	TSX       
XCG       	Ishares Canadian Growth Index ETF                 	TSX       
XCH       	Ishares China Index ETF                           	TSX       
XCR       	Ishares Conservative Core Port ETF                	TSX       
XCS       	Ishares SP TSX Smallcap Index ETF                 	TSX       
XCV       	Ishares Canadian Value Index ETF                  	TSX       
XDG       	Ishares Core MSCI Glo Qlty Div ETF                	TSX       
XDGH      	Ishares Core MSCI Glo Qlty Div ETF                	TSX       
XDIV      	Ishares Core MSCI CAD Qlty Div ETF                	TSX       
XDU       	Ishares Core MSCI US Qlty Div ETF                 	TSX       
XDUH      	Ishares Core MSCI US Qlty Div ETF                 	TSX       
XDV       	Ishares Canadian Select Div Index ETF             	TSX       
XEB       	Ishares JP Morgan USD Emerg Mkts Bd ETF           	TSX       
XEC       	Ishares Core MSCI Emerging Mkts IMI ETF           	TSX       
XEF       	Ishares Core MSCI EAFE IMI Index ETF              	TSX       
XEG       	Ishares SP TSX Capped Energy Index ETF            	TSX       
XEH       	Ishares MSCI Europe IMI Index ETF                 	TSX       
XEI       	Ishares SP TSX Comp High Div Index ETF            	TSX       
XEM       	Ishares MSCI Emerging Markets ETF                 	TSX       
XEN       	Ishares Jantzi Social Index ETF                   	TSX       
XEU       	Ishares MSCI Europe IMI Index ETF                 	TSX       
XFA       	Ishares Edge MSCI Multifact USA Idx CAD           	TSX       
XFC       	Ishares Edge MSCI Multifact Can ETF               	TSX       
XFF       	Ishares Edge MSCI Multifact EAFE Idx CAD          	TSX       
XFH       	Ishares Core MSCI EAFE IMI Index ETF              	TSX       
XFI       	Ishares Edge MSCI Multifact EAFE ETF              	TSX       
XFN       	Ishares SP TSX Capped Financials ETF              	TSX       
XFR       	Ishares Floating Rate Index ETF                   	TSX       
XFS       	Ishares Edge MSCI Multifact USA ETF               	TSX       
XGB       	Ishares Canadian Govt Bond Index ETF              	TSX       
XGC       	Ishares Global Comp. Port. Fund                   	TSX       
XGD       	Ishares S&P/Tsx Global Gold Index ETF             	TSX       
XGI       	Ishares SP Global Industrials ETF                 	TSX       
XGR       	Ishares Growth Core Port. Fund                    	TSX       
XHB       	Ishares CDN Hybrid Corp Bond ETF                  	TSX       
XHC       	Ishares Global Healthcare Index ETF               	TSX       
XHD       	Ishares US High Div Equity Index ETF              	TSX       
XHU       	Ishares US High Div Equity Index ETF              	TSX       
XHY       	Ishares US High Yield Bond Index ETF              	TSX       
XIC       	Ishares Core SP TSX Capped Comp ETF               	TSX       
XID       	Ishares India Index ETF                           	TSX       
XIG       	Ishares US Ig Corporate Bond Index ETF            	TSX       
XIN       	Ishares MSCI EAFE Index ETF                       	TSX       
XIT       	Ishares SP TSX Capped Info Tech ETF               	TSX       
XIU       	Ishares SP TSX 60 Index ETF                       	TSX       
XLB       	Ishares Core CDN Long Term Bond ETF               	TSX       
XMA       	Ishares SP TSX Capped Materials ETF               	TSX       
XMC       	Ishares SP US Midcap Index ETF                    	TSX       
XMD       	Ishares SP TSX Completion Index ETF               	TSX       
XMH       	Ishares SP US Midcap Index ETF CAD Hgd            	TSX       
XMI       	Ishares Edge MSCI Min Vol EAFE ETF                	TSX       
XML       	Ishares Edge MSCI Mv EAFE ETF CAD Hgd             	TSX       
XMM       	Ishares Edge MSCI Min Vol Emerg ETF               	TSX       
XMS       	Ishares Edge MSCI Mv USA ETF CAD Hgd              	TSX       
XMU       	Ishares Edge MSCI Min Vol USA ETF                 	TSX       
XMV       	Ishares Edge MSCI Min Vol Can ETF                 	TSX       
XMW       	Ishares Edge MSCI Min Vol Gbl ETF                 	TSX       
XMY       	Ishares Edge MSCI Mv Glbl ETF CAD Hgd             	TSX       
XPF       	Ishares SP TSX Na Pref Stock ETF                  	TSX       
XQB       	Ishares High Qlty Canadian Bond ETF               	TSX       
XQB.A     	Ishares High Qlty CDN Bond ETF AC                 	TSX       
XQQ       	Ishares Nasdaq 100 Index ETF                      	TSX       
XRB       	Ishares CDN Real Return Bond Index ETF            	TSX       
XRE       	Ishares SP TSX Capped REIT Index ETF              	TSX       
XSB       	Ishares Core CDN Short Trm Bond ETF               	TSX       
XSC       	Ishares Cons ST Strat Fix Inc ETF                 	TSX       
XSE       	Ishares Cons Strat Fix Inc ETF                    	TSX       
XSH       	Ishares Core CDN ST Corp Maple Bnd ETF            	TSX       
XSI       	Ishares Short Term Strategic FI ETF               	TSX       
XSP       	Ishares Core SP 500 ETF CAD Hdg ETF               	TSX       
XSQ       	Ishares ST Hi Qlty CDN Bond ETF                   	TSX       
XST       	Ishares SP TSX Capped Cons Stpl ETF               	TSX       
XSU       	Ishares US Small Cap Index ETF                    	TSX       
XTR       	Ishares Diversified Monthly Income ETF            	TSX       
XUH       	Ishares Core SP US Total Mkt ETF CAD Heg          	TSX       
XUS       	Ishares Core SP 500 Index ETF                     	TSX       
XUT       	Ishares SP TSX Capped Utilities ETF               	TSX       
XUU       	Ishares Core SP US Total Market ETF               	TSX       
XWD       	Ishares MSCI World Index ETF                      	TSX       
BDAVX     	Blackrock Ishares Dynamic Allocation V.I. Fund C  	USMF      
BDFVX     	Blackrock Ishares Dynamic Fixed Income V.I. Fund  	USMF      
BEAVX     	Blackrock Ishares Equity Appreciation V.I. Fund   	USMF      
BVASX     	Blackrock Ishares Alternative Strategies V.I. Fu  	USMF      
BVDAX     	Blackrock Ishares Dynamic Allocation V.I Fund Cl  	USMF      
BVDFX     	Blackrock Ishares Dynamic Fixed Income V.I. Fund  	USMF      
BVEAX     	Blackrock Ishares Equity Appreciation V.I. Fund   	USMF      
CIETX     	Ishares Russell 2000 ETF 529 Port A               	USMF      
CIEUX     	Ishares Russell 3000 ETF 529 Port A               	USMF      
CIRPX     	Ishares Russell 1000 ETF 529 Port A               	USMF      
CITPX     	Ishares Barclays TIPS Bond ETF 529 Port A         	USMF      
IBTAX     	Ishares TIPS Bond ETF 529 Portfolio Cl A          	USMF      
IBTCX     	Ishares TIPS Bond ETF 529 Portfolio Cl C          	USMF      
IBTEX     	Ishares TIPS Bond ETF 529 Portfolio Cl Z          	USMF      
IRDAX     	Ishares Russell 3000 ETF 529 Portfolio Cl A       	USMF      
IRDCX     	Ishares Russell 3000 ETF 529 Portfolio Cl C       	USMF      
IRDEX     	Ishares Russell 3000 ETF 529 Portfolio Cl Z       	USMF      
IRIAX     	Ishares Russell 1000 ETF 529 Portfolio Cl A       	USMF      
IRICX     	Ishares Russell 1000 ETF 529 Portfolio Cl E       	USMF      
IRIEX     	Ishares Russell 1000 ETF 529 Portfolio Cl Z       	USMF      
IRNAX     	Ishares Russell 2000 ETF 529 Portfolio Cl A       	USMF      
IRNCX     	Ishares Russell 2000 ETF 529 Portfolio Cl C       	USMF      
IRNEX     	Ishares Russell 2000 ETF 529 Portfolio Cl Z       	USMF      
