Ticker      Name                                        Exchange    List
AA    	Alcoa Corp                                        	NYSE      	none      
AABA  	Altaba Inc                                        	NASDAQ    	none      
AAL   	American Airlines Gp                              	NASDAQ    	SP500     
AAN   	Aaron's Inc                                       	NYSE      	none      
AAOI  	Applied Optoelect                                 	NASDAQ    	SP600     
AAP   	Advance Auto Parts Inc                            	NYSE      	SP500     
AAPL  	Apple Inc                                         	NASDAQ    	SP500     
AAXN  	Axon Inc                                          	NASDAQ    	SP600     
ABB   	Abb Ltd                                           	NYSE      	none      
ABBV  	Abbvie Inc                                        	NYSE      	SP500     
ABC   	Amerisourcebergen Corp                            	NYSE      	SP500     
ABEO  	Abeona Therapeutics                               	NASDAQ    	none      
ABM   	ABM Industries Incorporated                       	NYSE      	SP600     
ABT   	Abbott Laboratories                               	NYSE      	SP500     
ABX   	Barrick Gold Corp                                 	NYSE      	none      
ACAD  	Acadia Pharmaceutica                              	NASDAQ    	none      
ACC   	American Campus Communities Inc                   	NYSE      	none      
ACGL  	Arch Capital Grp Ltd                              	NASDAQ    	none      
ACHC  	Acadia Healthcr Co                                	NASDAQ    	none      
ACIW  	Aci Worldwide Inc                                 	NASDAQ    	none      
ACLS  	Axcelis Tech Inc                                  	NASDAQ    	SP600     
ACM   	Aecom Technology Corp                             	NYSE      	none      
ACN   	Accenture Plc                                     	NYSE      	SP500     
ACOR  	Acorda Therapeutics                               	NASDAQ    	SP600     
ACRS  	Aclaris Therapts                                  	NASDAQ    	none      
ADBE  	Adobe Systems Inc                                 	NASDAQ    	SP500     
ADI   	Analog Devices                                    	NASDAQ    	SP500     
ADM   	Archer Daniels Midland Company                    	NYSE      	SP500     
ADMS  	Adamas Pharma                                     	NASDAQ    	none      
ADNT  	Adient Plc                                        	NYSE      	none      
ADP   	Automatic Data Procs                              	NASDAQ    	SP500     
ADS   	Alliance Data Systems Corp                        	NYSE      	SP500     
ADSK  	Autodesk Inc                                      	NASDAQ    	SP500     
AEE   	Ameren Corp                                       	NYSE      	SP500     
AEL   	American Equity Investment Life                   	NYSE      	SP600     
AEM   	Agnico-Eagle Mines Ltd                            	NYSE      	none      
AEO   	American Eagle Outfitters                         	NYSE      	none      
AEP   	American Electric Power Company                   	NYSE      	SP500     
AER   	Aercap Holdings N.V.                              	NYSE      	none      
AES   	The Aes Corp                                      	NYSE      	SP500     
AET   	Aetna Inc                                         	NYSE      	SP500     
AFL   	Aflac Incorporated                                	NYSE      	SP500     
AFSI  	Amtrust Financial                                 	NASDAQ    	none      
AGCO  	Agco Corp                                         	NYSE      	none      
AGN   	Allergan Plc                                      	NYSE      	SP500     
AGNC  	American Capital Age                              	NASDAQ    	none      
AGO   	Assured Guaranty Ltd                              	NYSE      	none      
AGRO  	Adecoagro S.A.                                    	NYSE      	none      
AHL   	Aspen Insurance Holdings                          	NYSE      	none      
AIG   	American International Group                      	NYSE      	SP500     
AIV   	Apartment Investment and Management               	NYSE      	SP500     
AJG   	Arthur J. Gallagher & Co                          	NYSE      	SP500     
AJRD  	Aerojet Rocketdyne Holdings                       	NYSE      	SP600     
AKAM  	Akamai Technologies                               	NASDAQ    	SP500     
AKAO  	Achaogen Inc                                      	NASDAQ    	none      
AKRX  	Akorn Inc                                         	NASDAQ    	none      
AL    	Air Lease Corporation Class A C                   	NYSE      	none      
ALB   	Albemarle Corp                                    	NYSE      	SP500     
ALDR  	Alder Biopharma                                   	NASDAQ    	none      
ALGN  	Align Technology I                                	NASDAQ    	SP500     
ALK   	Alaska Air Group                                  	NYSE      	SP500     
ALKS  	Alkermes Plc                                      	NASDAQ    	none      
ALL   	Allstate Corp                                     	NYSE      	SP500     
ALLY  	Ally Financial                                    	NYSE      	none      
ALNY  	Alnylam Pharmaceut                                	NASDAQ    	none      
ALRM  	Alarm.Com                                         	NASDAQ    	none      
ALSN  	Allison Transmission Holdings                     	NYSE      	none      
ALXN  	Alexion Pharm Inc                                 	NASDAQ    	SP500     
AM    	Antero Resources Midstream Llc                    	NYSE      	none      
AMAG  	Amag Pharmaceuticals                              	NASDAQ    	SP600     
AMAT  	Applied Materials                                 	NASDAQ    	SP500     
AMBA  	Ambarella Inc                                     	NASDAQ    	none      
AMC   	Amc Entertainment Holdings Inc                    	NYSE      	none      
AMCX  	Amc Networks Cl A                                 	NASDAQ    	none      
AMD   	Adv Micro Devices                                 	NASDAQ    	SP500     
AME   	Amtek Inc                                         	NYSE      	SP500     
AMGN  	Amgen                                             	NASDAQ    	SP500     
AMGP  	Antero Midstream Gp LP                            	NYSE      	none      
AMH   	American Homes 4 Rent                             	NYSE      	none      
AMKR  	Amkor Technology                                  	NASDAQ    	none      
AMP   	Ameriprise Financial Services                     	NYSE      	SP500     
AMT   	American Tower Corp                               	NYSE      	SP500     
AMTD  	TD Ameritrade HD                                  	NASDAQ    	none      
AMX   	America Movil S.A.B. De C.V.                      	NYSE      	none      
AMZN  	Amazon.Com Inc.                                   	NASDAQ    	SP500     
AN    	Autonation Inc                                    	NYSE      	none      
ANDV  	Andeavor                                          	NYSE      	SP500     
ANDX  	Andeavor Logistics LP                             	NYSE      	none      
ANET  	Arista Networks Inc                               	NYSE      	none      
ANF   	Abercrombie & Fitch Company                       	NYSE      	SP600     
ANGI  	Homeservices Inc.                                 	NASDAQ    	none      
ANTM  	Anthem Inc                                        	NYSE      	SP500     
AOBC  	American Outdoor Brands Corp                      	NASDAQ    	none      
AON   	AON Plc                                           	NYSE      	SP500     
AOS   	Smith [A.O.] Corp                                 	NYSE      	SP500     
APA   	Apache Corp                                       	NYSE      	SP500     
APC   	Anadarko Petroleum Corp                           	NYSE      	SP500     
APD   	Air Products and Chemicals                        	NYSE      	SP500     
APH   	Amphenol Corp                                     	NYSE      	SP500     
APLE  	Apple Hospitality REIT Inc                        	NYSE      	none      
APO   	Apollo Global Management Llc C                    	NYSE      	none      
APPN  	Appian Corporation Class A                        	NASDAQ    	none      
APTS  	Preferred Apartment Communities                   	NYSE      	none      
AQUA  	Evoqua Water Technologies Corp.                   	NYSE      	none      
AR    	Antero Resources Corp                             	NYSE      	none      
ARCC  	Ares Capital Corp                                 	NASDAQ    	none      
ARE   	Alexandria Real Estate Equities                   	NYSE      	SP500     
ARI   	Apollo Commercial Real Estate                     	NYSE      	SP600     
ARMK  	Aramark Holdings Corp                             	NYSE      	none      
ARNC  	Arconic Inc                                       	NYSE      	SP500     
ARRS  	Arris Group Inc                                   	NASDAQ    	none      
ARRY  	Array Biopharma Inc                               	NASDAQ    	none      
ARW   	Arrow Electronics                                 	NYSE      	none      
ASB   	Associated Banc-Corp                              	NYSE      	none      
ASH   	Ashland Global Holdings Inc                       	NYSE      	none      
ASML  	Asml Hldg NY Reg                                  	NASDAQ    	none      
ATGE  	Adtalem Global Education Inc                      	NYSE      	none      
ATH   	Athene Holding Ltd                                	NYSE      	none      
ATHM  	Autohome Inc                                      	NYSE      	none      
ATI   	Allegheny Technologies Inc                        	NYSE      	none      
ATO   	Atmos Energy Corp                                 	NYSE      	none      
ATU   	Actuant Corp                                      	NYSE      	SP600     
ATUS  	Altice USA Inc. Class A                           	NYSE      	none      
ATVI  	Activision Blizzard                               	NASDAQ    	SP500     
AVAV  	Aerovironment Inc                                 	NASDAQ    	SP600     
AVB   	Avalonbay Communities                             	NYSE      	SP500     
AVGO  	Broadcom Ltd                                      	NASDAQ    	SP500     
AVT   	Avnet Inc                                         	NYSE      	none      
AVY   	Avery Dennison Corp                               	NYSE      	SP500     
AWI   	Armstrong World Industries Inc                    	NYSE      	none      
AWK   	American Water Works                              	NYSE      	SP500     
AXDX  	Accelerate Diagnosti                              	NASDAQ    	none      
AXL   	American Axle & Manufacturing                     	NYSE      	SP600     
AXP   	American Express Company                          	NYSE      	SP500     
AXS   	Axis Capital Holdings                             	NYSE      	none      
AXTA  	Axalta Coating Systems Ltd                        	NYSE      	none      
AYI   	Acuity Brands Inc                                 	NYSE      	SP500     
AYX   	Alteryx Inc                                       	NYSE      	none      
AZN   	Astrazeneca Plc                                   	NYSE      	none      
AZO   	Autozone                                          	NYSE      	SP500     
BA    	Boeing Company                                    	NYSE      	SP500     
BABA  	Alibaba Group Holding Ltd                         	NYSE      	none      
BAC   	Bank of America Corp                              	NYSE      	SP500     
BAH   	Booz Allen Hamilton Holding Corp                  	NYSE      	none      
BAM   	Brookfield Asset Management Inc                   	NYSE      	none      
BANC  	First Pactrust Bancorp                            	NYSE      	SP600     
BAX   	Baxter International Inc                          	NYSE      	SP500     
BB    	Blackberry Ltd                                    	NYSE      	none      
BBBY  	Bed Bath & Beyond                                 	NASDAQ    	none      
BBD   	Banco Bradesco S.A.                               	NYSE      	none      
BBL   	Bhp Billiton Plc                                  	NYSE      	none      
BBT   	BB&T Corp                                         	NYSE      	SP500     
BBY   	Best Buy Co                                       	NYSE      	SP500     
BC    	Brunswick Corp                                    	NYSE      	none      
BCC   	Boise Cascade L.L.C.                              	NYSE      	SP600     
BCE   	BCE Inc                                           	NYSE      	none      
BCR   	C.R. Bard                                         	NYSE      	SP500     
BCS   	Barclays Plc                                      	NYSE      	none      
BDX   	Becton Dickinson and Company                      	NYSE      	SP500     
BEAT  	Biotelemetry Inc                                  	NASDAQ    	SP600     
BECN  	Beacon Roofing Suppl                              	NASDAQ    	none      
BEN   	Franklin Resources                                	NYSE      	SP500     
BERY  	Berry Global Group                                	NYSE      	none      
BETR  	Amplify Snack Brands Inc                          	NYSE      	none      
BF.B  	Brown Forman Inc B                                	NYSE      	none      
BG    	Bunge Ltd                                         	NYSE      	none      
BGC   	General Cable Corp                                	NYSE      	SP600     
BGCP  	Bgc Partners Cl A                                 	NASDAQ    	none      
BGS   	B&G Foods Holdings                                	NYSE      	SP600     
BHF   	Brighthouse Financial Inc                         	NASDAQ    	SP500     
BHGE  	Baker Hughes A Ge Co. Cl. A                       	NYSE      	SP500     
BHP   	Bhp Billiton Ltd                                  	NYSE      	none      
BIDU  	Baidu Inc                                         	NASDAQ    	NDX       
BIG   	Big Lots                                          	NYSE      	none      
BIIB  	Biogen Inc                                        	NASDAQ    	SP500     
BITA  	Bitauto Holdings Ltd                              	NYSE      	none      
BIVV  	Bioverativ Inc                                    	NASDAQ    	none      
BK    	Bank of New York Mellon Corp                      	NYSE      	SP500     
BKE   	Buckle Inc                                        	NYSE      	SP600     
BKH   	Black Hills Corp                                  	NYSE      	none      
BKI   	Black Knight Inc                                  	NYSE      	none      
BKU   	BankUnited Inc                                    	NYSE      	none      
BLDR  	Builders Firstsource                              	NASDAQ    	none      
BLL   	Ball Corp                                         	NYSE      	SP500     
BLMN  	Bloomin' Brands Inc                               	NASDAQ    	none      
BLUE  	Bluebird Bio                                      	NASDAQ    	none      
BMCH  	Bmc Stock Holdings                                	NASDAQ    	none      
BMRN  	Biomarin Pharmaceut                               	NASDAQ    	NDX       
BMS   	Bemis Company                                     	NYSE      	none      
BMY   	Bristol-Myers Squibb Company                      	NYSE      	SP500     
BNS   	Bank of Nova Scotia                               	NYSE      	none      
BOFI  	Bofi Holding Inc                                  	NASDAQ    	SP600     
BOX   	Box Inc                                           	NYSE      	none      
BP    	BP Plc                                            	NYSE      	none      
BPL   	Buckeye Partners LP                               	NYSE      	none      
BPMC  	Blueprint Medi Cm ST                              	NASDAQ    	none      
BPOP  	Popular Inc                                       	NASDAQ    	none      
BR    	Broadridge Financial Solutions Llc                	NYSE      	none      
BRFS  	Brf-Brasil Foods S.A.                             	NYSE      	none      
BRK.B 	Berkshire Hath Hld B                              	NYSE      	none      
BRKR  	Bruker Corp                                       	NASDAQ    	none      
BRKS  	Brooks Automation                                 	NASDAQ    	SP600     
BRO   	Brown & Brown                                     	NYSE      	none      
BRS   	Bristow Group Inc                                 	NYSE      	SP600     
BRX   	Brixmor Property Group Inc                        	NYSE      	none      
BSAC  	Banco Santander-Chile Ads                         	NYSE      	none      
BSFT  	Broadsoft Inc                                     	NASDAQ    	none      
BSX   	Boston Scientific Corp                            	NYSE      	SP500     
BT    	Bt Group Plc                                      	NYSE      	none      
BTI   	British American Tobacco Industries               	NYSE      	none      
BTU   	Peabody Energy Corp.                              	NYSE      	none      
BUD   	Anheuser-Busch Inbev S.A.                         	NYSE      	none      
BUFF  	Blue Buffalo Pet                                  	NASDAQ    	none      
BURL  	Burlington Stores Inc                             	NYSE      	none      
BVN   	Compania Mina Buenaventura S.A.                   	NYSE      	none      
BWA   	Borgwarner Inc                                    	NYSE      	SP500     
BWLD  	Buffalo Wild Wings                                	NASDAQ    	none      
BWP   	Boardwalk Pipeline Partners LP                    	NYSE      	none      
BX    	The Blackstone Group LP                           	NYSE      	none      
BXP   	Boston Properties                                 	NYSE      	SP500     
BXS   	Bancorpsouth Inc                                  	NYSE      	none      
BYD   	Boyd Gaming Corp                                  	NYSE      	SP600     
BZUN  	Baozun Inc Ads                                    	NASDAQ    	none      
C     	Citigroup Inc                                     	NYSE      	SP500     
CA    	CA Inc                                            	NASDAQ    	SP500     
CAA   	Calatlantic Group Inc                             	NYSE      	none      
CADE  	Cadence Bancorporation Class A                    	NYSE      	none      
CAG   	Conagra Brands Inc                                	NYSE      	SP500     
CAH   	Cardinal Health                                   	NYSE      	SP500     
CAKE  	Cheesecake Fact                                   	NASDAQ    	none      
CALD  	Callidus Software                                 	NASDAQ    	none      
CAR   	Avis Budget Group I                               	NASDAQ    	none      
CARA  	Cara Therapeutics                                 	NASDAQ    	none      
CARS  	Cars.Com Inc                                      	NYSE      	none      
CASY  	Casey's General Stor                              	NASDAQ    	none      
CAT   	Caterpillar Inc                                   	NYSE      	SP500     
CATM  	Cardtronics Inc                                   	NASDAQ    	SP600     
CAVM  	Cavium Inc                                        	NASDAQ    	none      
CB    	Chubb Ltd                                         	NYSE      	SP500     
CBF   	Capital Bnk Fin Cl A                              	NASDAQ    	none      
CBG   	CBRE Group Inc                                    	NYSE      	SP500     
CBI   	Chicago Bridge & Iron Company N.V.                	NYSE      	none      
CBIO  	Catalyst Bio                                      	NASDAQ    	none      
CBOE  	CBOE Global Markets Inc                           	NASDAQ    	SP500     
CBS   	CBS Corp                                          	NYSE      	SP500     
CC    	Chemours Company                                  	NYSE      	none      
CCC   	Calgon Carbon Corp                                	NYSE      	SP600     
CCE   	Coca Cola European Partners                       	NYSE      	none      
CCI   	Crown Castle International Corp                   	NYSE      	SP500     
CCK   	Crown Cork & Seal Company                         	NYSE      	none      
CCL   	Carnival Corp                                     	NYSE      	SP500     
CDEV  	Centennial Resource Development Inc               	NASDAQ    	none      
CDK   	Cdk Global Inc                                    	NASDAQ    	none      
CDNS  	Cadence Design Sys                                	NASDAQ    	SP500     
CDW   	CDW Corp                                          	NASDAQ    	none      
CE    	Celanese Corp                                     	NYSE      	none      
CELG  	Celgene Corp                                      	NASDAQ    	SP500     
CENX  	Century Aluminum C                                	NASDAQ    	SP600     
CERN  	Cerner Corp                                       	NASDAQ    	SP500     
CF    	Cf Industries Holdings                            	NYSE      	SP500     
CFG   	Citizens Financial Group Inc/Ri                   	NYSE      	SP500     
CFX   	Colfax Corp                                       	NYSE      	none      
CG    	The Carlyle Group                                 	NASDAQ    	none      
CGNX  	Cognex Cp                                         	NASDAQ    	none      
CHD   	Church & Dwight Company                           	NYSE      	SP500     
CHGG  	Chegg Inc                                         	NYSE      	none      
CHKP  	Check Point Software                              	NASDAQ    	NDX       
CHL   	China Mobile [Hong Kong] Ltd                      	NYSE      	none      
CHRW  	C.H. Robinson Ww                                  	NASDAQ    	SP500     
CHTR  	Charter Communicatio                              	NASDAQ    	SP500     
CI    	Cigna Corp                                        	NYSE      	SP500     
CIEN  	Ciena Corp                                        	NYSE      	none      
CIM   	Chimera Investment Corp                           	NYSE      	none      
CINF  	Cincinnati Financial                              	NASDAQ    	SP500     
CIT   	Cit Group Inc [Del]                               	NYSE      	none      
CJ    	C&J Energy Services Inc                           	NYSE      	none      
CL    	Colgate-Palmolive Company                         	NYSE      	SP500     
CLB   	Core Laboratories N.V.                            	NYSE      	none      
CLDR  	Cloudera Inc                                      	NYSE      	none      
CLGX  	Corelogic                                         	NYSE      	none      
CLI   	Mack-Cali Realty Corp                             	NYSE      	none      
CLNS  	Colony Northstar Inc                              	NYSE      	none      
CLR   	Continental Resources                             	NYSE      	none      
CLS   	Celestica Inc                                     	NYSE      	none      
CLVS  	Clovis Oncology Inc                               	NASDAQ    	none      
CLX   	Clorox Company                                    	NYSE      	SP500     
CMA   	Comerica Inc                                      	NYSE      	SP500     
CMC   	Commercial Metals Company                         	NYSE      	none      
CMCM  	Cheetah Mobile Inc                                	NYSE      	none      
CMCSA 	Comcast Corp A                                    	NASDAQ    	SP500     
CME   	CME Group Inc                                     	NASDAQ    	SP500     
CMG   	Chipotle Mexican Grill                            	NYSE      	SP500     
CMI   	Cummins Inc                                       	NYSE      	SP500     
CMS   	Cms Energy Corp                                   	NYSE      	SP500     
CNC   	Centene Corp                                      	NYSE      	SP500     
CNCE  	Concert Pharmaceutic                              	NASDAQ    	none      
CNDT  	Conduent Inc                                      	NYSE      	none      
CNHI  	CNH Industrial N.V.                               	NYSE      	none      
CNI   	Canadian National Railway Company                 	NYSE      	none      
CNK   	Cinemark Holdings Inc                             	NYSE      	none      
CNO   	Cno Financial Group                               	NYSE      	none      
CNP   	Centerpoint Energy Inc                            	NYSE      	SP500     
CNQ   	Canadian Natural Resources                        	NYSE      	none      
CNSL  	Consolidated Communications Holdings Inc          	NASDAQ    	SP600     
CNX   	CNX Resources Corp                                	NYSE      	none      
COF   	Capital One Financial Corp                        	NYSE      	SP500     
COG   	Cabot Oil & Gas Corp                              	NYSE      	SP500     
COL   	Rockwell Collins                                  	NYSE      	SP500     
COLL  	Collegium Pharma                                  	NASDAQ    	none      
COMM  	Commscope Holding Co                              	NASDAQ    	none      
CONE  	Cyrusone Inc                                      	NASDAQ    	none      
CONN  	Conn's Inc                                        	NASDAQ    	none      
COO   	Cooper Companies                                  	NYSE      	SP500     
COP   	Conocophillips                                    	NYSE      	SP500     
CORT  	Corcept Therapeutics                              	NASDAQ    	none      
COST  	Costco Wholesale                                  	NASDAQ    	SP500     
COT   	Cott Corp                                         	NYSE      	none      
COTY  	Coty Inc                                          	NYSE      	SP500     
COUP  	Coupa Software Inc                                	NASDAQ    	none      
COWN  	Cowen Group Inc                                   	NASDAQ    	none      
CP    	Canadian Pacific Railway                          	NYSE      	none      
CPB   	Campbell Soup Company                             	NYSE      	SP500     
CPE   	Callon Petroleum Company                          	NYSE      	none      
CPL   	Cpfl Energia S.A.                                 	NYSE      	none      
CPN   	Calpine Corp                                      	NYSE      	none      
CPRT  	Copart Inc                                        	NASDAQ    	none      
CRC   	California Resources Corporatio                   	NYSE      	none      
CREE  	Cree Inc                                          	NASDAQ    	none      
CRH   	CRH Plc                                           	NYSE      	none      
CRI   	Carter's Inc                                      	NYSE      	none      
CRM   	Salesforce.Com Inc                                	NYSE      	SP500     
CROX  	Crocs Inc                                         	NASDAQ    	SP600     
CRR   	Carbo Ceramics                                    	NYSE      	SP600     
CRTO  	Criteo S.A. Ads                                   	NASDAQ    	none      
CRUS  	Cirrus Logic Inc                                  	NASDAQ    	none      
CRZO  	Carrizo Oil & Gas                                 	NASDAQ    	SP600     
CS    	Credit Suisse Group                               	NYSE      	none      
CSCO  	Cisco Systems Inc                                 	NASDAQ    	SP500     
CSIQ  	Canadian Solar Inc                                	NASDAQ    	none      
CSOD  	Cornerstone Ondemand                              	NASDAQ    	none      
CSRA  	Csra Inc                                          	NYSE      	SP500     
CSTM  	Constellium N.V.                                  	NYSE      	none      
CSX   	CSX Corp                                          	NASDAQ    	SP500     
CTAS  	Cintas Corp                                       	NASDAQ    	SP500     
CTB   	Cooper Tire & Rubber Company                      	NYSE      	none      
CTL   	Centurylink                                       	NYSE      	SP500     
CTLT  	Catalent Inc                                      	NYSE      	none      
CTRE  	Caretrust REIT Inc                                	NASDAQ    	SP600     
CTRL  	Control4 Corp                                     	NASDAQ    	SP600     
CTRP  	Ctrip.Com Intl Ltd                                	NASDAQ    	NDX       
CTSH  	Cognizant Tech Sol                                	NASDAQ    	SP500     
CTXS  	Citrix Systems Inc                                	NASDAQ    	SP500     
CUBE  	Cubesmart                                         	NYSE      	none      
CUDA  	Barracuda Networks Inc                            	NYSE      	SP600     
CVA   	Covanta Holding Corp                              	NYSE      	none      
CVG   	Convergys Corp                                    	NYSE      	none      
CVNA  	Carvana Co. Class A                               	NYSE      	none      
CVS   	CVS Corp                                          	NYSE      	SP500     
CVX   	Chevron Corp                                      	NYSE      	SP500     
CWH   	Camping World Holdings Inc                        	NYSE      	none      
CXO   	Concho Resources Inc                              	NYSE      	SP500     
CXW   	Corecivic Inc                                     	NYSE      	none      
CY    	Cypress Semiconductr                              	NASDAQ    	none      
CZR   	Caesars Entertainment Corp                        	NASDAQ    	none      
D     	Dominion Resources                                	NYSE      	SP500     
DAL   	Delta Air Lines Inc                               	NYSE      	SP500     
DAN   	Dana Inc                                          	NYSE      	none      
DAR   	Darling International Inc                         	NYSE      	SP600     
DATA  	Tableau Software Inc Class A                      	NYSE      	none      
DB    	Deutsche Bank Ag                                  	NYSE      	none      
DBD   	Diebold Nixdorf Inc                               	NYSE      	none      
DDS   	Dillard's                                         	NYSE      	none      
DE    	Deere & Company                                   	NYSE      	SP500     
DEA   	Easterly Government Properties                    	NYSE      	none      
DECK  	Deckers Outdoor Corp                              	NYSE      	none      
DEI   	Douglas Emmett                                    	NYSE      	none      
DERM  	Dermira Inc Cm ST                                 	NASDAQ    	none      
DF    	Dean Foods Company                                	NYSE      	none      
DFS   	Discover Financial Services                       	NYSE      	SP500     
DG    	Dollar General Corp                               	NYSE      	SP500     
DGX   	Quest Diagnostics Inc                             	NYSE      	SP500     
DHI   	D.R. Horton                                       	NYSE      	SP500     
DHR   	Danaher Corp                                      	NYSE      	SP500     
DIS   	Walt Disney Company                               	NYSE      	SP500     
DISCA 	Discovery Comm A                                  	NASDAQ    	SP500     
DISCK 	Discovery Comm Inc                                	NASDAQ    	SP500     
DISH  	Dish Network Corp                                 	NASDAQ    	SP500     
DK    	Delek US Holdings                                 	NYSE      	none      
DKS   	Dick's Sporting Goods Inc                         	NYSE      	none      
DLPH  	Delphi Technologies Plc                           	NYSE      	none      
DLTH  	Duluth Hldg Cl B                                  	NASDAQ    	none      
DLTR  	Dollar Tree Inc                                   	NASDAQ    	SP500     
DNKN  	Dunkin' Brands Group                              	NASDAQ    	none      
DNOW  	Now Inc                                           	NYSE      	none      
DO    	Diamond Offshore Drilling                         	NYSE      	none      
DOV   	Dover Corp                                        	NYSE      	SP500     
DOX   	Amdocs Ltd Ord                                    	NASDAQ    	none      
DPLO  	Diplomat Pharmacy Inc                             	NYSE      	SP600     
DPS   	Dr Pepper Snapple Group Inc                       	NYSE      	SP500     
DPZ   	Domino's Pizza Inc                                	NYSE      	none      
DRE   	Duke Realty Corp                                  	NYSE      	SP500     
DRH   	Diamondrock Hospitality Company                   	NYSE      	SP600     
DRI   	Darden Restaurants                                	NYSE      	SP500     
DSW   	DSW Inc                                           	NYSE      	SP600     
DTE   	Dte Energy Company                                	NYSE      	SP500     
DUK   	Duke Energy Corp                                  	NYSE      	SP500     
DVA   	Davita Healthcare Partners Inc                    	NYSE      	SP500     
DVAX  	Dynavax Technologies                              	NASDAQ    	none      
DVMT  	Dell Technologies Inc. Cl V                       	NYSE      	none      
DVN   	Devon Energy Corp                                 	NYSE      	SP500     
DWDP  	Dowdupont Inc.                                    	NYSE      	SP500     
DWT   	Velocity 3X Inverse Crude Oil                     	AMEX      	none      
DXC   	Dxc Technology Company                            	NYSE      	SP500     
DXCM  	Dexcom                                            	NASDAQ    	none      
DY    	Dycom Industries                                  	NYSE      	none      
DYN   	Dynegy Inc                                        	NYSE      	none      
EA    	Electronic Arts Inc                               	NASDAQ    	SP500     
EAT   	Brinker International                             	NYSE      	none      
EBAY  	Ebay Inc                                          	NASDAQ    	SP500     
EC    	Ecopetrol S.A.                                    	NYSE      	none      
ECA   	Encana Corp                                       	NYSE      	none      
ECHO  	Echo Global Logistic                              	NASDAQ    	SP600     
ECL   	Ecolab Inc                                        	NYSE      	SP500     
ED    	Consolidated Edison Company of New York           	NYSE      	SP500     
EDIT  	Editas Medicine                                   	NASDAQ    	none      
EDU   	New Oriental Education & Technology Group         	NYSE      	none      
EEFT  	Euronet Worldwide                                 	NASDAQ    	none      
EEP   	Enbridge Energy LP                                	NYSE      	none      
EEQ   	Enbridge Energy Management Llc                    	NYSE      	none      
EFX   	Equifax Inc                                       	NYSE      	SP500     
EGBN  	Eagle Bancorp Inc                                 	NASDAQ    	none      
EGHT  	8X8 Inc                                           	NASDAQ    	SP600     
EGN   	Energen Corp                                      	NYSE      	none      
EGOV  	Nic Inc                                           	NASDAQ    	SP600     
EIX   	Edison International                              	NYSE      	SP500     
EL    	Estee Lauder Companies                            	NYSE      	SP500     
ELY   	Callaway Golf Company                             	NYSE      	SP600     
EMN   	Eastman Chemical Company                          	NYSE      	SP500     
EMR   	Emerson Electric Company                          	NYSE      	SP500     
ENB   	Enbridge Inc                                      	NYSE      	none      
ENIA  	Enersis Americas S.A. American                    	NYSE      	none      
ENLK  	Enlink Midstream Partners LP                      	NYSE      	none      
ENR   	Energizer Holdings Inc                            	NYSE      	none      
ENTG  	Entegris Inc                                      	NASDAQ    	none      
ENTL  	Entellus Medical                                  	NASDAQ    	none      
EOG   	Eog Resources                                     	NYSE      	SP500     
EPC   	Edgewell Personal Care                            	NYSE      	none      
EPD   	Enterprise Products Partners LP                   	NYSE      	none      
EPZM  	Epizyme Inc                                       	NASDAQ    	none      
EQC   	Equity Commonwealth                               	NYSE      	none      
EQR   	Equity Residential                                	NYSE      	SP500     
EQT   	Eqt Corp                                          	NYSE      	SP500     
ERI   	Eldorado Resorts                                  	NASDAQ    	none      
ERJ   	Embraer-Empresa Brasileira De Aeronautica         	NYSE      	none      
ES    	Eversource Energy                                 	NYSE      	SP500     
ESIO  	Electro Sci Inds                                  	NASDAQ    	SP600     
ESNT  	Essent Group Ltd                                  	NYSE      	none      
ESPR  	Esperion Theraptc                                 	NASDAQ    	none      
ESRX  	Express Scripts                                   	NASDAQ    	SP500     
ETE   	Energy Transfer Equity LP                         	NYSE      	none      
ETFC  	E*Trade Finl Corp                                 	NASDAQ    	SP500     
ETM   	Entercom Communications Corp                      	NYSE      	none      
ETN   	Eaton Corp                                        	NYSE      	SP500     
ETP   	Energy Transfer Partners                          	NYSE      	none      
ETR   	Entergy Corp                                      	NYSE      	SP500     
ETSY  	Etsy Inc                                          	NASDAQ    	none      
EV    	Eaton Vance Corp                                  	NYSE      	none      
EVH   	Evolent Health Inc Class A Com                    	NYSE      	none      
EVHC  	Envision Healthcare Holdings                      	NYSE      	SP500     
EVTC  	Evertec Inc                                       	NYSE      	none      
EW    	Edwards Lifesciences Corp                         	NYSE      	SP500     
EWBC  	East West Bancorp                                 	NASDAQ    	none      
EXAS  	Exact Sciences Cor                                	NASDAQ    	none      
EXC   	Exelon Corp                                       	NYSE      	SP500     
EXEL  	Exelixis Inc                                      	NASDAQ    	none      
EXP   	Eagle Materials Inc                               	NYSE      	none      
EXPD  	Expeditors Intl                                   	NASDAQ    	SP500     
EXPE  	Expedia Inc                                       	NASDAQ    	SP500     
EXPR  	Express Inc                                       	NYSE      	SP600     
EXR   	Extra Space Storage Inc                           	NYSE      	SP500     
EXTR  	Extreme Networks                                  	NASDAQ    	none      
EYE   	National Vision Holdings Inc.                     	NASDAQ    	none      
EZPW  	Ezcorp Inc                                        	NASDAQ    	SP600     
F     	Ford Motor Company                                	NYSE      	SP500     
FAF   	First American Corp                               	NYSE      	none      
FANG  	Diamondback Energy                                	NASDAQ    	none      
FAST  	Fastenal Co                                       	NASDAQ    	SP500     
FB    	Facebook Inc                                      	NASDAQ    	SP500     
FBHS  	Fortune Brands Home & Security                    	NYSE      	SP500     
FBR   	Fibria Celulose S.A.                              	NYSE      	none      
FCAU  	Fiat Chrysler Automobiles N.V.                    	NYSE      	none      
FCE.A 	Forest City Ent Cl A                              	NYSE      	none      
FCF   	First Commonwealth Financial Corp                 	NYSE      	SP600     
FCX   	Freeport-Mcmoran Inc                              	NYSE      	SP500     
FDC   	First Data Corp                                   	NYSE      	none      
FDS   	Factset Research Systems Inc                      	NYSE      	none      
FDX   	Fedex Corp                                        	NYSE      	SP500     
FE    	Firstenergy Corp                                  	NYSE      	SP500     
FET   	Forum Energy Technologies Inc                     	NYSE      	none      
FEYE  	Fireeye Inc                                       	NASDAQ    	none      
FFIV  	F5 Networks Inc                                   	NASDAQ    	SP500     
FGEN  	Fibrogen Inc CS                                   	NASDAQ    	none      
FHN   	First Horizon National Corp                       	NYSE      	none      
FII   	Federated Investors                               	NYSE      	none      
FINL  	Finish Line Cl A                                  	NASDAQ    	SP600     
FIS   	Fidelity National Information Services            	NYSE      	SP500     
FISV  	Fiserv Inc                                        	NASDAQ    	SP500     
FITB  	Fifth Third Bncp                                  	NASDAQ    	SP500     
FIVE  	Five Below Inc                                    	NASDAQ    	SP600     
FL    	Footlocker Inc                                    	NYSE      	SP500     
FLEX  	Flextronics Intl Ltd                              	NASDAQ    	none      
FLIR  	Flir Systems Inc                                  	NASDAQ    	SP500     
FLO   	Flowers Foods                                     	NYSE      	none      
FLR   	Fluor Corp                                        	NYSE      	SP500     
FLS   	Flowserve Corp                                    	NYSE      	SP500     
FLT   	Fleetcor Technologies                             	NYSE      	none      
FLXN  	Flexion Therapeutics                              	NASDAQ    	none      
FMBI  	First Midwest Bncp                                	NASDAQ    	SP600     
FMC   	FMC Corp                                          	NYSE      	SP500     
FMX   	Fomento Economico Mexicano S.A.B. De C.V.         	NYSE      	none      
FNB   	F.N.B. Corp                                       	NYSE      	none      
FND   	Floor & Decor Holdings Inc                        	NYSE      	none      
FNF   	Fidelity National Financial                       	NYSE      	none      
FNGN  	Financial Engines                                 	NASDAQ    	SP600     
FNSR  	Finisar Corp                                      	NASDAQ    	none      
FNV   	Franco Nev Corp                                   	NYSE      	none      
FOE   	Ferro Corp                                        	NYSE      	none      
FOLD  	Amicus Therapeutics                               	NASDAQ    	none      
FORM  	Formfactor Inc                                    	NASDAQ    	none      
FOX   	21st Centry Fox Class B                           	NASDAQ    	SP500     
FOXA  	21st Centry Fox Class A                           	NASDAQ    	SP500     
FPRX  	Five Prime Thera                                  	NASDAQ    	none      
FRAC  	Keane Group Inc                                   	NYSE      	none      
FRC   	First Republic Bank                               	NYSE      	none      
FRTA  	Forterra Inc                                      	NASDAQ    	none      
FSLR  	First Solar Inc                                   	NASDAQ    	none      
FTI   	Technipfmc Plc                                    	NYSE      	SP500     
FTNT  	Fortinet Inc                                      	NASDAQ    	none      
FTV   	Fortive Corp                                      	NYSE      	SP500     
FULT  	Fulton Financial Cor                              	NASDAQ    	none      
FWONK 	Liberty Media F1 Series K                         	NASDAQ    	none      
G     	Genpact Ltd                                       	NYSE      	none      
GBT   	Global Blood Ther                                 	NASDAQ    	none      
GCI   	Gannett Co. Inc                                   	NYSE      	SP600     
GCO   	Genesco Inc                                       	NYSE      	SP600     
GD    	General Dynamics Corp                             	NYSE      	SP500     
GDDY  	Godaddy Inc                                       	NYSE      	none      
GDI   	Gardner Denver Holdings Inc                       	NYSE      	none      
GE    	General Electric Company                          	NYSE      	SP500     
GEL   	Genesis Energy LP                                 	NYSE      	none      
GEO   	Geo Group Inc                                     	NYSE      	none      
GES   	Guess Inc                                         	NYSE      	SP600     
GG    	Goldcorp Inc                                      	NYSE      	none      
GGAL  	Grupo Fin Galicia                                 	NASDAQ    	none      
GGP   	Ggp Inc                                           	NYSE      	SP500     
GHL   	Greenhill & Co. Inc                               	NYSE      	SP600     
GIII  	G-III Apparel Gp I                                	NASDAQ    	SP600     
GILD  	Gilead Sciences Inc                               	NASDAQ    	SP500     
GIMO  	Gigamon Inc                                       	NYSE      	SP600     
GIS   	General Mills                                     	NYSE      	SP500     
GKOS  	Glaukos Corp                                      	NYSE      	none      
GLNG  	Golar Lng Ltd                                     	NASDAQ    	none      
GLPI  	Gaming & Leisure                                  	NASDAQ    	none      
GLW   	Corning Inc                                       	NYSE      	SP500     
GLYC  	Glycomimetics Inc                                 	NASDAQ    	none      
GM    	General Motors Company                            	NYSE      	SP500     
GME   	Gamestop Corp                                     	NYSE      	none      
GMED  	Globus Medical Inc                                	NYSE      	none      
GMS   	Gms                                               	NYSE      	none      
GNTX  	Gentex Corp                                       	NASDAQ    	none      
GOGO  	Gogo Inc                                          	NASDAQ    	none      
GOOG  	Alphabet Class C                                  	NASDAQ    	SP500     
GOOGL 	Alphabet Class A                                  	NASDAQ    	SP500     
GOOS  	Canada Goose Holdings Inc. Subordinate Voting Sh  	NYSE      	none      
GPC   	Genuine Parts Company                             	NYSE      	SP500     
GPK   	Graphic Packaging Holding Company                 	NYSE      	none      
GPN   	Global Payments Inc                               	NYSE      	SP500     
GPOR  	Gulfport Energy Corp                              	NASDAQ    	none      
GPRE  	Green Plains Inc                                  	NASDAQ    	SP600     
GPS   	Gap Inc                                           	NYSE      	SP500     
GRA   	W.R. Grace & Company                              	NYSE      	none      
GRMN  	Garmin Ltd                                        	NASDAQ    	SP500     
GRUB  	Grubhub Inc                                       	NYSE      	none      
GS    	Goldman Sachs Group                               	NYSE      	SP500     
GSK   	Glaxosmithkline Plc                               	NYSE      	none      
GSM   	Ferroglobe Plc Os                                 	NASDAQ    	none      
GT    	Goodyear Tire Rubber                              	NASDAQ    	SP500     
GTN   	Gray Television                                   	NYSE      	none      
GWRE  	Guidewire Software Inc                            	NYSE      	none      
GWW   	W.W. Grainger                                     	NYSE      	SP500     
GXP   	Great Plains Energy Inc                           	NYSE      	none      
H     	Hyatt Hotels Corp                                 	NYSE      	none      
HA    	Hawaiian Hldgs Inc                                	NASDAQ    	SP600     
HAIN  	Hain Celestial Grp                                	NASDAQ    	none      
HAL   	Halliburton Company                               	NYSE      	SP500     
HALO  	Halozyme Therapeutic                              	NASDAQ    	none      
HAS   	Hasbro Inc                                        	NASDAQ    	SP500     
HAWK  	Blackhawk Network Ho                              	NASDAQ    	none      
HBAN  	Huntington Bcshs                                  	NASDAQ    	SP500     
HBHC  	Hancock Holding Co                                	NASDAQ    	none      
HBI   	Hanesbrands Inc                                   	NYSE      	SP500     
HCA   	Hca Holdings Inc                                  	NYSE      	SP500     
HCC   	Warrior Met Coal Inc                              	NYSE      	none      
HCLP  	Hi-Crush Partners LP                              	NYSE      	none      
HCN   	Welltower Inc                                     	NYSE      	SP500     
HCP   	HCP Inc                                           	NYSE      	SP500     
HCSG  	Healthcare Svcs Gp                                	NASDAQ    	SP600     
HD    	Home Depot                                        	NYSE      	SP500     
HDB   	Hdfc Bank Ltd                                     	NYSE      	none      
HDP   	Hortonworks                                       	NASDAQ    	none      
HDS   	HD Supply Hlds Cmm                                	NASDAQ    	none      
HES   	Hess Corp                                         	NYSE      	SP500     
HFC   	Hollyfrontier Corp                                	NYSE      	none      
HIBB  	Hibbett Sports Inc                                	NASDAQ    	SP600     
HIG   	Hartford Financial Services Group                 	NYSE      	SP500     
HIMX  	Himax Technologies                                	NASDAQ    	none      
HIW   	Highwoods Properties                              	NYSE      	none      
HLF   	Herbalife Ltd                                     	NYSE      	none      
HLS   	Healthsouth Corp                                  	NYSE      	none      
HLT   	Hilton Inc                                        	NYSE      	SP500     
HMC   	Honda Motor Company                               	NYSE      	none      
HMSY  	Hms Hldgs Cp                                      	NASDAQ    	SP600     
HOG   	Harley-Davidson Inc                               	NYSE      	SP500     
HOLX  	Hologic Inc                                       	NASDAQ    	SP500     
HOME  	At Home Group Inc                                 	NYSE      	none      
HON   	Honeywell International Inc                       	NYSE      	SP500     
HP    	Helmerich & Payne                                 	NYSE      	SP500     
HPE   	Hewlett Packard Enterprise Comp                   	NYSE      	SP500     
HPP   	Hudson Pacific Properties                         	NYSE      	none      
HPQ   	Hewlett-Packard Company                           	NYSE      	SP500     
HQY   	Healthequity                                      	NASDAQ    	SP600     
HRB   	H&R Block                                         	NYSE      	SP500     
HRG   	Hrg Group Inc                                     	NYSE      	none      
HRL   	Hormel Foods Corp                                 	NYSE      	SP500     
HRS   	Harris Corp                                       	NYSE      	SP500     
HRTX  	Heron Therapeutics                                	NASDAQ    	none      
HSBC  	HSBC Holdings Plc                                 	NYSE      	none      
HSIC  	Henry Schein Inc                                  	NASDAQ    	SP500     
HSY   	Hershey Foods Corp                                	NYSE      	SP500     
HTHT  	China Lodg Grp Ads                                	NASDAQ    	none      
HTZ   	Hertz Global Holdings Inc                         	NYSE      	none      
HUBS  	Hubspot Inc                                       	NYSE      	none      
HUM   	Humana Inc                                        	NYSE      	SP500     
HUN   	Huntsman Corp                                     	NYSE      	none      
HXL   	Hexcel Corp                                       	NYSE      	none      
HZNP  	Horizon Pharma Ord                                	NASDAQ    	none      
IAC   	Iac/Interactive                                   	NASDAQ    	none      
IBKC  	Iberiabank Corp                                   	NASDAQ    	none      
IBKR  	Interactive Brokers                               	NASDAQ    	SP600     
IBM   	International Business Machines                   	NYSE      	SP500     
IBO   	Ibo Common Stock                                  	AMEX      	none      
ICE   	Intercontinental Exchange                         	NYSE      	SP500     
ICHR  	Ichor                                             	NASDAQ    	none      
ICPT  	Intercept Pharmaceut                              	NASDAQ    	none      
IDTI  	Integrated Devices                                	NASDAQ    	none      
IDXX  	Idexx Laboratories                                	NASDAQ    	SP500     
IGT   	International Game Technology                     	NYSE      	none      
IIVI  	I I V I Inc                                       	NASDAQ    	SP600     
ILG   	Ilg Inc                                           	NASDAQ    	none      
ILMN  	Illumina Inc                                      	NASDAQ    	SP500     
IMAX  	Imax Corp                                         	NYSE      	none      
IMMU  	Immunomedics Inc                                  	NASDAQ    	none      
INCR  	Inc Research A                                    	NASDAQ    	none      
INCY  	Incyte Corp                                       	NASDAQ    	SP500     
INFO  	IHS Markit Ltd                                    	NASDAQ    	SP500     
INFY  	Infosys Ltd                                       	NYSE      	none      
ING   	VOYA Group N.V.                                   	NYSE      	none      
INN   	Summit Hotel Properties                           	NYSE      	SP600     
INOV  	Inovalon Hldgs Cm A                               	NASDAQ    	none      
INSM  	Insmed Inc                                        	NASDAQ    	none      
INT   	World Fuel Services Corp                          	NYSE      	none      
INTC  	Intel Corp                                        	NASDAQ    	SP500     
INTU  	Intuit Inc                                        	NASDAQ    	SP500     
INVA  	Innoviva Inc                                      	NASDAQ    	SP600     
INVH  	Invitation Homes Inc                              	NYSE      	none      
IONS  	Ionis Pharmaceutical                              	NASDAQ    	none      
IP    	International Paper Company                       	NYSE      	SP500     
IPG   	Interpublic Group of Companies                    	NYSE      	SP500     
IPGP  	Ipg Photonics Corp                                	NASDAQ    	none      
IPHI  	Inphi Corp                                        	NYSE      	none      
IPXL  	Impax Labs Inc                                    	NASDAQ    	SP600     
IQV   	Iqvia Holdings Inc.                               	NYSE      	SP500     
IR    	Ingersoll-Rand Plc [Ireland]                      	NYSE      	SP500     
IRBT  	Irobot Corp                                       	NASDAQ    	SP600     
IRDM  	Iridium Comm Inc                                  	NASDAQ    	SP600     
IRM   	Iron Mountain Inc                                 	NYSE      	SP500     
IRWD  	Ironwood Pharmaceuti                              	NASDAQ    	none      
ISBC  	Investors Bancorp                                 	NASDAQ    	none      
ISRG  	Intuitive Surg Inc                                	NASDAQ    	SP500     
ITT   	ITT Industries                                    	NYSE      	none      
ITUB  	Itau Unibanco Banco Holding S.A.                  	NYSE      	none      
ITW   	Illinois Tool Works Inc                           	NYSE      	SP500     
IVR   	Invesco Mortgage Capital Inc                      	NYSE      	SP600     
IVZ   	Invesco Plc                                       	NYSE      	SP500     
JACK  	Jack In The Box Inc                               	NASDAQ    	none      
JAG   	Jagged Peak Energy Inc                            	NYSE      	none      
JBGS  	Jbg Smith Properties                              	NYSE      	none      
JBHT  	J B Hunt Transport                                	NASDAQ    	SP500     
JBL   	Jabil Circuit                                     	NYSE      	none      
JBLU  	Jetblue Airways Cp                                	NASDAQ    	none      
JCI   	Johnson Controls Intl                             	NYSE      	SP500     
JD    	Jd.Com Inc Ads                                    	NASDAQ    	NDX       
JEC   	Jacobs Engineering Group Inc                      	NYSE      	SP500     
JELD  	Jeld-Wen Holding Inc                              	NYSE      	none      
JHG   	Janus Henderson Group Plc.                        	NYSE      	none      
JKS   	Jinkosolar Holding Company Ltd                    	NYSE      	none      
JNJ   	Johnson & Johnson                                 	NYSE      	SP500     
JNPR  	Juniper Networks                                  	NYSE      	SP500     
JPM   	JP Morgan Chase & Co                              	NYSE      	SP500     
JUNO  	Juno Therapeutics                                 	NASDAQ    	none      
JWN   	Nordstrom                                         	NYSE      	SP500     
K     	Kellogg Company                                   	NYSE      	SP500     
KAR   	Kar Auction Services Inc                          	NYSE      	none      
KBH   	KB Home                                           	NYSE      	none      
KBR   	KBR Inc                                           	NYSE      	none      
KEM   	Kemet Corp                                        	NYSE      	SP600     
KEX   	Kirby Corp                                        	NYSE      	none      
KEY   	Keycorp                                           	NYSE      	SP500     
KEYS  	Keysight Technologies Inc Comm                    	NYSE      	none      
KFY   	Korn/Ferry International                          	NYSE      	SP600     
KHC   	Kraft Heinz Co                                    	NASDAQ    	SP500     
KIM   	Kimco Realty Corp                                 	NYSE      	SP500     
KKR   	KKR & Co. LP                                      	NYSE      	none      
KL    	Kirkland Lake Gold Ltd                            	NYSE      	none      
KLAC  	K L A-Tencor Corp                                 	NASDAQ    	SP500     
KLIC  	Kulicke and Soffa                                 	NASDAQ    	SP600     
KLXI  	Klx Inc                                           	NASDAQ    	none      
KMB   	Kimberly-Clark Corp                               	NYSE      	SP500     
KMI   	Kinder Morgan                                     	NYSE      	SP500     
KMT   	Kennametal Inc                                    	NYSE      	none      
KMX   	Carmax Inc                                        	NYSE      	SP500     
KN    	Knowles Corp                                      	NYSE      	none      
KNX   	Knight-Swift Transporation Inc                    	NYSE      	none      
KO    	Coca-Cola Company                                 	NYSE      	SP500     
KORS  	Michael Kors Holdings Ltd                         	NYSE      	SP500     
KR    	Kroger Company                                    	NYSE      	SP500     
KRNY  	Kearny Financial                                  	NASDAQ    	none      
KRO   	Kronos Worldwide Inc                              	NYSE      	none      
KS    	Kapstone Paper and Packaging Corp                 	NYSE      	SP600     
KSS   	Kohl's Corp                                       	NYSE      	SP500     
KSU   	Kansas City Southern                              	NYSE      	SP500     
KT    	Korea Telecom Corp                                	NYSE      	none      
KTOS  	Kratos Defns                                      	NASDAQ    	none      
KW    	Kennedy-Wilson Holdings Inc                       	NYSE      	none      
KYN   	Kayne Anderson MLP Investment Company             	NYSE      	none      
L     	Loews Corp                                        	NYSE      	SP500     
LADR  	Ladder Capital Corp                               	NYSE      	none      
LAMR  	Lamar Advertis A                                  	NASDAQ    	none      
LAUR  	Laureate Education Inc                            	NASDAQ    	none      
LAZ   	Lazard Ltd                                        	NYSE      	none      
LB    	L Brands Inc                                      	NYSE      	SP500     
LBRDK 	Liberty Broadbd C                                 	NASDAQ    	none      
LCI   	Lannett Co Inc                                    	NYSE      	SP600     
LDOS  	Leidos Holdings Inc                               	NYSE      	none      
LEG   	Leggett & Platt Inc                               	NYSE      	SP500     
LEN   	Lennar Corp                                       	NYSE      	SP500     
LFC   	China Life Insurance Company Ltd                  	NYSE      	none      
LGF.A 	Lions Gate Entertainment Corp Cl A                	NYSE      	none      
LH    	Laboratory Corporation of America Holdings        	NYSE      	SP500     
LHO   	Lasalle Hotel Properties                          	NYSE      	none      
LILAK 	Liberty Lilac Cl C                                	NASDAQ    	none      
LITE  	Lumentum Hld                                      	NASDAQ    	SP600     
LJPC  	La Jolla Pharma                                   	NASDAQ    	none      
LKQ   	LKQ Corp                                          	NASDAQ    	SP500     
LL    	Lumber Liquidators Holdings Inc                   	NYSE      	SP600     
LLL   	L-3 Communications Holdings                       	NYSE      	SP500     
LLY   	Eli Lilly and Company                             	NYSE      	SP500     
LM    	Legg Mason Inc                                    	NYSE      	none      
LMT   	Lockheed Martin Corp                              	NYSE      	SP500     
LNC   	Lincoln National Corp                             	NYSE      	SP500     
LNCE  	Snyders-Lance Inc                                 	NASDAQ    	none      
LNG   	Cheniere Energy                                   	AMEX      	none      
LNT   	Alliant Energy Corp                               	NYSE      	SP500     
LOGM  	Logmein Inc                                       	NASDAQ    	none      
LOW   	Lowe's Companies                                  	NYSE      	SP500     
LPI   	Laredo Petroleum Holdings Inc                     	NYSE      	none      
LPL   	Lg Display Co. Ltd                                	NYSE      	none      
LPLA  	Lpl Financial Hld                                 	NASDAQ    	none      
LPX   	Louisiana-Pacific Corp                            	NYSE      	none      
LQ    	La Quinta Holdings Inc                            	NYSE      	none      
LRCX  	Lam Research Corp                                 	NASDAQ    	SP500     
LSXMA 	Liberty Srs XM CS A                               	NASDAQ    	none      
LSXMK 	Liberty Srs XM CS C                               	NASDAQ    	none      
LTM   	Latam Airlines Group S.A.                         	NYSE      	none      
LUK   	Leucadia National Corp                            	NYSE      	SP500     
LULU  	Lululemon Athletica                               	NASDAQ    	none      
LUV   	Southwest Airlines Company                        	NYSE      	SP500     
LVNTA 	Liberty Vntrs Srs A                               	NASDAQ    	none      
LVS   	Las Vegas Sands                                   	NYSE      	none      
LW    	Lamb Weston Holdings Inc                          	NYSE      	none      
LXRX  	Lexicon Pharmaceutcl                              	NASDAQ    	none      
LYB   	Lyondellbasell Industries Nv                      	NYSE      	SP500     
LYV   	Live Nation Entertainment                         	NYSE      	none      
LZB   	La-Z-Boy Inc                                      	NYSE      	SP600     
M     	Macy's Inc                                        	NYSE      	SP500     
MA    	Mastercard Inc                                    	NYSE      	SP500     
MAA   	Mid-America Apartment Communities                 	NYSE      	SP500     
MAC   	Macerich Company                                  	NYSE      	SP500     
MANH  	Manhattan Assoc                                   	NASDAQ    	none      
MAR   	Marriot Int Class A                               	NASDAQ    	SP500     
MARK  	Remark Holdings Inc                               	NASDAQ    	none      
MAS   	Masco Corp                                        	NYSE      	SP500     
MAT   	Mattel Inc                                        	NASDAQ    	SP500     
MB    	Mindbody Cls A                                    	NASDAQ    	none      
MBT   	Mobile Telesystems                                	NYSE      	none      
MCD   	McDonald's Corp                                   	NYSE      	SP500     
MCHP  	Microchip Technology                              	NASDAQ    	SP500     
MCK   	Mckesson Corp                                     	NYSE      	SP500     
MCO   	Moody's Corp                                      	NYSE      	SP500     
MCRN  	Milacron Holdings Corp                            	NYSE      	none      
MD    	Mednax Inc                                        	NYSE      	none      
MDC   	M.D.C. Holdings                                   	NYSE      	SP600     
MDCO  	Medicines Co                                      	NASDAQ    	SP600     
MDLZ  	Mondelez Intl Cmn A                               	NASDAQ    	SP500     
MDP   	Meredith Corp                                     	NYSE      	none      
MDRX  	Allscripts Hlthcare                               	NASDAQ    	none      
MDSO  	Medidata Solutions                                	NASDAQ    	none      
MDT   	Medtronic Inc                                     	NYSE      	SP500     
MDU   	Mdu Res Group Inc                                 	NYSE      	none      
MDXG  	Mimedx Group Inc                                  	NASDAQ    	SP600     
MELI  	Mercadolibre Inc                                  	NASDAQ    	none      
MEOH  	Methanex Cp                                       	NASDAQ    	none      
MET   	Metlife Inc                                       	NYSE      	SP500     
MFC   	Manulife Financial Corp                           	NYSE      	none      
MFGP  	Micro Focus Intl Plc                              	NYSE      	none      
MGA   	Magna International                               	NYSE      	none      
MGM   	MGM Resorts International                         	NYSE      	SP500     
MGP   	MGM Growth Properties Llc                         	NYSE      	none      
MHK   	Mohawk Industries                                 	NYSE      	SP500     
MIDD  	Middleby Corp                                     	NASDAQ    	none      
MIK   	The Michaels Comp                                 	NASDAQ    	none      
MKC   	Mccormick & Company Inc                           	NYSE      	SP500     
MKSI  	Mks Instruments Inc                               	NASDAQ    	none      
MLCO  	Melco Resorts & Entertainment                     	NASDAQ    	none      
MLM   	Martin Marietta Materials                         	NYSE      	SP500     
MLNX  	Mellanox Technologies                             	NASDAQ    	none      
MMC   	Marsh & Mclennan Companies                        	NYSE      	SP500     
MMM   	3M Company                                        	NYSE      	SP500     
MMP   	Magellan Midstream Partners LP                    	NYSE      	none      
MNK   	Mallinckrodt Plc Ordinary Share                   	NYSE      	none      
MNST  	Monster Beverage Cp                               	NASDAQ    	SP500     
MNTA  	Momenta Pharma                                    	NASDAQ    	SP600     
MO    	Altria Group                                      	NYSE      	SP500     
MOH   	Molina Healthcare Inc                             	NYSE      	none      
MOMO  	Momo Inc Ads                                      	NASDAQ    	none      
MON   	Monsanto Company                                  	NYSE      	SP500     
MOS   	Mosaic Company                                    	NYSE      	SP500     
MPC   	Marathon Petroleum Corp                           	NYSE      	SP500     
MPLX  	Mplx LP                                           	NYSE      	none      
MRC   	Mrc Global Inc                                    	NYSE      	none      
MRK   	Merck & Company                                   	NYSE      	SP500     
MRO   	Marathon Oil Corp                                 	NYSE      	SP500     
MRVL  	Marvell Tech Group                                	NASDAQ    	none      
MS    	Morgan Stanley                                    	NYSE      	SP500     
MSCC  	Microsemi Corp                                    	NASDAQ    	none      
MSFT  	Microsoft Corp                                    	NASDAQ    	SP500     
MSGN  	Msg Networks Inc                                  	NYSE      	none      
MSI   	Motorola Solutions                                	NYSE      	SP500     
MT    	Arcelormittal                                     	NYSE      	none      
MTB   	M&T Bank Corp                                     	NYSE      	SP500     
MTCH  	Match Group Inc CS                                	NASDAQ    	none      
MTDR  	Matador Resources Company                         	NYSE      	none      
MTG   	Mgic Investment Corp                              	NYSE      	none      
MTN   	Vail Resorts                                      	NYSE      	none      
MTOR  	Arvinmeritor                                      	NYSE      	none      
MTSI  	Macom Technology S                                	NASDAQ    	none      
MTZ   	Mastec Inc                                        	NYSE      	none      
MU    	Micron Technology                                 	NASDAQ    	SP500     
MULE  	Mulesoft Inc. Class A                             	NYSE      	none      
MUR   	Murphy Oil Corp                                   	NYSE      	none      
MWA   	Mueller Water Products                            	NYSE      	none      
MXIM  	Maxim Integrated                                  	NASDAQ    	NDX       
MYGN  	Myriad Genetics Inc                               	NASDAQ    	SP600     
MYL   	Mylan Nv Ord Shs                                  	NASDAQ    	SP500     
MZOR  	Mazor Robotics Ads                                	NASDAQ    	none      
NATI  	Natl Instruments Cor                              	NASDAQ    	none      
NAV   	Navistar International Corp                       	NYSE      	none      
NAVI  	Navient Cp                                        	NASDAQ    	SP500     
NBIX  	Neurocrine Bioscienc                              	NASDAQ    	none      
NBL   	Noble Energy Inc                                  	NYSE      	SP500     
NCLH  	Norwegian Cruise Ord                              	NASDAQ    	SP500     
NCR   	NCR Corp                                          	NYSE      	none      
NCS   	NCI Building Systems                              	NYSE      	none      
NDAQ  	Nasdaq Inc                                        	NASDAQ    	SP500     
NEE   	Nextera Energy                                    	NYSE      	SP500     
NEM   	Newmont Mining Corp                               	NYSE      	SP500     
NETE  	Net Element Inc                                   	NASDAQ    	none      
NEWR  	New Relic Inc                                     	NYSE      	none      
NEWS  	Newstar Financial                                 	NASDAQ    	none      
NFLX  	Netflix Inc                                       	NASDAQ    	SP500     
NFX   	Newfield Exploration Company                      	NYSE      	SP500     
NGG   	National Grid Transco Plc                         	NYSE      	none      
NGL   	Ngl Energy Partners LP                            	NYSE      	none      
NI    	NiSource Inc                                      	NYSE      	SP500     
NJR   	Newjersey Resources Corp                          	NYSE      	none      
NKE   	Nike Inc                                          	NYSE      	SP500     
NKTR  	Nektar Therapeutics                               	NASDAQ    	SP600     
NLSN  	Nielsen Holdings Plc                              	NYSE      	SP500     
NLY   	Annaly Capital Management Inc                     	NYSE      	none      
NMIH  	Nmi Holdings Cmn A                                	NASDAQ    	SP600     
NNN   	National Retail Properties                        	NYSE      	none      
NOC   	Northrop Grumman Corp                             	NYSE      	SP500     
NOMD  	Nomad Foods Limited Ordinary Sh                   	NYSE      	none      
NOV   	National-Oilwell                                  	NYSE      	SP500     
NOW   	Servicenow Inc                                    	NYSE      	none      
NRG   	NRG Energy                                        	NYSE      	SP500     
NRZ   	New Residential Investment Corp                   	NYSE      	none      
NS    	Nustar Energy LP                                  	NYSE      	none      
NSA   	National Storage Affiliates Tru                   	NYSE      	SP600     
NSC   	Norfolk Southern Corp                             	NYSE      	SP500     
NTAP  	Netapp Inc                                        	NASDAQ    	SP500     
NTCT  	Netscout Systems I                                	NASDAQ    	none      
NTES  	Netease Inc Ads                                   	NASDAQ    	NDX       
NTGR  	Netgear Inc                                       	NASDAQ    	SP600     
NTLA  	Intellia Thera CS                                 	NASDAQ    	none      
NTNX  	Nutanix Inc                                       	NASDAQ    	none      
NUAN  	Nuance Communicatns                               	NASDAQ    	none      
NUE   	Nucor Corp                                        	NYSE      	SP500     
NUVA  	Nuvasive Inc                                      	NASDAQ    	none      
NVCR  	Novocure Ltd Ord Sh                               	NASDAQ    	none      
NVDA  	Nvidia Corp                                       	NASDAQ    	SP500     
NVO   	Novo Nordisk A/S                                  	NYSE      	none      
NVRO  	Nevro Corp                                        	NYSE      	none      
NVS   	Novartis Ag                                       	NYSE      	none      
NWL   	Newell Rubbermaid Inc                             	NYSE      	SP500     
NWS   	News Cp Cl B Cmn ST                               	NASDAQ    	SP500     
NWSA  	News Cp Cl A Cmn ST                               	NASDAQ    	SP500     
NXPI  	Nxp Semiconductors                                	NASDAQ    	none      
NXST  	Nexstar Broadcasting                              	NASDAQ    	none      
NXTM  	Nxstage Medical Inc                               	NASDAQ    	none      
NYCB  	New York Community Bancorp                        	NYSE      	none      
NYLD  	NRG Yield Inc                                     	NYSE      	none      
NYT   	New York Times Company                            	NYSE      	none      
O     	Realty Income Corp                                	NYSE      	SP500     
OA    	Orbital Atk Inc                                   	NYSE      	none      
OC    	Owens Corning Inc                                 	NYSE      	none      
ODFL  	Old Dominion Freig                                	NASDAQ    	none      
OEC   	Orion Engineered Carbons S.A R                    	NYSE      	none      
OFC   	Corporate Office Properties                       	NYSE      	none      
OGE   	Oge Energy Corp                                   	NYSE      	none      
OHI   	Omega Healthcare Investors                        	NYSE      	none      
OI    	Owens-Illinois                                    	NYSE      	none      
OII   	Oceaneering International                         	NYSE      	none      
OIS   	Oil States International                          	NYSE      	SP600     
OKE   	Oneok Inc                                         	NYSE      	SP500     
OKTA  	Okta Inc. Class A                                 	NASDAQ    	none      
OLED  	Universal Display                                 	NASDAQ    	none      
OLLI  	Ollies Bargain CS                                 	NASDAQ    	SP600     
OLN   	Olin Corp                                         	NYSE      	none      
OMAM  	Om Asset Management Ltd                           	NYSE      	none      
OMC   	Omnicom Group Inc                                 	NYSE      	SP500     
OME   	Omega Protein Corp                                	NYSE      	none      
OMER  	Omeros Corp                                       	NASDAQ    	none      
OMF   	Onemain Holdings Inc                              	NYSE      	none      
OMI   	Owens & Minor                                     	NYSE      	none      
ON    	On Semiconductor                                  	NASDAQ    	none      
ONB   	Old National Bncp                                 	NASDAQ    	SP600     
ONCE  	Spark Therap                                      	NASDAQ    	none      
OR    	Osisko Gold Royalties Ltd                         	NYSE      	none      
ORCL  	Oracle Corp                                       	NYSE      	SP500     
ORI   	Old Republic International Corp                   	NYSE      	none      
ORLY  	O'Reilly Automotive                               	NASDAQ    	SP500     
OSIS  	O S I Systems Inc                                 	NASDAQ    	SP600     
OSK   	Oshkosh Truck Corp                                	NYSE      	none      
OSTK  	Overstock.Com Inc                                 	NASDAQ    	none      
OSUR  	Orasure Tech Inc                                  	NASDAQ    	SP600     
OUT   	Outfront Media Inc                                	NYSE      	none      
OXY   	Occidental Petroleum Corp                         	NYSE      	SP500     
OZRK  	Bank of The Ozarks                                	NASDAQ    	none      
PAA   	Plains All American Pipeline LP                   	NYSE      	none      
PAAS  	Pan Amer Silver Corp                              	NASDAQ    	none      
PACW  	Pacwest Bancorp                                   	NASDAQ    	none      
PAGP  	Plains Gp Holdings LP                             	NYSE      	none      
PAH   	Platform Specialty Products Corp                  	NYSE      	none      
PANW  	Palo Alto Networks Inc                            	NYSE      	none      
PAY   	Verifone Systems                                  	NYSE      	none      
PAYC  	Paycom Software Inc                               	NYSE      	none      
PAYX  	Paychex Inc                                       	NASDAQ    	SP500     
PBCT  	People's United Finl                              	NASDAQ    	SP500     
PBF   	PBF Energy Inc                                    	NYSE      	none      
PBH   	Prestige Brand Holdings                           	NYSE      	none      
PBI   	Pitney Bowes Inc                                  	NYSE      	none      
PBYI  	Puma Biotechnology                                	NASDAQ    	none      
PCAR  	Paccar Inc                                        	NASDAQ    	SP500     
PCG   	Pacific Gas & Electric Co                         	NYSE      	SP500     
PCH   	Potlatch Cp                                       	NASDAQ    	none      
PCRX  	Pacira Pharm Inc                                  	NASDAQ    	none      
PDCE  	Pdc Energy Inc                                    	NASDAQ    	SP600     
PDCO  	Patterson Companies                               	NASDAQ    	SP500     
PDFS  	Pdf Solutions Inc                                 	NASDAQ    	SP600     
PE    	Parsley Energy                                    	NYSE      	none      
PEG   	Public Service Enterprise Group Inc               	NYSE      	SP500     
PEGI  	Pattern Energy Cl A                               	NASDAQ    	none      
PEI   	Pennsylvania Real Estate Investment               	NYSE      	SP600     
PENN  	Penn Natl Gaming Inc                              	NASDAQ    	SP600     
PEP   	Pepsico Inc                                       	NASDAQ    	SP500     
PETS  	Petmed Express Inc                                	NASDAQ    	SP600     
PF    	Pinnacle Foods Inc                                	NYSE      	none      
PFE   	Pfizer Inc                                        	NYSE      	SP500     
PFG   	Principal Financial Group Inc                     	NASDAQ    	SP500     
PFGC  	Performance Food Group Co                         	NYSE      	none      
PG    	Procter & Gamble Company                          	NYSE      	SP500     
PGR   	Progressive Corp                                  	NYSE      	SP500     
PGRE  	Paramount Group Inc                               	NYSE      	none      
PH    	Parker-Hannifin Corp                              	NYSE      	SP500     
PHG   	Koninklijke Philips Electronics                   	NYSE      	none      
PHH   	Phh Corp                                          	NYSE      	none      
PHM   	Pultegroup                                        	NYSE      	SP500     
PII   	Polaris Industries Inc                            	NYSE      	none      
PINC  	Premier Inc Cl A                                  	NASDAQ    	none      
PK    	Park Hotels & Resorts Inc                         	NYSE      	none      
PKG   	Packaging Corporation of America                  	NYSE      	SP500     
PKI   	Perkinelmer                                       	NYSE      	SP500     
PLAY  	Dave & Buster's Ente                              	NASDAQ    	SP600     
PLD   	Prologis Inc                                      	NYSE      	SP500     
PLNT  	Planet Fitness                                    	NYSE      	none      
PM    	Philip Morris International Inc                   	NYSE      	SP500     
PNC   	PNC Bank                                          	NYSE      	SP500     
PNK   	Pinnacle Entmt                                    	NASDAQ    	none      
PNM   	PNM Resources Inc                                 	NYSE      	none      
PNR   	Pentair Ltd                                       	NYSE      	SP500     
PNW   	Pinnacle West Capital Corp                        	NYSE      	SP500     
PODD  	Insulet Corp                                      	NASDAQ    	none      
POR   	Portland General Electric Company                 	NYSE      	none      
POST  	Post Holdings Inc                                 	NYSE      	none      
POT   	Potash Corp. of Saskatchewan Inc                  	NYSE      	none      
PPBI  	Pacific Premier Bncp                              	NASDAQ    	SP600     
PPC   	Pilgrim's Pride                                   	NASDAQ    	none      
PPG   	PPG Industries                                    	NYSE      	SP500     
PPL   	PPL Corp                                          	NYSE      	SP500     
PQG   	Pq Group Holdings Inc.                            	NYSE      	none      
PRAH  	Pra Health                                        	NASDAQ    	none      
PRGO  	Perrigo Company                                   	NYSE      	SP500     
PRTY  	Party City Holdco Inc                             	NYSE      	none      
PRU   	Prudential Financial Inflation Retail             	NYSE      	SP500     
PSA   	Public Storage                                    	NYSE      	SP500     
PSTG  	Pure Storage Inc                                  	NYSE      	none      
PSX   	Phillips 66                                       	NYSE      	SP500     
PTC   	Ptc Inc                                           	NASDAQ    	none      
PTCT  	Ptc Therapeutics                                  	NASDAQ    	none      
PTEN  	Patterson-Uti Energy                              	NASDAQ    	none      
PTLA  	Portola Pharma                                    	NASDAQ    	none      
PUMP  	Propetro Holding Corp.                            	NYSE      	none      
PVG   	Pretium Res Inc                                   	NYSE      	none      
PVH   	Phillips-Van Heusen Corp                          	NYSE      	SP500     
PWR   	Quanta Services                                   	NYSE      	SP500     
PX    	Praxair                                           	NYSE      	SP500     
PXD   	Pioneer Natural Resources Co                      	NYSE      	SP500     
PYPL  	Paypal Holdings                                   	NASDAQ    	SP500     
PZZA  	Papa John's Intl                                  	NASDAQ    	none      
QCOM  	Qualcomm Inc                                      	NASDAQ    	SP500     
QCP   	Quality Care Properties Inc                       	NYSE      	none      
QD    	Qudian Inc ADR                                    	NYSE      	none      
QDEL  	Quidel Cp                                         	NASDAQ    	none      
QGEN  	Qiagen N.V.                                       	NASDAQ    	none      
QRVO  	Qorvo Inc                                         	NASDAQ    	SP500     
QSR   	Restaurant Brands International                   	NYSE      	none      
QUOT  	Quotient Technology Inc                           	NYSE      	none      
QVCA  	Liberty Int Qvc Sr A                              	NASDAQ    	NDX       
R     	Ryder System                                      	NYSE      	none      
RACE  	Ferrari N.V.                                      	NYSE      	none      
RARE  	Ultragenyx Pharmaceu                              	NASDAQ    	none      
RBA   	Ritchie Bros. Auctioneers Inc                     	NYSE      	none      
RCII  	Rent-A-Center Inc                                 	NASDAQ    	SP600     
RCL   	Royal Caribbean Cruises Ltd                       	NYSE      	SP500     
RDC   	Rowan Companies                                   	NYSE      	none      
RDFN  	Redfin Corp                                       	NASDAQ    	none      
RDN   	Radian Group Inc                                  	NYSE      	none      
RDS.A 	Royal Dutch Shell Plc                             	NYSE      	none      
RDS.B 	Royal Dutch Shell                                 	NYSE      	none      
RDUS  	Radius Health                                     	NASDAQ    	none      
RE    	Everest Re Group                                  	NYSE      	SP500     
REG   	Regency Centers Corp                              	NYSE      	SP500     
REGN  	Regeneron Pharmaceutical                          	NASDAQ    	SP500     
REN   	Resolute Energy Corp                              	NYSE      	none      
RES   	RPC Inc                                           	NYSE      	none      
REXR  	Rexford Industrial Realty Inc                     	NYSE      	none      
RF    	Regions Financial Corp                            	NYSE      	SP500     
RFP   	Resolute Forest Products Inc                      	NYSE      	none      
RGC   	Regal Entertainment Group                         	NYSE      	none      
RH    	Restoration Hardware Holdings                     	NYSE      	SP600     
RHI   	Robert Half International Inc                     	NYSE      	SP500     
RHT   	Red Hat Inc                                       	NYSE      	SP500     
RIG   	Transocean Inc                                    	NYSE      	none      
RIO   	Rio Tinto Plc                                     	NYSE      	none      
RIOT  	Riot Blockchain Inc.                              	NASDAQ    	none      
RJF   	Raymond James Financial                           	NYSE      	SP500     
RL    	Ralph Lauren Corp                                 	NYSE      	SP500     
RLGY  	Realogy Holdings Corp                             	NYSE      	none      
RMBS  	Rambus Inc                                        	NASDAQ    	SP600     
RMD   	Resmed Inc                                        	NYSE      	SP500     
RNG   	Ringcentral Inc                                   	NYSE      	none      
ROIC  	Retail Opp Invts Cp                               	NASDAQ    	SP600     
ROK   	Rockwell Automation Inc                           	NYSE      	SP500     
ROKU  	Roku Inc.                                         	NASDAQ    	none      
ROL   	Rollins Inc                                       	NYSE      	none      
ROST  	Ross Stores Inc                                   	NASDAQ    	SP500     
RP    	Realpage Inc                                      	NASDAQ    	none      
RPAI  	Retail Properties of America                      	NYSE      	none      
RPM   	RPM International Inc                             	NYSE      	none      
RRC   	Range Resources Corp                              	NYSE      	SP500     
RRR   	Rd Rock Rsrts Cla                                 	NASDAQ    	none      
RSG   	Republic Services                                 	NYSE      	SP500     
RSPP  	Rsp Permian Inc                                   	NYSE      	none      
RTN   	Raytheon Company                                  	NYSE      	SP500     
RVNC  	Revance Therapeutics                              	NASDAQ    	none      
RXDX  	Ignyta Inc                                        	NASDAQ    	none      
RXN   	Rexnord Corp                                      	NYSE      	none      
RY    	Royal Bank of Canada                              	NYSE      	none      
RYAAY 	Ryanair Hldgs Plc                                 	NASDAQ    	none      
RYAM  	Rayonier Advanced Materials Inc                   	NYSE      	SP600     
RYB   	Ryb Education Inc. Aps                            	NYSE      	none      
SABR  	Sabre Corp                                        	NASDAQ    	none      
SAFM  	Sanderson Farms In                                	NASDAQ    	none      
SAGE  	Sage Therapeutic Com                              	NASDAQ    	none      
SAIL  	Sailpoint Technologies Holdings Inc.              	NYSE      	none      
SANM  	Sanmina Corp                                      	NASDAQ    	SP600     
SAVE  	Spirit Airlines Inc                               	NASDAQ    	none      
SBAC  	SBA Communications                                	NASDAQ    	SP500     
SBGI  	Sinclair Brdcst A                                 	NASDAQ    	none      
SBH   	Sally Beauty Holdings                             	NYSE      	none      
SBRA  	Sabra REIT                                        	NASDAQ    	none      
SBS   	Cia De Saneamento Basico Do Estado                	NYSE      	none      
SBUX  	Starbucks Corp                                    	NASDAQ    	SP500     
SC    	Santander Consumer USA Holdings                   	NYSE      	none      
SCCO  	Southern Peru Copper Corp                         	NYSE      	none      
SCG   	Scana Corp                                        	NYSE      	SP500     
SCI   	Service Corporation International                 	NYSE      	none      
SCMP  	Sucampo Pharma Inc                                	NASDAQ    	SP600     
SCS   	Steelcase Inc                                     	NYSE      	none      
SD    	Sandridge Energy Inc                              	NYSE      	none      
SE    	Sea Limited ADR                                   	NYSE      	none      
SEAS  	Seaworld Entertainment Inc Co                     	NYSE      	none      
SEDG  	Solaredge Tech                                    	NASDAQ    	SP600     
SEE   	Sealed Air Corp                                   	NYSE      	SP500     
SEIC  	Sei Investments Co                                	NASDAQ    	none      
SEM   	Select Medical Holdings Corp                      	NYSE      	SP600     
SEMG  	Semgroup Corp                                     	NYSE      	none      
SEP   	Spectra Energy Partners LP                        	NYSE      	none      
SERV  	Servicemaster Global Holdings I                   	NYSE      	none      
SFIX  	Stitch Fix Inc.                                   	NASDAQ    	none      
SFL   	Ship Finance International                        	NYSE      	none      
SFLY  	Shutterfly Inc                                    	NASDAQ    	SP600     
SFM   	Sprouts Farmers Mark                              	NASDAQ    	none      
SGEN  	Seattle Genetics Inc                              	NASDAQ    	none      
SGH   	Smart Global Holdings Inc                         	NASDAQ    	none      
SGMO  	Sangamo Therapeutics                              	NASDAQ    	none      
SGMS  	Scientific Games                                  	NASDAQ    	SP600     
SGRY  	Surgery Partners CS                               	NASDAQ    	none      
SHAK  	Shake Shack Inc                                   	NYSE      	SP600     
SHLX  	Shell Midstream Partners LP                       	NYSE      	none      
SHO   	Sunstone Hotel Investors                          	NYSE      	none      
SHOO  	Steven Maddens Ltd                                	NASDAQ    	SP600     
SHOP  	Shopify Inc                                       	NYSE      	none      
SHPG  	Shire Plc Ads                                     	NASDAQ    	NDX       
SHW   	Sherwin-Williams Company                          	NYSE      	SP500     
SIEB  	Siebert Fin Cp                                    	NASDAQ    	none      
SIG   	Signet Jewelers Ltd                               	NYSE      	SP500     
SINA  	Sina Corp                                         	NASDAQ    	none      
SIVB  	Svb Financial Grp                                 	NASDAQ    	none      
SIX   	Six Flags Entertainment Corp                      	NYSE      	none      
SJM   	J.M. Smucker Company                              	NYSE      	SP500     
SKM   	Sk Telecom Corp                                   	NYSE      	none      
SKT   	Tanger Factory Outlet Centers                     	NYSE      	none      
SKX   	Skechers U.S.A.                                   	NYSE      	none      
SLB   	Schlumberger N.V.                                 	NYSE      	SP500     
SLCA  	U.S. Silica Holdings Inc                          	NYSE      	SP600     
SLG   	SL Green Realty Corp                              	NYSE      	SP500     
SLM   	SLM Corp                                          	NASDAQ    	none      
SM    	Sm Energy Company                                 	NYSE      	none      
SMTC  	Semtech Corp                                      	NASDAQ    	SP600     
SNA   	Snap-On Inc                                       	NYSE      	SP500     
SNAP  	Snap Inc                                          	NYSE      	none      
SNBR  	Sleep Number Corporation                          	NASDAQ    	SP600     
SNDR  	Schneider National Inc                            	NYSE      	none      
SNE   	Sony Corp                                         	NYSE      	none      
SNI   	Scripps Ntwrks Int A                              	NASDAQ    	SP500     
SNPS  	Synopsys Inc                                      	NASDAQ    	SP500     
SNV   	Synovus Financial Corp                            	NYSE      	none      
SNY   	Sanofi-Aventis S.A.                               	NYSE      	none      
SO    	Southern Company                                  	NYSE      	SP500     
SOGO  	Sogou Inc.                                        	NYSE      	none      
SONC  	Sonic Cp                                          	NASDAQ    	SP600     
SPB   	Spectrum Brands Holdings                          	NYSE      	none      
SPG   	Simon Property Group                              	NYSE      	SP500     
SPGI  	S&P Global Inc                                    	NYSE      	SP500     
SPLK  	Splunk Inc                                        	NASDAQ    	none      
SPPI  	Spectrum Pharma Inc                               	NASDAQ    	SP600     
SPR   	Spirit Aerosystems Holdings                       	NYSE      	none      
SQ    	Square                                            	NYSE      	none      
SQM   	Sociedad Quimica Y Minera S.A.                    	NYSE      	none      
SRCL  	Stericycle Inc                                    	NASDAQ    	SP500     
SRE   	Sempra Energy                                     	NYSE      	SP500     
SRPT  	Sarepta Therapeutics                              	NASDAQ    	none      
SSNC  	SS&C Technologies                                 	NASDAQ    	none      
SSNI  	Silver Spring Networks Inc Co                     	NYSE      	none      
SSYS  	Stratasys Ltd                                     	NASDAQ    	none      
ST    	Sensata Technologies Holding N.V.                 	NYSE      	none      
STAG  	STI Inc                                           	NYSE      	none      
STAR  	Istar Financial Inc                               	NYSE      	none      
STAY  	Extended Stay America Inc                         	NYSE      	none      
STI   	Suntrust Banks                                    	NYSE      	SP500     
STL   	Sterling Bancorp                                  	NYSE      	none      
STLD  	Steel Dynamics Inc                                	NASDAQ    	none      
STM   	Stmicroelectronics N.V.                           	NYSE      	none      
STO   	Statoil ASA                                       	NYSE      	none      
STOR  	Store Capital Corpstore Capital                   	NYSE      	none      
STT   	State Street Corp                                 	NYSE      	SP500     
STX   	Seagate Tech Ord Shs                              	NASDAQ    	SP500     
STZ   	Constellation Brands Inc                          	NYSE      	SP500     
SU    	Suncor Energy Inc                                 	NYSE      	none      
SUM   	Summit Materials Inc                              	NYSE      	none      
SVU   	Supervalu Inc                                     	NYSE      	SP600     
SWCH  	Switch Inc.                                       	NYSE      	none      
SWK   	Stanley Black & Decker Inc                        	NYSE      	SP500     
SWKS  	Skyworks Solutions                                	NASDAQ    	SP500     
SXC   	Suncoke Energy Inc                                	NYSE      	SP600     
SYF   	Synchrony Financial                               	NYSE      	SP500     
SYK   	Stryker Corp                                      	NYSE      	SP500     
SYMC  	Symantec Corp                                     	NASDAQ    	SP500     
SYNA  	Synaptics Inc                                     	NASDAQ    	none      
SYRS  	Syros Pharmaceuticals                             	NASDAQ    	none      
SYY   	Sysco Corp                                        	NYSE      	SP500     
T     	AT&T Inc                                          	NYSE      	SP500     
TAL   	Tal Education Group                               	NYSE      	none      
TAP   	Molson Coors Brewing Company                      	NYSE      	SP500     
TBB   	AT&T Inc. 5.350% Global Notes Due 2066            	NYSE      	none      
TCBI  	Texas Capital Bncsh                               	NASDAQ    	none      
TCF   	TCF Financial Corp                                	NYSE      	none      
TCO   	Taubman Centers                                   	NYSE      	none      
TD    	Toronto Dominion Bank                             	NYSE      	none      
TDC   	Teradata Corp                                     	NYSE      	none      
TDOC  	Teladoc Inc                                       	NYSE      	none      
TDS   	Telephone and Data Systems                        	NYSE      	none      
TEAM  	Atlassian Cls A Ord                               	NASDAQ    	none      
TECK  	Teck Resources Ltd                                	NYSE      	none      
TEL   	Te Connectivity Ltd                               	NYSE      	SP500     
TER   	Teradyne Inc                                      	NYSE      	none      
TERP  	Terraform Power Inc                               	NASDAQ    	none      
TEVA  	Teva Pharmaceutical Industries Ltd                	NYSE      	none      
TEX   	Terex Corp                                        	NYSE      	none      
TGI   	Triumph Group                                     	NYSE      	SP600     
TGNA  	Tegna Inc                                         	NYSE      	none      
TGT   	Target Corp                                       	NYSE      	SP500     
THC   	Tenet Healthcare Corp                             	NYSE      	none      
THO   	Thor Industries                                   	NYSE      	none      
THS   	Treehouse Foods                                   	NYSE      	none      
TIF   	Tiffany & Co                                      	NYSE      	SP500     
TILE  	Interface Inc                                     	NASDAQ    	SP600     
TIME  	Time Inc                                          	NYSE      	SP600     
TIVO  	Tivo Corp                                         	NASDAQ    	SP600     
TJX   	TJX Companies                                     	NYSE      	SP500     
TKR   	Timken Company                                    	NYSE      	none      
TLRD  	Tailored Brands Inc                               	NYSE      	SP600     
TMHC  	Taylor Morrison Home Corporatio                   	NYSE      	none      
TMK   	Torchmark Corp                                    	NYSE      	SP500     
TMO   	Thermo Fisher Scientific Inc                      	NYSE      	SP500     
TMUS  	T-Mobile US                                       	NASDAQ    	NDX       
TMUSP 	T-Mobile 5.5 Pfd A                                	NASDAQ    	none      
TOL   	Toll Brothers Inc                                 	NYSE      	none      
TOT   	Totalfinaelf S.A.                                 	NYSE      	none      
TPC   	Tutor Perini Corp                                 	NYSE      	none      
TPH   	Tri Pointe Homes Inc                              	NYSE      	none      
TPR   	Tapestry Inc                                      	NYSE      	SP500     
TPRE  	Third Point Reinsurance Ltd. Co                   	NYSE      	SP600     
TPX   	Tempur-Pedic International Inc                    	NYSE      	none      
TRCO  	Tribune Media Corp                                	NYSE      	none      
TRGP  	Targa Resources                                   	NYSE      	none      
TRI   	Thomson Reuters Corp                              	NYSE      	none      
TRIP  	Tripadvisor Inc                                   	NASDAQ    	SP500     
TRMB  	Trimble Navigation                                	NASDAQ    	none      
TRN   	Trinity Industries                                	NYSE      	none      
TROW  	T Rowe Price Group                                	NASDAQ    	SP500     
TROX  	Tronox Inc                                        	NYSE      	none      
TRP   	Transcananda Pipelines                            	NYSE      	none      
TRTN  	Triton International Ltd                          	NYSE      	none      
TRU   	Transunion                                        	NYSE      	none      
TRUE  	Truecar Inc                                       	NASDAQ    	none      
TRV   	The Travelers Companies Inc                       	NYSE      	SP500     
TS    	Tenaris S.A.                                      	NYSE      	none      
TSCO  	Tractor Supply Co                                 	NASDAQ    	SP500     
TSEM  	Tower Semiconductor                               	NASDAQ    	none      
TSLA  	Tesla Inc                                         	NASDAQ    	NDX       
TSM   	Taiwan Semiconductor Manufacturing                	NYSE      	none      
TSN   	Tyson Foods                                       	NYSE      	SP500     
TSRO  	Tesaro Inc                                        	NASDAQ    	none      
TSS   	Total System Services                             	NYSE      	SP500     
TSU   	Tim Participacoes S.A.                            	NYSE      	none      
TTC   	Toro Company                                      	NYSE      	none      
TTD   	Trade Desk Inc                                    	NASDAQ    	none      
TTM   	Tata Motors Ltd                                   	NYSE      	none      
TTMI  	TTM Technologies I                                	NASDAQ    	SP600     
TTWO  	Take-Two Interacti                                	NASDAQ    	none      
TV    	Grupo Televisa S.A.                               	NYSE      	none      
TVPT  	Travelport Worldwide Ltd                          	NYSE      	none      
TVTY  	Tivity Health                                     	NASDAQ    	SP600     
TWLO  	Twilio                                            	NYSE      	none      
TWNK  	Hostess Brands Inc                                	NASDAQ    	none      
TWO   	Two Harbors Investments Corp                      	NYSE      	none      
TWOU  	2U Inc                                            	NASDAQ    	none      
TWTR  	Twitter Inc                                       	NYSE      	none      
TWX   	Time Warner Inc                                   	NYSE      	SP500     
TXN   	Texas Instruments                                 	NASDAQ    	SP500     
TXRH  	Texas Roadhouse Inc                               	NASDAQ    	none      
TXT   	Textron Inc                                       	NYSE      	SP500     
UA    	Under Armour Inc Class C Comm                     	NYSE      	SP500     
UAA   	Under Armour                                      	NYSE      	SP500     
UAL   	United Continental Holdings                       	NYSE      	SP500     
UBS   	UBS Group Ag                                      	NYSE      	none      
UBSI  	United Bkshs Inc                                  	NASDAQ    	none      
UCTT  	Ultra Clean Holdings                              	NASDAQ    	none      
UE    	Urban Edge Properties                             	NYSE      	none      
UEPS  	Net 1 Ueps Techs Inc                              	NASDAQ    	none      
UGI   	Ugi Corp                                          	NYSE      	none      
UGLD  	VS 3X Gold                                        	NASDAQ    	none      
UHS   	Universal Health Services                         	NYSE      	SP500     
UL    	Unilever Plc                                      	NYSE      	none      
ULTA  	Ulta Salon Cosmetic                               	NASDAQ    	SP500     
UMPQ  	Umpqua Holdings Corp                              	NASDAQ    	none      
UN    	Unilever Nv                                       	NYSE      	none      
UNFI  	United Nat Foods I                                	NASDAQ    	none      
UNH   	Unitedhealth Group Inc                            	NYSE      	SP500     
UNIT  	Uniti Group Inc                                   	NASDAQ    	none      
UNM   	Unumprovident Corp                                	NYSE      	SP500     
UNP   	Union Pacific Corp                                	NYSE      	SP500     
UNVR  	Univar Inc                                        	NYSE      	none      
UPS   	United Parcel Service                             	NYSE      	SP500     
URBN  	Urban Outfitters Inc                              	NASDAQ    	none      
URI   	United Rentals                                    	NYSE      	SP500     
USB   	U.S. Bancorp                                      	NYSE      	SP500     
USFD  	US Foods Holding                                  	NYSE      	none      
USG   	USG Corp                                          	NYSE      	none      
USLV  	VS 3X Silver                                      	NASDAQ    	none      
UTX   	United Technologies Corp                          	NYSE      	SP500     
UWT   	Velocity 3X Long Crude Oil                        	AMEX      	none      
V     	Visa Inc                                          	NYSE      	SP500     
VAL.P 	Vale S.A.                                         	NYSE      	none      
VALE  	Vale S.A.                                         	NYSE      	none      
VAR   	Varian Medical Systems                            	NYSE      	SP500     
VCIT  	Interm Corp Bond Vanguard                         	NASDAQ    	none      
VCSH  	Sht-Term Corp Bond Vanguard                       	NASDAQ    	none      
VEA   	FTSE Developed Markets Vanguard                   	AMEX      	none      
VECO  	Veeco Instrument                                  	NASDAQ    	SP600     
VEEV  	Veeva Systems Inc                                 	NYSE      	none      
VERI  	Veritone Inc                                      	NASDAQ    	none      
VFC   	V.F. Corp                                         	NYSE      	SP500     
VG    	Vonage Holdings                                   	NYSE      	SP600     
VGR   	Vector Group Ltd                                  	NYSE      	none      
VIAB  	Viacom Inc Cl B                                   	NASDAQ    	SP500     
VIPS  	Vipshop Holdings Ltd                              	NYSE      	none      
VIRT  	Virtu Financial Cm A                              	NASDAQ    	none      
VIV   	Telecomunicacoes De Sao Paulo S/A Ads             	NYSE      	none      
VLO   	Valero Energy Corp                                	NYSE      	SP500     
VLY   	Valley National Bancorp                           	NYSE      	none      
VMBS  	Mortgage-Backed Securities Vanguard               	NASDAQ    	none      
VMC   	Vulcan Materials Company                          	NYSE      	SP500     
VMW   	Vmware Inc                                        	NYSE      	none      
VNDA  	Vanda Pharmaceutical                              	NASDAQ    	none      
VNTV  	Vantiv Inc                                        	NYSE      	none      
VOD   	Vodafone Grp Plc Ads                              	NASDAQ    	NDX       
VOYA  	VOYA Financial Inc                                	NYSE      	none      
VR    	Validus Holdings                                  	NYSE      	none      
VRA   	Vera Bradley                                      	NASDAQ    	SP600     
VRNT  	Verint Systems Inc                                	NASDAQ    	none      
VRS   	Verso Corp                                        	NYSE      	none      
VRSK  	Verisk Analytics Inc                              	NASDAQ    	SP500     
VRSN  	Verisign Inc                                      	NASDAQ    	SP500     
VRTX  	Vertex Pharmaceutic                               	NASDAQ    	SP500     
VRX   	Valeant Pharmaceuticals Intl                      	NYSE      	none      
VSH   	Vishay Intertechnology                            	NYSE      	none      
VSM   	Versum Materials Inc                              	NYSE      	none      
VST   	Vistra Energy Corp.                               	NYSE      	none      
VSTO  	Vista Outdoor Inc                                 	NYSE      	SP600     
VTIP  	Sht-Term Infl Protected Vanguard                  	NASDAQ    	none      
VTR   	Ventas Inc                                        	NYSE      	SP500     
VVV   	Valvoline Inc                                     	NYSE      	none      
VZ    	Verizon Communications Inc                        	NYSE      	SP500     
W     	Wayfair Inc                                       	NYSE      	none      
WAB   	Wabtec Corp                                       	NYSE      	none      
WAL   	Western Alliance Bancorporation                   	NYSE      	none      
WB    	Weibo Corp. Ads                                   	NASDAQ    	none      
WBA   	Walgreens Boots Alliance                          	NASDAQ    	SP500     
WBS   	Webster Financial Corp                            	NYSE      	none      
WBT   	Welbilt Inc                                       	NYSE      	none      
WCN   	Waste Connections Inc                             	NYSE      	none      
WDAY  	Workday Inc                                       	NASDAQ    	none      
WDC   	Western Digital Cp                                	NASDAQ    	SP500     
WDR   	Waddell & Reed Financial                          	NYSE      	SP600     
WEC   	Wisconsin Energy Corp                             	NYSE      	SP500     
WEN   	Wendys Company                                    	NASDAQ    	none      
WERN  	Werner Enterprise                                 	NASDAQ    	none      
WES   	Western Gas Partners LP                           	NYSE      	none      
WFC   	Wells Fargo & Company                             	NYSE      	SP500     
WGO   	Winnebago Industries                              	NYSE      	SP600     
WHR   	Whirlpool Corp                                    	NYSE      	SP500     
WING  	Wingstop Inc                                      	NASDAQ    	SP600     
WIX   	Wix.Com Ltd                                       	NASDAQ    	none      
WLK   	Westlake Chemical Corp                            	NYSE      	none      
WLL   	Whiting Petroleum Corp                            	NYSE      	none      
WLTW  	Willis Towers Wts                                 	NASDAQ    	SP500     
WM    	Waste Management                                  	NYSE      	SP500     
WMB   	Williams Companies                                	NYSE      	SP500     
WMGI  	Wright Med Grp Nv                                 	NASDAQ    	none      
WMT   	Wal-Mart Stores                                   	NYSE      	SP500     
WNC   	Wabash National Corp                              	NYSE      	SP600     
WPM   	Wheaton Precious Metals                           	NYSE      	none      
WPX   	Wpx Energy Inc                                    	NYSE      	none      
WPZ   	Williams Partners LP                              	NYSE      	none      
WR    	Westar Energy                                     	NYSE      	none      
WRB   	W.R. Berkley Corp                                 	NYSE      	none      
WRD   	Wildhorse Resour                                  	NYSE      	none      
WRI   	Weingarten Realty Investors                       	NYSE      	none      
WRK   	Westrock Company                                  	NYSE      	SP500     
WSM   	Williams-Sonoma                                   	NYSE      	none      
WTR   	Aqua America                                      	NYSE      	none      
WTTR  	Select Energy Services Inc                        	NYSE      	none      
WTW   	Weight Watchers International Inc                 	NYSE      	none      
WU    	Western Union Company                             	NYSE      	SP500     
WUBA  	58.Com Inc                                        	NYSE      	none      
WWE   	World Wrestling Entertainment                     	NYSE      	SP600     
WWW   	Wolverine World Wide                              	NYSE      	SP600     
WY    	Weyerhaeuser Company                              	NYSE      	SP500     
WYN   	Wyndham Worldwide Corp                            	NYSE      	SP500     
WYNN  	Wynn Resorts Ltd                                  	NASDAQ    	SP500     
X     	United States Steel Corp                          	NYSE      	none      
XEC   	Cimarex Energy Co                                 	NYSE      	SP500     
XEL   	XCEL Energy Inc                                   	NYSE      	SP500     
XHR   	Xenia Hotels & Resorts Inc                        	NYSE      	none      
XIV   	VS -1X VIX Short Term                             	NASDAQ    	none      
XL    	XL Company Switzerland Gmbh                       	NYSE      	SP500     
XLNX  	Xilinx Inc                                        	NASDAQ    	SP500     
XNET  	Xunlei Limited ADR                                	NASDAQ    	none      
XOG   	Extraction Oil & Gas Inc                          	NASDAQ    	none      
XOM   	Exxon Mobil Corp                                  	NYSE      	SP500     
XON   	Intrexon Corp                                     	NYSE      	none      
XPER  	Xperi Corp                                        	NASDAQ    	SP600     
XPO   	Xpo Logistics Inc.                                	NYSE      	none      
XRAY  	Dentsply Sirona Inc                               	NASDAQ    	SP500     
XRX   	Xerox Corp                                        	NYSE      	SP500     
XYL   	Xylem Inc                                         	NYSE      	SP500     
YELP  	Yelp Inc                                          	NYSE      	none      
YEXT  	Yext Inc                                          	NYSE      	none      
YNDX  	Yandex N.V.                                       	NASDAQ    	none      
YPF   	Ypf Sociedad Anonima                              	NYSE      	none      
YRCW  	YRC Worldwide                                     	NASDAQ    	none      
YRD   	Yirendai Ltd                                      	NYSE      	none      
YUM   	Yum! Brands                                       	NYSE      	SP500     
YUMC  	Yum China Holdings Inc                            	NYSE      	none      
YY    	YY Inc                                            	NASDAQ    	none      
Z     	Zillow Group Cl C                                 	NASDAQ    	none      
ZAGG  	Zagg Inc                                          	NASDAQ    	none      
ZAYO  	Zayo Group Holdings Inc                           	NYSE      	none      
ZBH   	Zimmer Biomet Holdings                            	NYSE      	SP500     
ZEN   	Zendesk Inc                                       	NYSE      	none      
ZGNX  	Zogenix Inc                                       	NASDAQ    	none      
ZION  	Zions Bancorporation                              	NASDAQ    	SP500     
ZTO   	Zto Express [Cayman] Inc                          	NYSE      	none      
ZTS   	Zoetis Inc Class A                                	NYSE      	SP500     
ZUMZ  	Zumiez Inc                                        	NASDAQ    	SP600     
