QQQ
SPY
DIA
IWO
NDX.IDX
DVS.IDX
NYA.IDX
DWC.IDX
WMX.IDX   	ISE Walmart Suplr Index                           	INDEX     
IQX.IDX   	S&P 500 EQUAL WEIGHT                              	INDEX     
IQZ.IDX   	S&P 1000                                          	INDEX     
FVX.IDX   	5-YEAR TREASURY NOTE                              	INDEX     
ADVA.IDX  	AMEX Advancing Stocks                             	INDEX     
ADVD.IDX  	OTC Advancing Stocks                              	INDEX     
ADVE.IDX  	ETFS  Advancing Stocks                            	INDEX     
ADVN.IDX  	NYSE Advancing Stocks                             	INDEX     
ADVQ.IDX  	NASD Advancing Stocks                             	INDEX     
ADVS.IDX  	TSX Advancing Stocks                              	INDEX     
ADVT.IDX  	Total Advancing Stocks                            	INDEX 
DECA.IDX  	AMEX Declining Stocks                             	INDEX     
DECD.IDX  	OTC Declining Stocks                              	INDEX     
DECE.IDX  	ETFS  Declining Stocks                            	INDEX     
DECN.IDX  	NYSE Declining Stocks                             	INDEX     
DECQ.IDX  	NASD Declining Stocks                             	INDEX     
DECS.IDX  	TSX Declining Stocks                              	INDEX     
DECT.IDX  	Total Declining Stocks                            	INDEX     
AVVA.IDX  	AMEX Advancing Volume                             	INDEX     
AVVD.IDX  	OTC Advancing Volume                              	INDEX     
AVVE.IDX  	ETFS  Advancing Volume                            	INDEX     
AVVN.IDX  	NYSE Advancing Volume                             	INDEX     
AVVQ.IDX  	NASD Advancing Volume                             	INDEX     
AVVS.IDX  	TSX Advancing Volume                              	INDEX     
AVVT.IDX  	Total Advancing Volume                            	INDEX
DVCA.IDX  	AMEX Declining Volume                             	INDEX     
DVCD.IDX  	OTC Declining Volume                              	INDEX     
DVCE.IDX  	ETFS  Declining Volume                            	INDEX     
DVCN.IDX  	NYSE Declining Volume                             	INDEX     
DVCQ.IDX  	NASD Declining Volume                             	INDEX     
DVCS.IDX  	TSX Declining Volume                              	INDEX     
DVCT.IDX  	Total Declining Volume                            	INDEX     
TRIA.IDX  	AMEX Trin                                         	INDEX     
TRIN.IDX  	NYSE Trin                                         	INDEX
TICK.IDX  	NYSE Tick                                         	INDEX  
TICX.IDX  	NYSE Tick                                         	INDEX               
DSAF.IDX  	DJ US DELIVRYSRV                                  	INDEX     
DSAL.IDX  	DJ US ALUMINUM                                    	INDEX     
DSBM.IDX  	DJ US BASICMAT                                    	INDEX     
DSBV.IDX  	DJ US BEVERAGES                                   	INDEX     
DSCF.IDX  	DJ US CLOTHACCSS                                  	INDEX     
DSCG.IDX  	DJ US TRAVLEIS                                    	INDEX     
DSCM.IDX  	DJ US PERSPROD                                    	INDEX     
DSFH.IDX  	DJ US FURNISHNG                                   	INDEX     
DSFR.IDX  	DJ US FORESTPAPR                                  	INDEX     
DSGT.IDX  	DJ US GENRETAIL                                   	INDEX     
DSHG.IDX  	DJ US HLDGOODS                                    	INDEX     
DSLE.IDX  	DJ US LEISGOODS                                   	INDEX     
DSLG.IDX  	DJ US HOTELS                                      	INDEX     
DSPG.IDX  	DJ US PERSGOODS                                   	INDEX     
DSPP.IDX  	DJ US PAPER                                       	INDEX     
DSST.IDX  	DJ US STEEL                                       	INDEX     
DSTK.IDX  	DJ US TRUCKING                                    	INDEX     
DSWU.IDX  	DJ US WATER                                       	INDEX    
CPR.IDX   	Copper Index                                      	INDEX     

